Date,Amount,Account Number,,Transaction Type,Transaction Details,Balance,Category,Merchants Name
12-Oct-19,1588.89,272526163,,INTER-BANK CREDIT,Lopez PLC,-8123.4800000000005,Uncategorised, 
15-Oct-19,-585.71,272526163,,AUTOMATIC DRAWING,743821734357725 PACHECO-TORRES ,-8709.19,Financial, 
16-Oct-19,-1623.3,272526163,,INTER-BANK CREDIT,397169667597924 JONES ADAMS AND PERRY ,-10332.49,Other Income, 
19-Oct-19,29.87,272526163,,TRANSFER DEBIT,Weaver-Carlson,-10302.619999999999,Financial, 
21-Oct-19,208.34,272526163,,INTER-BANK CREDIT,Martinez Ltd,-10094.279999999999,Other Income, 
21-Oct-19,1637.77,272526163,,INTER-BANK CREDIT,Thompson-Henderson,-8456.509999999998,Bills, 
21-Oct-19,-1158.96,272526163,,INTER-BANK CREDIT,Krause-Gutierrez,-9615.469999999998,Financial, 
22-Oct-19,1.45,272526163,,AUTOMATIC DRAWING,Owens-Ray,-9614.019999999997,Bills, 
25-Oct-19,-574.13,272526163,,AUTOMATIC DRAWING,862105397780577 HARPER ONEILL AND KNAPP ,-10188.149999999996,Other Income, 
27-Oct-19,548.28,272526163,,AUTOMATIC DRAWING,432693621661351 BOWMAN GROUP ,-9639.869999999995,Other Income, 
28-Oct-19,268.65,272526163,,TRANSFER DEBIT,753247918229668 HOWARD-JORDAN ,-9371.219999999996,Other Income, 
31-Oct-19,-856.19,272526163,,INTER-BANK CREDIT,139632223605527 GRAHAM-CAMPBELL ,-10227.409999999996,Uncategorised, 
31-Oct-19,1356.49,272526163,,INTER-BANK CREDIT,33090790872577 OLSEN KIM AND MURPHY ,-8870.919999999996,Bills, 
31-Oct-19,1504.79,272526163,,TRANSFER DEBIT,998819018069619 FOWLER MURPHY AND TOWNSEND ,-7366.1299999999965,Financial, 
01-Nov-19,333.6,272526163,,AUTOMATIC DRAWING,Mcguire Ltd,-7032.529999999996,Other Income, 
01-Nov-19,-1574.21,272526163,,INTER-BANK CREDIT,223531890353468 SMITH-NEWMAN ,-8606.739999999996,Financial, 
04-Nov-19,-1491.49,272526163,,INTER-BANK CREDIT,Gregory Stuart and Phillips,-10098.229999999996,Other Income, 
04-Nov-19,1137.35,272526163,,INTER-BANK CREDIT,621404576636617 MCGUIRE-DIAZ ,-8960.879999999996,Financial, 
05-Nov-19,1745.13,272526163,,INTER-BANK CREDIT,531797145171473 WOLFE-MILLER ,-7215.749999999995,Bills, 
06-Nov-19,1106.07,272526163,,INTER-BANK CREDIT,963589009113755 PATTERSON STARK AND HENSON ,-6109.679999999996,Other Income, 
08-Nov-19,-1760.87,272526163,,AUTOMATIC DRAWING,Martinez Inc,-7870.549999999996,Financial, 
09-Nov-19,-1381.87,272526163,,AUTOMATIC DRAWING,364200642970209 BROWN-RAYMOND ,-9252.419999999995,Bills, 
11-Nov-19,1416.69,272526163,,INTER-BANK CREDIT,Figueroa Fitzgerald and Martin,-7835.729999999994,Uncategorised, 
11-Nov-19,-438.17,272526163,,TRANSFER DEBIT,178183085408640 PEREZ MELENDEZ AND DAVIS ,-8273.899999999994,Bills, 
12-Nov-19,949.43,272526163,,INTER-BANK CREDIT,Hinton-Contreras,-7324.469999999994,Other Income, 
12-Nov-19,-13.46,272526163,,INTER-BANK CREDIT,647978716476109 MCLAUGHLIN LLC ,-7337.929999999994,Other Income, 
14-Nov-19,-310.6,272526163,,INTER-BANK CREDIT,Vazquez LLC,-7648.529999999994,Financial, 
15-Nov-19,-1258.58,272526163,,INTER-BANK CREDIT,361224981075477 MORRIS PLC ,-8907.109999999993,Bills, 
17-Nov-19,-85.03,272526163,,AUTOMATIC DRAWING,897468145571011 SAVAGE-JOSEPH ,-8992.139999999994,Uncategorised, 
20-Nov-19,-91.68,272526163,,INTER-BANK CREDIT,632870882691604 HENRY-BRUCE ,-9083.819999999994,Bills, 
22-Nov-19,648.33,272526163,,INTER-BANK CREDIT,Caldwell-Foster,-8435.489999999994,Uncategorised, 
25-Nov-19,-26.85,272526163,,INTER-BANK CREDIT,8531006104375 WALLACE-STEWART ,-8462.339999999995,Financial, 
25-Nov-19,486.71,272526163,,TRANSFER DEBIT,371425971244253 BRAUN LLC ,-7975.629999999995,Financial, 
26-Nov-19,-1524.07,272526163,,TRANSFER DEBIT,Campos Klein and Wilson,-9499.699999999995,Financial, 
28-Nov-19,1262.64,272526163,,AUTOMATIC DRAWING,732177105003052 BOONE LTD ,-8237.059999999996,Uncategorised, 
28-Nov-19,-1297.88,272526163,,INTER-BANK CREDIT,Hardy LLC,-9534.939999999995,Financial, 
01-Dec-19,-768.7,272526163,,INTER-BANK CREDIT,778645221303001 BROWN LTD ,-10303.639999999996,Financial, 
03-Dec-19,-494.82,272526163,,AUTOMATIC DRAWING,Dominguez Mayo and Gray,-10798.459999999995,Bills, 
03-Dec-19,-476.95,272526163,,TRANSFER DEBIT,Camacho Ltd,-11275.409999999996,Financial, 
03-Dec-19,-1542.36,272526163,,AUTOMATIC DRAWING,656057134666149 HERNANDEZ-SANCHEZ ,-12817.769999999997,Bills, 
06-Dec-19,257.61,272526163,,AUTOMATIC DRAWING,689195520237946 ANDERSON-OCONNELL ,-12560.159999999996,Uncategorised, 
08-Dec-19,-1832.79,272526163,,INTER-BANK CREDIT,Duarte LLC,-14392.949999999997,Other Income, 
10-Dec-19,1565.27,272526163,,INTER-BANK CREDIT,234682546245141 SCOTT AND SONS ,-12827.679999999997,Other Income, 
13-Dec-19,-527.33,272526163,,INTER-BANK CREDIT,Grant LLC,-13355.009999999997,Uncategorised, 
13-Dec-19,1.75,272526163,,TRANSFER DEBIT,Watkins Group,-13353.259999999997,Financial, 
15-Dec-19,1932.75,272526163,,AUTOMATIC DRAWING,828263487440180 JOHNSON-JONES ,-11420.509999999997,Other Income, 
18-Dec-19,520.58,272526163,,INTER-BANK CREDIT,616241035401418 RICHARDS-DUFFY ,-10899.929999999997,Uncategorised, 
20-Dec-19,799.44,272526163,,INTER-BANK CREDIT,684959662211674 GONZALEZ-PALMER ,-10100.489999999996,Other Income, 
20-Dec-19,-1903.12,272526163,,INTER-BANK CREDIT,271215954829679 THOMPSON-AGUIRRE ,-12003.609999999997,Other Income, 
21-Dec-19,-644.02,272526163,,INTER-BANK CREDIT,762505665900163 KELLEY JACKSON AND KNIGHT ,-12647.629999999997,Uncategorised, 
21-Dec-19,24.53,272526163,,INTER-BANK CREDIT,195331048220941 PRICE-NICHOLS ,-12623.099999999997,Other Income, 
23-Dec-19,-757.84,272526163,,INTER-BANK CREDIT,175100605015133 OWENS-RODGERS ,-13380.939999999997,Financial, 
26-Dec-19,679.12,272526163,,INTER-BANK CREDIT,871509970855059 ARNOLD-JOHNSON ,-12701.819999999996,Other Income, 
27-Dec-19,-1037.96,272526163,,INTER-BANK CREDIT,Garcia Inc,-13739.779999999995,Uncategorised, 
27-Dec-19,-927.66,272526163,,TRANSFER DEBIT,Martinez LLC,-14667.439999999995,Financial, 
30-Dec-19,-1502.15,272526163,,TRANSFER DEBIT,Turner-Fitzpatrick,-16169.589999999995,Bills, 
02-Jan-20,-1791.29,272526163,,INTER-BANK CREDIT,246938527101295 SINGH LTD ,-17960.879999999994,Financial, 
02-Jan-20,1629.63,272526163,,INTER-BANK CREDIT,Glass Perez and Brown,-16331.249999999993,Uncategorised, 
04-Jan-20,587.12,272526163,,AUTOMATIC DRAWING,895135055600137 BURTON ANDERSON AND GOMEZ ,-15744.129999999992,Financial, 
07-Jan-20,-954.21,272526163,,INTER-BANK CREDIT,631204707676475 GARRETT-DIAZ ,-16698.339999999993,Other Income, 
07-Jan-20,-1839.15,272526163,,TRANSFER DEBIT,Johnson LLC,-18537.489999999994,Uncategorised, 
08-Jan-20,949.63,272526163,,INTER-BANK CREDIT,Byrd-Gay,-17587.859999999993,Financial, 
10-Jan-20,783.01,272526163,,INTER-BANK CREDIT,Lane Yates and Hess,-16804.849999999995,Uncategorised, 
10-Jan-20,961.75,272526163,,AUTOMATIC DRAWING,Moses-Coleman,-15843.099999999995,Financial, 
12-Jan-20,-423.06,272526163,,INTER-BANK CREDIT,637884396998558 DAVIDSON AND SONS ,-16266.159999999994,Uncategorised, 
14-Jan-20,448.98,272526163,,INTER-BANK CREDIT,Huff-Schmidt,-15817.179999999995,Other Income, 
16-Jan-20,1484.11,272526163,,INTER-BANK CREDIT,446402699418150 RAY AND SONS ,-14333.069999999994,Financial, 
19-Jan-20,193.91,272526163,,AUTOMATIC DRAWING,462192418799391 HAYES-THOMPSON ,-14139.159999999994,Uncategorised, 
19-Jan-20,-1955.38,272526163,,INTER-BANK CREDIT,339728805400381 SMITH-DYER ,-16094.539999999994,Other Income, 
19-Jan-20,-447.25,272526163,,INTER-BANK CREDIT,Thompson Ltd,-16541.789999999994,Bills, 
20-Jan-20,915.92,272526163,,INTER-BANK CREDIT,Henderson Miller and Boyer,-15625.869999999994,Bills, 
21-Jan-20,1091.64,272526163,,TRANSFER DEBIT,Lewis and Sons,-14534.229999999994,Uncategorised, 
22-Jan-20,120.52,272526163,,INTER-BANK CREDIT,Parrish-Lewis,-14413.709999999994,Uncategorised, 
22-Jan-20,271.56,272526163,,AUTOMATIC DRAWING,Willis Group,-14142.149999999994,Financial, 
24-Jan-20,1403.37,272526163,,AUTOMATIC DRAWING,233865975734293 CHAMBERS ALLEN AND RODGERS ,-12738.779999999995,Uncategorised, 
26-Jan-20,-1235.34,272526163,,INTER-BANK CREDIT,236721579055394 GARCIA GIBSON AND HO ,-13974.119999999995,Financial, 
26-Jan-20,1448.86,272526163,,TRANSFER DEBIT,Smith-Duncan,-12525.259999999995,Financial, 
29-Jan-20,-1897.86,272526163,,INTER-BANK CREDIT,Jones Sanchez and Horton,-14423.119999999995,Uncategorised, 
31-Jan-20,1228.77,272526163,,INTER-BANK CREDIT,Richardson Mckenzie and Vega,-13194.349999999995,Financial, 
02-Feb-20,698.69,272526163,,TRANSFER DEBIT,Mcgee and Sons,-12495.659999999994,Bills, 
05-Feb-20,319.07,272526163,,TRANSFER DEBIT,Rogers Rubio and Hall,-12176.589999999995,Bills, 
05-Feb-20,1500.54,272526163,,AUTOMATIC DRAWING,941140881380933 DONALDSON PLC ,-10676.049999999996,Uncategorised, 
05-Feb-20,-1160.59,272526163,,TRANSFER DEBIT,707367434741893 ALVARADO-FERGUSON ,-11836.639999999996,Bills, 
07-Feb-20,1082.98,272526163,,TRANSFER DEBIT,Conley-Hall,-10753.659999999996,Financial, 
08-Feb-20,-559.13,272526163,,AUTOMATIC DRAWING,Watson Williams and Wheeler,-11312.789999999995,Financial, 
11-Feb-20,-1524.7,272526163,,INTER-BANK CREDIT,Stewart Inc,-12837.489999999996,Uncategorised, 
14-Feb-20,901.47,272526163,,AUTOMATIC DRAWING,Parker-Rose,-11936.019999999997,Other Income, 
16-Feb-20,1166.86,272526163,,INTER-BANK CREDIT,Jones-Hanna,-10769.159999999996,Bills, 
17-Feb-20,1555.2,272526163,,TRANSFER DEBIT,Coleman-Miller,-9213.959999999995,Bills, 
19-Feb-20,822.54,272526163,,INTER-BANK CREDIT,331788823360067 LE GROUP ,-8391.419999999995,Other Income, 
19-Feb-20,1736.36,272526163,,INTER-BANK CREDIT,436171272246907 ANDERSON-HOPKINS ,-6655.059999999995,Uncategorised, 
21-Feb-20,-53.14,272526163,,INTER-BANK CREDIT,792157287318237 PONCE AND SONS ,-6708.199999999995,Other Income, 
22-Feb-20,-1373.89,272526163,,TRANSFER DEBIT,566194984564670 GONZALEZ INC ,-8082.089999999996,Financial, 
23-Feb-20,-1819.61,272526163,,TRANSFER DEBIT,Smith LLC,-9901.699999999995,Uncategorised, 
26-Feb-20,-1414.79,272526163,,TRANSFER DEBIT,Banks Group,-11316.489999999994,Other Income, 
27-Feb-20,-441.85,272526163,,TRANSFER DEBIT,Mitchell-Duncan,-11758.339999999995,Uncategorised, 
29-Feb-20,1957.93,272526163,,INTER-BANK CREDIT,964162845663939 MORGAN-WEST ,-9800.409999999994,Other Income, 
02-Mar-20,1403.63,272526163,,AUTOMATIC DRAWING,601004449156441 SINGLETON WHITE AND COX ,-8396.779999999995,Other Income, 
05-Mar-20,-461.44,272526163,,INTER-BANK CREDIT,Price-Rice,-8858.219999999996,Financial, 
08-Mar-20,1449.18,272526163,,AUTOMATIC DRAWING,Ruiz-Moses,-7409.039999999995,Bills, 
11-Mar-20,-1423.02,272526163,,INTER-BANK CREDIT,Johnson Price and Ortega,-8832.059999999996,Other Income, 
12-Mar-20,647.58,272526163,,AUTOMATIC DRAWING,957717167741619 EVANS LTD ,-8184.479999999996,Other Income, 
13-Mar-20,1801.53,272526163,,INTER-BANK CREDIT,489826432124245 CUNNINGHAM-WILLIAMS ,-6382.949999999996,Bills, 
13-Mar-20,-581.79,272526163,,INTER-BANK CREDIT,Soto Campbell and Hernandez,-6964.739999999996,Financial, 
14-Mar-20,1984.48,272526163,,AUTOMATIC DRAWING,858386759268013 PEREZ KNIGHT AND JIMENEZ ,-4980.259999999997,Financial, 
16-Mar-20,-1851.75,272526163,,AUTOMATIC DRAWING,366387349792087 JUAREZ-CURTIS ,-6832.009999999997,Bills, 
17-Mar-20,-57.15,272526163,,TRANSFER DEBIT,453133025085332 BURGESS-GARCIA ,-6889.159999999996,Bills, 
19-Mar-20,-39.91,272526163,,TRANSFER DEBIT,555855148828265 THOMAS PARKER AND WATERS ,-6929.069999999996,Uncategorised, 
22-Mar-20,-216.9,272526163,,AUTOMATIC DRAWING,Arnold LLC,-7145.969999999996,Financial, 
25-Mar-20,-1272.86,272526163,,AUTOMATIC DRAWING,382035193417197 SILVA-MACIAS ,-8418.829999999996,Bills, 
27-Mar-20,-181.8,272526163,,INTER-BANK CREDIT,83806459379786 RUBIO-MAY ,-8600.629999999996,Uncategorised, 
28-Mar-20,1816.84,272526163,,INTER-BANK CREDIT,Nelson-Harmon,-6783.789999999995,Bills, 
30-Mar-20,1598.04,272526163,,TRANSFER DEBIT,Robinson Lee and Lopez,-5185.749999999995,Financial, 
01-Apr-20,-1032.08,272526163,,INTER-BANK CREDIT,Gonzalez Group,-6217.829999999995,Bills, 
03-Apr-20,440.26,272526163,,TRANSFER DEBIT,245583095009295 BROWN JOHNSTON AND LOPEZ ,-5777.569999999995,Bills, 
06-Apr-20,-1583.5,272526163,,AUTOMATIC DRAWING,Jones Ltd,-7361.069999999995,Uncategorised, 
09-Apr-20,-505.17,272526163,,INTER-BANK CREDIT,Raymond Ltd,-7866.239999999995,Other Income, 
12-Apr-20,1413.72,272526163,,AUTOMATIC DRAWING,826512963597107 SHIELDS-LIVINGSTON ,-6452.519999999995,Other Income, 
13-Apr-20,1270.59,272526163,,TRANSFER DEBIT,442214846481226 JONES SHORT AND SMITH ,-5181.929999999995,Other Income, 
13-Apr-20,-1141.47,272526163,,INTER-BANK CREDIT,477396238442769 JOHNSON GILBERT AND TATE ,-6323.399999999995,Uncategorised, 
13-Apr-20,-155.16,272526163,,AUTOMATIC DRAWING,Rios Inc,-6478.559999999995,Other Income, 
14-Apr-20,-1519.76,272526163,,INTER-BANK CREDIT,Chavez and Sons,-7998.319999999995,Financial, 
14-Apr-20,-17.14,272526163,,TRANSFER DEBIT,Flynn Kelley and Mata,-8015.4599999999955,Uncategorised, 
14-Apr-20,1400.71,272526163,,TRANSFER DEBIT,Hubbard-Williams,-6614.749999999995,Financial, 
15-Apr-20,14.86,272526163,,INTER-BANK CREDIT,49377679785955 ALEXANDER INC ,-6599.889999999996,Other Income, 
15-Apr-20,1128.95,272526163,,INTER-BANK CREDIT,Campbell Group,-5470.939999999996,Other Income, 
17-Apr-20,249.36,272526163,,TRANSFER DEBIT,743068363613644 ROJAS LEWIS AND SIMPSON ,-5221.579999999996,Uncategorised, 
20-Apr-20,254.19,272526163,,INTER-BANK CREDIT,288735099075344 THOMAS INC ,-4967.389999999997,Bills, 
23-Apr-20,697.49,272526163,,INTER-BANK CREDIT,906789740074962 WILSON-WHITE ,-4269.899999999997,Bills, 
23-Apr-20,-15.64,272526163,,TRANSFER DEBIT,Ward-Klein,-4285.539999999997,Financial, 
23-Apr-20,31.46,272526163,,INTER-BANK CREDIT,Spencer-Sanchez,-4254.079999999997,Uncategorised, 
25-Apr-20,576.44,272526163,,INTER-BANK CREDIT,675084201237351 INGRAM AND SONS ,-3677.639999999997,Financial, 
25-Apr-20,-1194.87,272526163,,AUTOMATIC DRAWING,458477637884944 MOORE LTD ,-4872.509999999997,Other Income, 
26-Apr-20,1730.48,272526163,,AUTOMATIC DRAWING,Perez-Herman,-3142.0299999999966,Uncategorised, 
27-Apr-20,1282.23,272526163,,TRANSFER DEBIT,Weaver PLC,-1859.7999999999965,Other Income, 
27-Apr-20,338.97,272526163,,AUTOMATIC DRAWING,928574856549778 MOSS MITCHELL AND JOHNSON ,-1520.8299999999965,Bills, 
29-Apr-20,1819.03,272526163,,TRANSFER DEBIT,Evans-Barrett,298.20000000000346,Uncategorised, 
30-Apr-20,-985.25,272526163,,INTER-BANK CREDIT,746767868820228 HARRIS PLC ,-687.0499999999965,Bills, 
02-May-20,1751.63,272526163,,INTER-BANK CREDIT,Sutton PLC,1064.5800000000036,Bills, 
02-May-20,1833.91,272526163,,TRANSFER DEBIT,Mack Alvarado and Barrett,2898.4900000000034,Other Income, 
03-May-20,-197.55,272526163,,INTER-BANK CREDIT,Fitzgerald Inc,2700.9400000000032,Uncategorised, 
03-May-20,-97.68,272526163,,AUTOMATIC DRAWING,Riggs Mitchell and Roman,2603.2600000000034,Other Income, 
06-May-20,1206.49,272526163,,AUTOMATIC DRAWING,Gross-Chan,3809.7500000000036,Other Income, 
07-May-20,-912.07,272526163,,INTER-BANK CREDIT,486557774178125 ZUNIGA KIM AND LYONS ,2897.6800000000035,Financial, 
09-May-20,-1024.76,272526163,,AUTOMATIC DRAWING,768435973563155 SULLIVAN-BELL ,1872.9200000000035,Other Income, 
11-May-20,-1129.0,272526163,,INTER-BANK CREDIT,Collins PLC,743.9200000000035,Other Income, 
14-May-20,1870.3,272526163,,INTER-BANK CREDIT,132993117654976 HART GROUP ,2614.2200000000034,Bills, 
15-May-20,-616.2,272526163,,TRANSFER DEBIT,583085848841327 SKINNER WILLIAMS AND DAY ,1998.0200000000034,Other Income, 
15-May-20,-140.3,272526163,,TRANSFER DEBIT,Le Ltd,1857.7200000000034,Bills, 
18-May-20,72.76,272526163,,TRANSFER DEBIT,Moore Leon and Manning,1930.4800000000034,Uncategorised, 
21-May-20,-1532.07,272526163,,AUTOMATIC DRAWING,903385121260461 MOORE HUFF AND PARKS ,398.4100000000035,Other Income, 
21-May-20,1386.03,272526163,,AUTOMATIC DRAWING,Wilson-Jackson,1784.4400000000035,Bills, 
21-May-20,-270.31,272526163,,INTER-BANK CREDIT,548657917992988 TREVINO LTD ,1514.1300000000035,Bills, 
21-May-20,718.83,272526163,,TRANSFER DEBIT,Gonzalez Klein and Gonzales,2232.9600000000037,Other Income, 
22-May-20,-245.29,272526163,,INTER-BANK CREDIT,Stewart Inc,1987.6700000000037,Other Income, 
24-May-20,1144.51,272526163,,TRANSFER DEBIT,840127083506835 WOODS AND SONS ,3132.180000000004,Bills, 
26-May-20,-1610.6,272526163,,AUTOMATIC DRAWING,Valdez PLC,1521.580000000004,Bills, 
26-May-20,537.49,272526163,,INTER-BANK CREDIT,59741829454430 HORTON PLC ,2059.0700000000043,Uncategorised, 
28-May-20,-161.77,272526163,,AUTOMATIC DRAWING,Ross Gaines and Pierce,1897.3000000000043,Financial, 
28-May-20,-610.55,272526163,,INTER-BANK CREDIT,699319611340788 ROJAS FREEMAN AND NICHOLS ,1286.7500000000043,Other Income, 
31-May-20,594.37,272526163,,AUTOMATIC DRAWING,997980797982590 HOGAN LTD ,1881.1200000000044,Bills, 
01-Jun-20,261.65,272526163,,AUTOMATIC DRAWING,Murphy-Riley,2142.7700000000045,Other Income, 
01-Jun-20,828.67,272526163,,AUTOMATIC DRAWING,Nelson Watts and White,2971.4400000000046,Financial, 
03-Jun-20,-1130.28,272526163,,INTER-BANK CREDIT,Todd-Hall,1841.1600000000046,Bills, 
05-Jun-20,-2.84,272526163,,INTER-BANK CREDIT,764825944900292 MITCHELL CONTRERAS AND CAMACHO ,1838.3200000000047,Other Income, 
05-Jun-20,393.63,272526163,,INTER-BANK CREDIT,416229690421425 BREWER-GLOVER ,2231.950000000005,Bills, 
07-Jun-20,94.77,272526163,,TRANSFER DEBIT,92153869792576 LAMBERT-DAVIS ,2326.720000000005,Other Income, 
10-Jun-20,1426.64,272526163,,INTER-BANK CREDIT,Young-Warren,3753.360000000005,Financial, 
12-Jun-20,1683.32,272526163,,INTER-BANK CREDIT,915407445257471 MASSEY LTD ,5436.680000000005,Financial, 
13-Jun-20,-1587.1,272526163,,INTER-BANK CREDIT,Garcia PLC,3849.580000000005,Uncategorised, 
14-Jun-20,-1138.98,272526163,,TRANSFER DEBIT,976806503628359 ANDERSEN THOMPSON AND STEPHENS ,2710.600000000005,Financial, 
16-Jun-20,-286.26,272526163,,AUTOMATIC DRAWING,Snyder Ltd,2424.3400000000047,Other Income, 
19-Jun-20,1393.28,272526163,,TRANSFER DEBIT,288205870215232 RASMUSSEN ERICKSON AND BROWN ,3817.6200000000044,Other Income, 
19-Jun-20,-629.2,272526163,,TRANSFER DEBIT,Colon-Young,3188.4200000000046,Other Income, 
21-Jun-20,190.54,272526163,,AUTOMATIC DRAWING,Morales Ltd,3378.9600000000046,Other Income, 
23-Jun-20,-1355.71,272526163,,INTER-BANK CREDIT,334400146560471 NIXON-GONZALES ,2023.2500000000045,Other Income, 
25-Jun-20,-875.35,272526163,,AUTOMATIC DRAWING,266977914450962 RILEY INC ,1147.9000000000046,Bills, 
27-Jun-20,605.79,272526163,,TRANSFER DEBIT,469908736840537 PEREZ LTD ,1753.6900000000046,Financial, 
29-Jun-20,-408.18,272526163,,AUTOMATIC DRAWING,530521665457801 HANNA-HERNANDEZ ,1345.5100000000045,Financial, 
29-Jun-20,1126.57,272526163,,AUTOMATIC DRAWING,Williamson-Reed,2472.0800000000045,Other Income, 
01-Jul-20,-1641.66,272526163,,AUTOMATIC DRAWING,163647855714122 JOHNSON-HALL ,830.4200000000044,Bills, 
02-Jul-20,800.23,272526163,,INTER-BANK CREDIT,544208891959278 BALL-HENDERSON ,1630.6500000000044,Bills, 
03-Jul-20,219.98,272526163,,TRANSFER DEBIT,Myers-Anderson,1850.6300000000044,Other Income, 
04-Jul-20,-825.12,272526163,,AUTOMATIC DRAWING,99707424323333 WRIGHT-HARRIS ,1025.5100000000043,Uncategorised, 
05-Jul-20,1417.53,272526163,,INTER-BANK CREDIT,Graham-Shepherd,2443.0400000000045,Other Income, 
07-Jul-20,1088.08,272526163,,AUTOMATIC DRAWING,248163926057152 WILLIAMSON GROUP ,3531.1200000000044,Other Income, 
07-Jul-20,-1315.34,272526163,,AUTOMATIC DRAWING,Riley Inc,2215.7800000000043,Uncategorised, 
10-Jul-20,479.27,272526163,,AUTOMATIC DRAWING,917640276889022 MERCER CERVANTES AND TERRY ,2695.0500000000043,Other Income, 
12-Jul-20,1996.09,272526163,,TRANSFER DEBIT,397166104708910 SCHULTZ-ANDERSEN ,4691.140000000004,Bills, 
13-Jul-20,-1730.1,272526163,,INTER-BANK CREDIT,Martin-Shaw,2961.040000000004,Other Income, 
13-Jul-20,181.37,272526163,,TRANSFER DEBIT,Dixon and Sons,3142.410000000004,Bills, 
13-Jul-20,-7.16,272526163,,TRANSFER DEBIT,Brown-Harris,3135.250000000004,Other Income, 
16-Jul-20,-1482.94,272526163,,AUTOMATIC DRAWING,478461704621168 JENKINS WILSON AND WELCH ,1652.310000000004,Uncategorised, 
16-Jul-20,1840.24,272526163,,TRANSFER DEBIT,189411347877284 CARNEY-FOLEY ,3492.550000000004,Other Income, 
18-Jul-20,-645.78,272526163,,INTER-BANK CREDIT,Hubbard LLC,2846.770000000004,Financial, 
21-Jul-20,-1515.31,272526163,,AUTOMATIC DRAWING,103021934764832 SMITH-WILLIAMS ,1331.4600000000041,Other Income, 
21-Jul-20,-841.08,272526163,,AUTOMATIC DRAWING,Mckenzie Stanley and Gay,490.3800000000041,Other Income, 
24-Jul-20,-710.56,272526163,,TRANSFER DEBIT,Rice Diaz and Jackson,-220.17999999999586,Uncategorised, 
24-Jul-20,1825.5,272526163,,AUTOMATIC DRAWING,549227535336641 PONCE-JONES ,1605.3200000000043,Bills, 
26-Jul-20,896.42,272526163,,AUTOMATIC DRAWING,Young Bush and Smith,2501.7400000000043,Financial, 
28-Jul-20,-1356.41,272526163,,AUTOMATIC DRAWING,130281415484862 SCOTT GROUP ,1145.3300000000042,Uncategorised, 
29-Jul-20,398.37,272526163,,TRANSFER DEBIT,459534647557972 TAYLOR INC ,1543.7000000000044,Financial, 
01-Aug-20,1140.53,272526163,,INTER-BANK CREDIT,464567123003757 MCCORMICK BROWN AND JIMENEZ ,2684.230000000004,Uncategorised, 
02-Aug-20,1336.47,272526163,,INTER-BANK CREDIT,Rivera Group,4020.7000000000044,Financial, 
05-Aug-20,-803.76,272526163,,INTER-BANK CREDIT,672837727719648 JOHNSON ORTEGA AND LANE ,3216.940000000004,Bills, 
06-Aug-20,-1355.08,272526163,,INTER-BANK CREDIT,Lam PLC,1861.8600000000042,Other Income, 
09-Aug-20,-1311.94,272526163,,INTER-BANK CREDIT,936774998107140 CARROLL WILLIAMS AND ROMERO ,549.9200000000042,Uncategorised, 
10-Aug-20,1839.83,272526163,,INTER-BANK CREDIT,680814436052684 JOHNSON-MILLS ,2389.750000000004,Uncategorised, 
12-Aug-20,-169.69,272526163,,INTER-BANK CREDIT,Fox LLC,2220.060000000004,Other Income, 
12-Aug-20,63.45,272526163,,INTER-BANK CREDIT,Porter Williams and Jones,2283.510000000004,Other Income, 
14-Aug-20,-947.05,272526163,,INTER-BANK CREDIT,9196093891621 HILL PITTMAN AND TAYLOR ,1336.460000000004,Financial, 
16-Aug-20,727.76,272526163,,TRANSFER DEBIT,Love-Carter,2064.220000000004,Uncategorised, 
18-Aug-20,741.86,272526163,,TRANSFER DEBIT,Kelly-Allen,2806.080000000004,Bills, 
20-Aug-20,958.67,272526163,,INTER-BANK CREDIT,336115434828842 DAVIS FIGUEROA AND ELLIS ,3764.750000000004,Other Income, 
21-Aug-20,-615.68,272526163,,TRANSFER DEBIT,Brooks Inc,3149.0700000000043,Other Income, 
23-Aug-20,1609.14,272526163,,AUTOMATIC DRAWING,612815781253661 TRAVIS GROUP ,4758.210000000005,Uncategorised, 
24-Aug-20,368.57,272526163,,AUTOMATIC DRAWING,Garcia Inc,5126.780000000004,Uncategorised, 
27-Aug-20,901.03,272526163,,INTER-BANK CREDIT,Morrow Group,6027.810000000004,Bills, 
28-Aug-20,-1321.35,272526163,,INTER-BANK CREDIT,Melton and Sons,4706.460000000005,Uncategorised, 
29-Aug-20,-634.48,272526163,,TRANSFER DEBIT,May Inc,4071.9800000000046,Uncategorised, 
30-Aug-20,-1285.26,272526163,,AUTOMATIC DRAWING,916567335237677 WARREN-WARD ,2786.720000000005,Other Income, 
30-Aug-20,1341.76,272526163,,INTER-BANK CREDIT,975050604695421 SULLIVAN HAMILTON AND MCMAHON ,4128.480000000005,Other Income, 
30-Aug-20,220.07,272526163,,TRANSFER DEBIT,Thomas Turner and Hayes,4348.550000000005,Financial, 
30-Aug-20,35.05,272526163,,INTER-BANK CREDIT,769081726763797 PARRISH YOUNG AND WELCH ,4383.600000000005,Uncategorised, 
30-Aug-20,-1690.82,272526163,,INTER-BANK CREDIT,Rodriguez Lamb and Jones,2692.780000000005,Financial, 
30-Aug-20,-1720.48,272526163,,INTER-BANK CREDIT,331205016325183 MARTINEZ WALL AND ROSE ,972.3000000000052,Other Income, 
31-Aug-20,1832.89,272526163,,AUTOMATIC DRAWING,Peters-May,2805.190000000005,Other Income, 
01-Sep-20,1760.87,272526163,,INTER-BANK CREDIT,699919994352586 BOWMAN FOSTER AND JOHNSON ,4566.060000000005,Uncategorised, 
01-Sep-20,18.87,272526163,,INTER-BANK CREDIT,Sweeney and Sons,4584.930000000005,Financial, 
04-Sep-20,-950.18,272526163,,INTER-BANK CREDIT,Spencer PLC,3634.750000000005,Bills, 
05-Sep-20,-1809.14,272526163,,INTER-BANK CREDIT,Williamson-Reid,1825.610000000005,Other Income, 
05-Sep-20,624.04,272526163,,INTER-BANK CREDIT,467765306474918 COLLINS SCHNEIDER AND MALONE ,2449.650000000005,Uncategorised, 
05-Sep-20,52.6,272526163,,AUTOMATIC DRAWING,276628241561463 FUENTES FREEMAN AND PAYNE ,2502.250000000005,Uncategorised, 
06-Sep-20,818.22,272526163,,TRANSFER DEBIT,794708616200474 MULLINS-LAWRENCE ,3320.470000000005,Other Income, 
09-Sep-20,-1116.17,272526163,,TRANSFER DEBIT,Brown Diaz and Bradford,2204.3000000000047,Financial, 
11-Sep-20,-1039.52,272526163,,INTER-BANK CREDIT,Vaughn-Reeves,1164.7800000000047,Bills, 
13-Sep-20,685.39,272526163,,AUTOMATIC DRAWING,Miller PLC,1850.1700000000046,Bills, 
15-Sep-20,-646.05,272526163,,TRANSFER DEBIT,956588060205082 WILSON LTD ,1204.1200000000047,Uncategorised, 
15-Sep-20,-30.55,272526163,,AUTOMATIC DRAWING,Frank LLC,1173.5700000000047,Bills, 
16-Sep-20,-1053.69,272526163,,INTER-BANK CREDIT,692948428465397 CAMPBELL SANDERS AND RODRIGUEZ ,119.88000000000466,Other Income, 
17-Sep-20,-954.13,272526163,,AUTOMATIC DRAWING,Waller LLC,-834.2499999999953,Other Income, 
17-Sep-20,-1743.84,272526163,,TRANSFER DEBIT,Williams-Mcgee,-2578.089999999995,Bills, 
18-Sep-20,-1451.39,272526163,,INTER-BANK CREDIT,Welch Brown and Manning,-4029.479999999995,Other Income, 
20-Sep-20,1584.03,272526163,,INTER-BANK CREDIT,Woods Ltd,-2445.4499999999953,Other Income, 
20-Sep-20,591.29,272526163,,TRANSFER DEBIT,Cannon Riddle and Mcpherson,-1854.1599999999953,Uncategorised, 
20-Sep-20,1832.92,272526163,,INTER-BANK CREDIT,351262849054214 FREEMAN-JOHNSON ,-21.239999999995234,Bills, 
21-Sep-20,-247.15,272526163,,INTER-BANK CREDIT,857637270668596 ALLEN MILLER AND HARRISON ,-268.3899999999952,Other Income, 
24-Sep-20,-293.02,272526163,,INTER-BANK CREDIT,Campbell Miller and Byrd,-561.4099999999952,Financial, 
25-Sep-20,-339.05,272526163,,INTER-BANK CREDIT,573429779062254 THOMAS TATE AND BARTON ,-900.4599999999953,Uncategorised, 
26-Sep-20,-1657.89,272526163,,TRANSFER DEBIT,Franco Pierce and Davis,-2558.3499999999954,Financial, 
26-Sep-20,1178.52,272526163,,AUTOMATIC DRAWING,432864047520418 FULLER PATRICK AND BOWEN ,-1379.8299999999954,Other Income, 
28-Sep-20,398.81,272526163,,INTER-BANK CREDIT,923245826660682 COX-LEWIS ,-981.0199999999954,Financial, 
29-Sep-20,-995.13,272526163,,INTER-BANK CREDIT,Moyer Ltd,-1976.1499999999955,Bills, 
01-Oct-20,-1217.36,272526163,,AUTOMATIC DRAWING,871182322976107 THOMAS AND SONS ,-3193.5099999999957,Bills, 
03-Oct-20,-1080.82,272526163,,TRANSFER DEBIT,724069597638700 SCOTT REILLY AND ADAMS ,-4274.329999999995,Other Income, 
04-Oct-20,-250.46,272526163,,INTER-BANK CREDIT,237940543170156 YOUNG-FRANKLIN ,-4524.789999999995,Financial, 
06-Oct-20,743.42,272526163,,TRANSFER DEBIT,880259033010747 BROWN LTD ,-3781.3699999999953,Bills, 
08-Oct-20,-151.31,272526163,,INTER-BANK CREDIT,336235408639880 MOSLEY-WILKINSON ,-3932.6799999999953,Uncategorised, 
10-Oct-20,-834.36,272526163,,INTER-BANK CREDIT,Richards Martinez and Henderson,-4767.039999999995,Other Income, 
13-Oct-20,-1736.85,272526163,,INTER-BANK CREDIT,297533091792944 GOMEZ PLC ,-6503.889999999996,Uncategorised, 
13-Oct-20,1065.43,272526163,,TRANSFER DEBIT,397423115816769 FITZGERALD ARNOLD AND HERNANDEZ ,-5438.4599999999955,Bills, 
13-Oct-20,-250.94,272526163,,INTER-BANK CREDIT,Taylor-Green,-5689.399999999995,Bills, 
15-Oct-20,-559.09,272526163,,TRANSFER DEBIT,733242507378884 FERGUSON GROUP ,-6248.489999999995,Financial, 
16-Oct-20,-1264.83,272526163,,INTER-BANK CREDIT,Martin-Carson,-7513.319999999995,Bills, 
18-Oct-20,965.19,272526163,,INTER-BANK CREDIT,203716281123576 JOHNSON GROUP ,-6548.129999999996,Other Income, 
20-Oct-20,-196.31,272526163,,INTER-BANK CREDIT,Rojas Smith and Herrera,-6744.439999999996,Financial, 
21-Oct-20,-45.31,272526163,,INTER-BANK CREDIT,Moore and Sons,-6789.749999999996,Bills, 
24-Oct-20,486.1,272526163,,TRANSFER DEBIT,Branch Rodriguez and Ferrell,-6303.649999999996,Bills, 
25-Oct-20,-1196.06,272526163,,INTER-BANK CREDIT,Wilson Newman and Mendoza,-7499.7099999999955,Financial, 
25-Oct-20,-680.19,272526163,,AUTOMATIC DRAWING,Carrillo Martin and Fleming,-8179.899999999996,Bills, 
25-Oct-20,1954.69,272526163,,TRANSFER DEBIT,146146687073832 EDWARDS-ESTES ,-6225.2099999999955,Other Income, 
27-Oct-20,736.2,272526163,,INTER-BANK CREDIT,129229893089728 SCHULTZ-FOWLER ,-5489.009999999996,Financial, 
30-Oct-20,236.69,272526163,,AUTOMATIC DRAWING,658708126545903 FRANKLIN-CARPENTER ,-5252.319999999996,Uncategorised, 
30-Oct-20,199.66,272526163,,INTER-BANK CREDIT,Thompson Group,-5052.659999999996,Bills, 
01-Nov-20,1531.64,272526163,,AUTOMATIC DRAWING,Martinez-Perez,-3521.019999999996,Bills, 
02-Nov-20,1372.62,272526163,,INTER-BANK CREDIT,938792383936748 MOORE PLC ,-2148.399999999996,Bills, 
04-Nov-20,-1357.32,272526163,,INTER-BANK CREDIT,942789281173793 BURNS GROUP ,-3505.7199999999957,Uncategorised, 
06-Nov-20,-151.86,272526163,,INTER-BANK CREDIT,562753906195936 WILLIAMS-CASEY ,-3657.579999999996,Other Income, 
08-Nov-20,1436.94,272526163,,INTER-BANK CREDIT,578446510320449 JONES MCGUIRE AND BROWN ,-2220.639999999996,Financial, 
10-Nov-20,1503.74,272526163,,INTER-BANK CREDIT,Vargas-Rodriguez,-716.8999999999958,Other Income, 
12-Nov-20,704.78,272526163,,INTER-BANK CREDIT,Williams Ltd,-12.119999999995798,Uncategorised, 
15-Nov-20,1890.02,272526163,,INTER-BANK CREDIT,Lewis LLC,1877.9000000000042,Other Income, 
17-Nov-20,913.72,272526163,,INTER-BANK CREDIT,631828595217016 ADAMS INC ,2791.6200000000044,Uncategorised, 
19-Nov-20,878.34,272526163,,AUTOMATIC DRAWING,443285866883277 GONZALEZ BRANCH AND TAYLOR ,3669.9600000000046,Financial, 
21-Nov-20,-10.32,272526163,,INTER-BANK CREDIT,Yoder-Torres,3659.6400000000044,Other Income, 
22-Nov-20,-364.42,272526163,,AUTOMATIC DRAWING,108313280397842 ROWE GROUP ,3295.2200000000043,Financial, 
23-Nov-20,1445.8,272526163,,AUTOMATIC DRAWING,Edwards PLC,4741.020000000004,Uncategorised, 
23-Nov-20,-1631.64,272526163,,AUTOMATIC DRAWING,Robinson Landry and Sanford,3109.3800000000037,Other Income, 
26-Nov-20,-1711.86,272526163,,TRANSFER DEBIT,Kennedy-Wright,1397.5200000000038,Other Income, 
26-Nov-20,-1375.49,272526163,,TRANSFER DEBIT,James Alvarez and Cooper,22.030000000003838,Bills, 
29-Nov-20,-1298.17,272526163,,INTER-BANK CREDIT,Hicks-Cantrell,-1276.1399999999962,Uncategorised, 
01-Dec-20,-628.55,272526163,,TRANSFER DEBIT,951393899439553 SPEARS-PORTER ,-1904.6899999999962,Other Income, 
04-Dec-20,22.95,272526163,,INTER-BANK CREDIT,Martinez Pollard and Edwards,-1881.7399999999961,Other Income, 
04-Dec-20,1914.78,272526163,,INTER-BANK CREDIT,889971554962045 DAVIS-MYERS ,33.04000000000383,Bills, 
05-Dec-20,-373.98,272526163,,INTER-BANK CREDIT,753685973700459 MILLER AND SONS ,-340.9399999999962,Other Income, 
06-Dec-20,-1147.27,272526163,,AUTOMATIC DRAWING,804885019384466 JOHNSON AND SONS ,-1488.2099999999962,Uncategorised, 
06-Dec-20,1858.77,272526163,,AUTOMATIC DRAWING,Freeman-Bailey,370.5600000000038,Uncategorised, 
07-Dec-20,-1781.61,272526163,,INTER-BANK CREDIT,545842494554332 ROBERTS SCOTT AND CABRERA ,-1411.049999999996,Other Income, 
09-Dec-20,1107.29,272526163,,AUTOMATIC DRAWING,580303777451895 GLASS SPEARS AND MILLER ,-303.7599999999961,Other Income, 
11-Dec-20,953.72,272526163,,INTER-BANK CREDIT,346102033964007 MCDONALD-JONES ,649.9600000000039,Financial, 
12-Dec-20,-701.55,272526163,,INTER-BANK CREDIT,486269926527657 DUNCAN BLEVINS AND PETERS ,-51.58999999999605,Other Income, 
13-Dec-20,-926.23,272526163,,TRANSFER DEBIT,692627862607383 TORRES-LEE ,-977.8199999999961,Bills, 
16-Dec-20,340.56,272526163,,INTER-BANK CREDIT,Anderson-Gonzalez,-637.2599999999961,Bills, 
19-Dec-20,-1174.19,272526163,,INTER-BANK CREDIT,418304905138418 GREGORY-RUSSO ,-1811.4499999999962,Other Income, 
22-Dec-20,787.17,272526163,,TRANSFER DEBIT,181665343340242 LEE LLC ,-1024.279999999996,Uncategorised, 
25-Dec-20,446.5,272526163,,AUTOMATIC DRAWING,Olson Farley and Shannon,-577.7799999999961,Bills, 
27-Dec-20,1330.44,272526163,,TRANSFER DEBIT,46235976719916 OWENS-OLSEN ,752.660000000004,Uncategorised, 
30-Dec-20,1787.41,272526163,,INTER-BANK CREDIT,Porter Guzman and Blair,2540.0700000000043,Other Income, 
31-Dec-20,-1049.59,272526163,,AUTOMATIC DRAWING,Ross-Dickerson,1490.4800000000043,Other Income, 
31-Dec-20,-1760.84,272526163,,INTER-BANK CREDIT,86375580499213 WALKER-JOHNSON ,-270.3599999999956,Bills, 
03-Jan-21,-1629.31,272526163,,INTER-BANK CREDIT,Wood-Merritt,-1899.6699999999955,Uncategorised, 
03-Jan-21,-633.9,272526163,,INTER-BANK CREDIT,Parsons Herring and Rivera,-2533.5699999999956,Financial, 
04-Jan-21,-1924.33,272526163,,INTER-BANK CREDIT,87369126085964 WELLS-WATKINS ,-4457.899999999996,Uncategorised, 
05-Jan-21,1779.49,272526163,,INTER-BANK CREDIT,Acevedo-Ward,-2678.409999999996,Uncategorised, 
07-Jan-21,-1277.14,272526163,,INTER-BANK CREDIT,477667230799019 DIAZ-GONZALEZ ,-3955.5499999999965,Financial, 
08-Jan-21,21.24,272526163,,INTER-BANK CREDIT,824103061363989 MATTHEWS KELLY AND MARSHALL ,-3934.3099999999968,Other Income, 
11-Jan-21,-1025.71,272526163,,TRANSFER DEBIT,Randall Shelton and Moore,-4960.019999999997,Financial, 
11-Jan-21,-1428.65,272526163,,TRANSFER DEBIT,202156997657874 POWERS-TREVINO ,-6388.669999999996,Financial, 
12-Jan-21,-1357.37,272526163,,INTER-BANK CREDIT,Hernandez Jordan and Lee,-7746.039999999996,Other Income, 
15-Jan-21,773.25,272526163,,INTER-BANK CREDIT,Schaefer-Daniels,-6972.789999999996,Financial, 
16-Jan-21,1371.89,272526163,,INTER-BANK CREDIT,598858173995870 LAMB LTD ,-5600.899999999996,Bills, 
18-Jan-21,1828.62,272526163,,TRANSFER DEBIT,Carpenter-Ferrell,-3772.279999999996,Bills, 
21-Jan-21,1828.45,272526163,,INTER-BANK CREDIT,46649609991488 GOODMAN GROUP ,-1943.829999999996,Financial, 
21-Jan-21,1272.16,272526163,,INTER-BANK CREDIT,Hernandez Inc,-671.669999999996,Other Income, 
22-Jan-21,694.92,272526163,,INTER-BANK CREDIT,135777114850590 BROWN-VEGA ,23.25000000000398,Other Income, 
25-Jan-21,53.85,272526163,,INTER-BANK CREDIT,Elliott Potter and Smith,77.10000000000397,Other Income, 
26-Jan-21,1901.95,272526163,,TRANSFER DEBIT,575932480407369 BUCKLEY WHITE AND CURTIS ,1979.050000000004,Uncategorised, 
26-Jan-21,-677.68,272526163,,INTER-BANK CREDIT,Wilson Group,1301.370000000004,Financial, 
28-Jan-21,92.18,272526163,,AUTOMATIC DRAWING,657893471629504 JAMES ORR AND TERRELL ,1393.550000000004,Uncategorised, 
28-Jan-21,-1754.9,272526163,,AUTOMATIC DRAWING,Benson-Mason,-361.34999999999604,Financial, 
31-Jan-21,-1374.17,272526163,,TRANSFER DEBIT,Decker Smith and West,-1735.5199999999961,Bills, 
02-Feb-21,22.65,272526163,,AUTOMATIC DRAWING,Fitzgerald Inc,-1712.869999999996,Financial, 
05-Feb-21,-628.49,272526163,,TRANSFER DEBIT,629013485513308 WILSON-CHAMBERS ,-2341.359999999996,Bills, 
06-Feb-21,-1446.81,272526163,,INTER-BANK CREDIT,Turner-Myers,-3788.169999999996,Financial, 
09-Feb-21,1770.38,272526163,,INTER-BANK CREDIT,540452362510362 OLSON BROOKS AND NELSON ,-2017.7899999999959,Other Income, 
09-Feb-21,-988.0,272526163,,INTER-BANK CREDIT,Johnson-Walters,-3005.789999999996,Bills, 
09-Feb-21,1495.78,272526163,,AUTOMATIC DRAWING,Edwards Williams and Patterson,-1510.009999999996,Other Income, 
11-Feb-21,282.38,272526163,,INTER-BANK CREDIT,Mills Inc,-1227.629999999996,Uncategorised, 
14-Feb-21,-1379.41,272526163,,INTER-BANK CREDIT,64383883016577 WOLFE-SERRANO ,-2607.0399999999963,Financial, 
14-Feb-21,1269.62,272526163,,TRANSFER DEBIT,888639138734151 CORDOVA-ARCHER ,-1337.4199999999964,Financial, 
17-Feb-21,-1822.69,272526163,,INTER-BANK CREDIT,Cooper-Williams,-3160.1099999999965,Uncategorised, 
18-Feb-21,672.95,272526163,,INTER-BANK CREDIT,Rubio-Lewis,-2487.159999999996,Financial, 
19-Feb-21,1978.51,272526163,,INTER-BANK CREDIT,788281909070901 GILL GROUP ,-508.6499999999962,Bills, 
21-Feb-21,1338.77,272526163,,INTER-BANK CREDIT,220132609560975 ANDERSEN WHITE AND RIVERA ,830.1200000000038,Other Income, 
21-Feb-21,-1179.89,272526163,,INTER-BANK CREDIT,Rich-Hester,-349.76999999999634,Financial, 
23-Feb-21,-610.62,272526163,,INTER-BANK CREDIT,784317189555480 NELSON BROWN AND COLEMAN ,-960.3899999999963,Uncategorised, 
24-Feb-21,-1912.62,272526163,,AUTOMATIC DRAWING,Bell-Robinson,-2873.009999999996,Financial, 
27-Feb-21,-1737.77,272526163,,INTER-BANK CREDIT,Harper Edwards and Gregory,-4610.779999999996,Financial, 
27-Feb-21,942.41,272526163,,AUTOMATIC DRAWING,Christensen and Sons,-3668.3699999999963,Other Income, 
02-Mar-21,-254.34,272526163,,INTER-BANK CREDIT,Robinson Inc,-3922.7099999999964,Uncategorised, 
02-Mar-21,1103.35,272526163,,TRANSFER DEBIT,924992148664767 MCDOWELL PLC ,-2819.3599999999965,Bills, 
02-Mar-21,-1648.03,272526163,,INTER-BANK CREDIT,525531738181286 FREEMAN-BROWN ,-4467.389999999997,Financial, 
02-Mar-21,70.31,272526163,,AUTOMATIC DRAWING,459759524249058 GARRETT GROUP ,-4397.079999999996,Uncategorised, 
04-Mar-21,-1004.14,272526163,,INTER-BANK CREDIT,Shaw Sanchez and White,-5401.219999999997,Other Income, 
04-Mar-21,197.01,272526163,,AUTOMATIC DRAWING,508905106602073 CHAMBERS-MUNOZ ,-5204.209999999996,Uncategorised, 
04-Mar-21,590.93,272526163,,AUTOMATIC DRAWING,256035639883320 BARRY GROUP ,-4613.279999999996,Other Income, 
04-Mar-21,869.49,272526163,,INTER-BANK CREDIT,Brown Inc,-3743.7899999999963,Other Income, 
07-Mar-21,-367.01,272526163,,TRANSFER DEBIT,Taylor Fox and Davenport,-4110.7999999999965,Financial, 
09-Mar-21,1478.81,272526163,,INTER-BANK CREDIT,Allison-Ward,-2631.9899999999966,Uncategorised, 
11-Mar-21,-585.74,272526163,,TRANSFER DEBIT,Smith and Sons,-3217.729999999997,Other Income, 
14-Mar-21,1288.86,272526163,,TRANSFER DEBIT,Wise Inc,-1928.869999999997,Financial, 
15-Mar-21,-1741.08,272526163,,TRANSFER DEBIT,Garcia-Wheeler,-3669.949999999997,Bills, 
16-Mar-21,202.08,272526163,,TRANSFER DEBIT,Gardner-Williams,-3467.869999999997,Bills, 
19-Mar-21,893.16,272526163,,AUTOMATIC DRAWING,931890400642382 RODRIGUEZ PLC ,-2574.7099999999973,Other Income, 
22-Mar-21,362.09,272526163,,INTER-BANK CREDIT,Perry Fletcher and Nichols,-2212.619999999997,Other Income, 
25-Mar-21,-696.74,272526163,,INTER-BANK CREDIT,Nelson Inc,-2909.359999999997,Uncategorised, 
25-Mar-21,-1381.12,272526163,,TRANSFER DEBIT,Ochoa-Gill,-4290.479999999997,Other Income, 
27-Mar-21,-665.24,272526163,,TRANSFER DEBIT,Brown-Foster,-4955.719999999997,Other Income, 
30-Mar-21,397.13,272526163,,AUTOMATIC DRAWING,559659207415006 MILLER-WALLS ,-4558.5899999999965,Uncategorised, 
02-Apr-21,1193.1,272526163,,INTER-BANK CREDIT,611076310078021 WARD GROUP ,-3365.4899999999966,Bills, 
03-Apr-21,1482.74,272526163,,AUTOMATIC DRAWING,550192427246472 CHAN-LONG ,-1882.7499999999966,Bills, 
04-Apr-21,-975.45,272526163,,AUTOMATIC DRAWING,866994537863786 EWING BURTON AND WILLIAMS ,-2858.1999999999966,Other Income, 
05-Apr-21,479.31,272526163,,TRANSFER DEBIT,413109258019529 MARTIN LTD ,-2378.8899999999967,Uncategorised, 
07-Apr-21,878.84,272526163,,INTER-BANK CREDIT,Armstrong Martinez and Hunter,-1500.0499999999965,Other Income, 
08-Apr-21,-1287.08,272526163,,AUTOMATIC DRAWING,976190839467755 PERRY KING AND CAIN ,-2787.1299999999965,Bills, 
11-Apr-21,-1007.38,272526163,,TRANSFER DEBIT,Garcia Ltd,-3794.5099999999966,Uncategorised, 
12-Apr-21,572.48,272526163,,TRANSFER DEBIT,824365786946566 BARNES-TUCKER ,-3222.0299999999966,Uncategorised, 
12-Apr-21,1156.36,272526163,,TRANSFER DEBIT,Martinez-Edwards,-2065.6699999999964,Bills, 
13-Apr-21,665.58,272526163,,TRANSFER DEBIT,963645811056185 SHAW AND SONS ,-1400.0899999999965,Uncategorised, 
14-Apr-21,1155.15,272526163,,AUTOMATIC DRAWING,Franklin-Weber,-244.93999999999642,Financial, 
16-Apr-21,798.49,272526163,,INTER-BANK CREDIT,931025517405839 LEE SMITH AND GONZALEZ ,553.5500000000036,Bills, 
16-Apr-21,-839.99,272526163,,INTER-BANK CREDIT,Ruiz-Molina,-286.4399999999964,Other Income, 
18-Apr-21,1326.78,272526163,,TRANSFER DEBIT,579808016832354 ROBERTS DELGADO AND MCCARTHY ,1040.3400000000036,Financial, 
19-Apr-21,-793.1,272526163,,INTER-BANK CREDIT,771118426462423 RAMIREZ MILLER AND COX ,247.24000000000353,Financial, 
22-Apr-21,-269.29,272526163,,INTER-BANK CREDIT,Wilson LLC,-22.049999999996487,Bills, 
22-Apr-21,1815.37,272526163,,AUTOMATIC DRAWING,Wilson-Gonzalez,1793.3200000000033,Bills, 
24-Apr-21,-1713.44,272526163,,TRANSFER DEBIT,789905259509952 GARZA MARTINEZ AND WALKER ,79.88000000000329,Other Income, 
25-Apr-21,-622.01,272526163,,INTER-BANK CREDIT,Richards Robinson and Holmes,-542.1299999999967,Uncategorised, 
26-Apr-21,668.99,272526163,,AUTOMATIC DRAWING,Roman and Sons,126.86000000000331,Other Income, 
29-Apr-21,-474.65,272526163,,INTER-BANK CREDIT,Ford-Johnson,-347.78999999999667,Bills, 
30-Apr-21,562.74,272526163,,INTER-BANK CREDIT,Garcia Jackson and Clay,214.95000000000334,Financial, 
02-May-21,-106.61,272526163,,INTER-BANK CREDIT,Smith-Randolph,108.34000000000334,Other Income, 
04-May-21,-219.07,272526163,,INTER-BANK CREDIT,730536775732209 BROWN-HAHN ,-110.72999999999665,Bills, 
04-May-21,-1236.42,272526163,,INTER-BANK CREDIT,Perez Jensen and Ellis,-1347.1499999999967,Other Income, 
04-May-21,947.87,272526163,,AUTOMATIC DRAWING,728532260383449 VALDEZ-OWEN ,-399.2799999999967,Uncategorised, 
05-May-21,-931.75,272526163,,TRANSFER DEBIT,44587033640893 WOODARD LTD ,-1331.0299999999966,Other Income, 
06-May-21,-1386.88,272526163,,INTER-BANK CREDIT,Holloway Group,-2717.9099999999967,Uncategorised, 
08-May-21,-1469.17,272526163,,INTER-BANK CREDIT,415702781559512 NGUYEN GROUP ,-4187.079999999996,Bills, 
10-May-21,-997.81,272526163,,TRANSFER DEBIT,399185173928541 SALAZAR-MARTINEZ ,-5184.889999999996,Bills, 
12-May-21,290.69,272526163,,AUTOMATIC DRAWING,645034897414838 MORGAN-DAVIS ,-4894.199999999996,Other Income, 
14-May-21,-447.34,272526163,,AUTOMATIC DRAWING,414997993506533 MOORE CHRISTENSEN AND DOMINGUEZ ,-5341.539999999996,Uncategorised, 
17-May-21,174.33,272526163,,TRANSFER DEBIT,365284545671633 LANE KIDD AND SANCHEZ ,-5167.209999999996,Financial, 
17-May-21,-1638.99,272526163,,TRANSFER DEBIT,Bass-Rice,-6806.199999999996,Uncategorised, 
19-May-21,-1008.62,272526163,,AUTOMATIC DRAWING,Pace Group,-7814.819999999996,Other Income, 
22-May-21,-1237.16,272526163,,INTER-BANK CREDIT,578527723105749 HILL-DAVIS ,-9051.979999999996,Other Income, 
25-May-21,307.82,272526163,,TRANSFER DEBIT,269832130476945 NELSON-FRANK ,-8744.159999999996,Financial, 
27-May-21,1282.62,272526163,,AUTOMATIC DRAWING,Cook Reynolds and Terrell,-7461.539999999996,Financial, 
28-May-21,1754.57,272526163,,TRANSFER DEBIT,71004218329156 GARCIA HENSLEY AND JENSEN ,-5706.969999999997,Uncategorised, 
31-May-21,-203.88,272526163,,INTER-BANK CREDIT,932878235274409 OWENS PLC ,-5910.849999999997,Other Income, 
01-Jun-21,-475.62,272526163,,INTER-BANK CREDIT,253494409173752 MUNOZ KENNEDY AND RAMIREZ ,-6386.469999999997,Financial, 
01-Jun-21,-120.61,272526163,,INTER-BANK CREDIT,Miller-Simmons,-6507.079999999996,Financial, 
04-Jun-21,366.7,272526163,,AUTOMATIC DRAWING,695648293551976 TURNER ROBINSON AND SMITH ,-6140.3799999999965,Other Income, 
04-Jun-21,-303.41,272526163,,INTER-BANK CREDIT,Reid LLC,-6443.789999999996,Financial, 
05-Jun-21,17.95,272526163,,INTER-BANK CREDIT,Robertson-Anderson,-6425.8399999999965,Uncategorised, 
08-Jun-21,-683.01,272526163,,TRANSFER DEBIT,Clark Group,-7108.849999999997,Bills, 
09-Jun-21,1944.24,272526163,,INTER-BANK CREDIT,Sanders and Sons,-5164.609999999997,Other Income, 
12-Jun-21,-1664.37,272526163,,TRANSFER DEBIT,Hall Potter and Johnson,-6828.979999999997,Financial, 
14-Jun-21,1347.44,272526163,,INTER-BANK CREDIT,384074668124365 WARE-ROMAN ,-5481.539999999997,Financial, 
17-Jun-21,-1671.77,272526163,,AUTOMATIC DRAWING,Reynolds Browning and Rojas,-7153.309999999998,Bills, 
19-Jun-21,-62.81,272526163,,AUTOMATIC DRAWING,Smith-Hall,-7216.119999999998,Bills, 
22-Jun-21,1453.09,272526163,,INTER-BANK CREDIT,206238834251906 WALLACE-VASQUEZ ,-5763.029999999998,Uncategorised, 
24-Jun-21,-1688.95,272526163,,INTER-BANK CREDIT,Sosa Navarro and Lowe,-7451.979999999998,Other Income, 
25-Jun-21,31.26,272526163,,INTER-BANK CREDIT,Garcia-Palmer,-7420.7199999999975,Bills, 
28-Jun-21,-339.48,272526163,,TRANSFER DEBIT,Monroe Peters and Payne,-7760.199999999997,Financial, 
30-Jun-21,903.36,272526163,,INTER-BANK CREDIT,545706204002892 DAVIS AND SONS ,-6856.839999999997,Uncategorised, 
30-Jun-21,-310.74,272526163,,INTER-BANK CREDIT,357693720560493 MCBRIDE AND SONS ,-7167.579999999997,Other Income, 
01-Jul-21,959.95,272526163,,AUTOMATIC DRAWING,375851020713466 WRIGHT SALINAS AND GARRETT ,-6207.629999999997,Other Income, 
02-Jul-21,-1877.85,272526163,,TRANSFER DEBIT,Garcia-Gibson,-8085.479999999998,Financial, 
04-Jul-21,1509.31,272526163,,INTER-BANK CREDIT,917716575719530 COOPER HARRINGTON AND CARTER ,-6576.169999999998,Financial, 
07-Jul-21,-1975.15,272526163,,INTER-BANK CREDIT,Cobb-Taylor,-8551.319999999998,Uncategorised, 
10-Jul-21,-498.52,272526163,,TRANSFER DEBIT,167830197602060 JOHNSON LLC ,-9049.839999999998,Uncategorised, 
13-Jul-21,-1901.03,272526163,,AUTOMATIC DRAWING,138148782528378 RICHARDS GROUP ,-10950.869999999999,Other Income, 
13-Jul-21,1847.41,272526163,,INTER-BANK CREDIT,Cummings Inc,-9103.46,Other Income, 
16-Jul-21,-1530.48,272526163,,AUTOMATIC DRAWING,697862233714189 BARNETT-VALENZUELA ,-10633.939999999999,Uncategorised, 
18-Jul-21,-587.31,272526163,,INTER-BANK CREDIT,698837538779076 VAUGHN AND SONS ,-11221.249999999998,Bills, 
21-Jul-21,-564.96,272526163,,AUTOMATIC DRAWING,168237182363601 HAYES-PITTS ,-11786.21,Other Income, 
24-Jul-21,446.85,272526163,,INTER-BANK CREDIT,Lynn Simmons and Mcmahon,-11339.359999999999,Financial, 
25-Jul-21,-1201.37,272526163,,INTER-BANK CREDIT,Rodriguez-Brown,-12540.73,Uncategorised, 
25-Jul-21,1847.81,272526163,,INTER-BANK CREDIT,372985010501824 MCCLURE BURTON AND SUTTON ,-10692.92,Other Income, 
25-Jul-21,-1557.6,272526163,,INTER-BANK CREDIT,Lin-Crawford,-12250.52,Other Income, 
27-Jul-21,-898.76,272526163,,AUTOMATIC DRAWING,Gonzalez and Sons,-13149.28,Bills, 
30-Jul-21,1098.37,272526163,,TRANSFER DEBIT,Johnson Pearson and Johnson,-12050.91,Uncategorised, 
30-Jul-21,592.3,272526163,,TRANSFER DEBIT,Farmer Davenport and Sanchez,-11458.61,Uncategorised, 
01-Aug-21,1388.94,272526163,,INTER-BANK CREDIT,Garrison Dodson and Robertson,-10069.67,Bills, 
02-Aug-21,-468.8,272526163,,TRANSFER DEBIT,368276080234283 DAVIS-WILLIAMS ,-10538.47,Other Income, 
03-Aug-21,-1143.92,272526163,,TRANSFER DEBIT,758246294993522 BRENNAN INC ,-11682.39,Bills, 
03-Aug-21,-514.56,272526163,,AUTOMATIC DRAWING,726399768274999 WEAVER-ORTIZ ,-12196.949999999999,Other Income, 
06-Aug-21,-1475.85,272526163,,INTER-BANK CREDIT,Fernandez-Payne,-13672.8,Bills, 
07-Aug-21,-430.09,272526163,,INTER-BANK CREDIT,204970247117396 CROSS LTD ,-14102.89,Other Income, 
09-Aug-21,-502.21,272526163,,INTER-BANK CREDIT,Alexander LLC,-14605.099999999999,Uncategorised, 
11-Aug-21,1863.2,272526163,,INTER-BANK CREDIT,Warren West and Cabrera,-12741.899999999998,Other Income, 
12-Aug-21,-540.72,272526163,,TRANSFER DEBIT,Reed-Lopez,-13282.619999999997,Financial, 
14-Aug-21,-1281.19,272526163,,TRANSFER DEBIT,669176583297983 JOHNSON PONCE AND HAYES ,-14563.809999999998,Other Income, 
16-Aug-21,-581.47,272526163,,INTER-BANK CREDIT,Mata Ferguson and Matthews,-15145.279999999997,Uncategorised, 
17-Aug-21,1924.2,272526163,,INTER-BANK CREDIT,871856416302474 BENTON-SANCHEZ ,-13221.079999999996,Other Income, 
18-Aug-21,-1633.32,272526163,,INTER-BANK CREDIT,928081038975010 PERRY INC ,-14854.399999999996,Uncategorised, 
18-Aug-21,-1797.36,272526163,,INTER-BANK CREDIT,74877039020472 KAISER NEWTON AND HAMILTON ,-16651.759999999995,Bills, 
18-Aug-21,-893.1,272526163,,INTER-BANK CREDIT,970387038497985 BELL-BOYD ,-17544.859999999993,Uncategorised, 
21-Aug-21,-796.4,272526163,,AUTOMATIC DRAWING,Frey and Sons,-18341.259999999995,Financial, 
23-Aug-21,802.26,272526163,,INTER-BANK CREDIT,213029789058244 SHEPHERD-GRIFFITH ,-17538.999999999996,Bills, 
23-Aug-21,-34.37,272526163,,INTER-BANK CREDIT,Mckinney Inc,-17573.369999999995,Uncategorised, 
24-Aug-21,1704.34,272526163,,AUTOMATIC DRAWING,811870040382195 HEBERT THOMAS AND HUTCHINSON ,-15869.029999999995,Uncategorised, 
26-Aug-21,-942.0,272526163,,INTER-BANK CREDIT,Hunter White and Osborne,-16811.029999999995,Uncategorised, 
29-Aug-21,-1177.94,272526163,,INTER-BANK CREDIT,835856908524119 DUNN-MORSE ,-17988.969999999994,Financial, 
01-Sep-21,1208.52,272526163,,INTER-BANK CREDIT,960776054348693 HOOD-DOMINGUEZ ,-16780.449999999993,Uncategorised, 
03-Sep-21,374.85,272526163,,TRANSFER DEBIT,Villegas-Obrien,-16405.599999999995,Bills, 
05-Sep-21,293.98,272526163,,TRANSFER DEBIT,Rush-Mckay,-16111.619999999995,Financial, 
07-Sep-21,649.51,272526163,,INTER-BANK CREDIT,White Smith and Baxter,-15462.109999999995,Bills, 
08-Sep-21,-1240.95,272526163,,AUTOMATIC DRAWING,859061283262839 GUTIERREZ MCDONALD AND WILSON ,-16703.059999999994,Bills, 
09-Sep-21,910.01,272526163,,AUTOMATIC DRAWING,Gross Smith and Bryant,-15793.049999999994,Bills, 
12-Sep-21,-576.98,272526163,,INTER-BANK CREDIT,Evans Group,-16370.029999999993,Uncategorised, 
13-Sep-21,-227.94,272526163,,TRANSFER DEBIT,853653197745386 BARRERA INC ,-16597.969999999994,Bills, 
13-Sep-21,190.42,272526163,,AUTOMATIC DRAWING,156773077858236 SANCHEZ LOPEZ AND HOWELL ,-16407.549999999996,Other Income, 
15-Sep-21,1314.42,272526163,,INTER-BANK CREDIT,974359744564284 ROBERTS AND SONS ,-15093.129999999996,Financial, 
17-Sep-21,-449.44,272526163,,AUTOMATIC DRAWING,Reyes-Williams,-15542.569999999996,Uncategorised, 
17-Sep-21,1505.51,272526163,,TRANSFER DEBIT,888823216715081 HINES PLC ,-14037.059999999996,Bills, 
17-Sep-21,1325.35,272526163,,TRANSFER DEBIT,Mendez-Beard,-12711.709999999995,Other Income, 
18-Sep-21,1612.16,272526163,,INTER-BANK CREDIT,Lopez Wilson and Johnson,-11099.549999999996,Financial, 
19-Sep-21,-240.06,272526163,,INTER-BANK CREDIT,371649675132198 QUINN PLC ,-11339.609999999995,Uncategorised, 
22-Sep-21,-511.97,272526163,,AUTOMATIC DRAWING,Sanchez-Lynch,-11851.579999999994,Financial, 
24-Sep-21,-1602.2,272526163,,AUTOMATIC DRAWING,Crawford PLC,-13453.779999999995,Other Income, 
26-Sep-21,1755.36,272526163,,TRANSFER DEBIT,Clark Group,-11698.419999999995,Financial, 
27-Sep-21,-1104.06,272526163,,AUTOMATIC DRAWING,Bishop-Andersen,-12802.479999999994,Uncategorised, 
28-Sep-21,-1319.98,272526163,,TRANSFER DEBIT,Patterson-Parker,-14122.459999999994,Other Income, 
30-Sep-21,-1040.98,272526163,,INTER-BANK CREDIT,Walker Morrison and Castro,-15163.439999999993,Other Income, 
02-Oct-21,1342.58,272526163,,AUTOMATIC DRAWING,Mcdonald-Simmons,-13820.859999999993,Other Income, 
05-Oct-21,-929.91,272526163,,INTER-BANK CREDIT,Jones Freeman and Smith,-14750.769999999993,Uncategorised, 
08-Oct-21,1948.92,272526163,,INTER-BANK CREDIT,Thompson-Martinez,-12801.849999999993,Other Income, 
08-Oct-21,311.23,272526163,,AUTOMATIC DRAWING,Allen Ltd,-12490.619999999994,Other Income, 
10-Oct-21,-1692.19,272526163,,INTER-BANK CREDIT,831014256185696 MORRIS SMITH AND BENNETT ,-14182.809999999994,Bills, 
12-Oct-21,1196.79,272526163,,AUTOMATIC DRAWING,Thompson Myers and Rowe,-12986.019999999993,Other Income, 
14-Oct-21,1073.43,272526163,,INTER-BANK CREDIT,Young-Jones,-11912.589999999993,Financial, 
15-Oct-21,759.9,272526163,,AUTOMATIC DRAWING,510695048279917 GLOVER GROUP ,-11152.689999999993,Financial, 
18-Oct-21,237.67,272526163,,AUTOMATIC DRAWING,Reynolds Ltd,-10915.019999999993,Financial, 
18-Oct-21,-48.19,272526163,,TRANSFER DEBIT,527808116334600 MURPHY NICHOLS AND MAY ,-10963.209999999994,Uncategorised, 
18-Oct-21,1115.1,272526163,,INTER-BANK CREDIT,220763098915600 GRANT LTD ,-9848.109999999993,Other Income, 
19-Oct-21,-1851.21,272526163,,INTER-BANK CREDIT,Lewis Group,-11699.319999999992,Other Income, 
21-Oct-21,548.73,272526163,,INTER-BANK CREDIT,587088333689283 GARCIA HERNANDEZ AND TURNER ,-11150.589999999993,Financial, 
24-Oct-21,-613.9,272526163,,AUTOMATIC DRAWING,James Group,-11764.489999999993,Financial, 
24-Oct-21,171.65,272526163,,INTER-BANK CREDIT,Martinez LLC,-11592.839999999993,Other Income, 
24-Oct-21,966.61,272526163,,TRANSFER DEBIT,White Myers and Miller,-10626.229999999992,Bills, 
26-Oct-21,-825.75,272526163,,INTER-BANK CREDIT,951955405609962 RICHARDSON PLC ,-11451.979999999992,Other Income, 
27-Oct-21,-693.63,272526163,,TRANSFER DEBIT,103157528826891 HALL GROUP ,-12145.609999999991,Uncategorised, 
28-Oct-21,-1447.28,272526163,,TRANSFER DEBIT,619916423007615 MIRANDA-NOVAK ,-13592.889999999992,Financial, 
28-Oct-21,1119.97,272526163,,AUTOMATIC DRAWING,683239172925491 SMITH-CARROLL ,-12472.919999999993,Uncategorised, 
28-Oct-21,523.35,272526163,,AUTOMATIC DRAWING,Frazier Group,-11949.569999999992,Uncategorised, 
31-Oct-21,1196.53,272526163,,INTER-BANK CREDIT,Conner Inc,-10753.039999999992,Other Income, 
02-Nov-21,626.56,272526163,,AUTOMATIC DRAWING,Williams Group,-10126.479999999992,Uncategorised, 
05-Nov-21,-164.21,272526163,,AUTOMATIC DRAWING,390255916354964 WOLF INGRAM AND CRAWFORD ,-10290.689999999991,Other Income, 
07-Nov-21,-1432.96,272526163,,TRANSFER DEBIT,410103449995356 GONZALEZ GROUP ,-11723.64999999999,Other Income, 
08-Nov-21,-830.06,272526163,,TRANSFER DEBIT,194723963427674 WALLER COOPER AND KHAN ,-12553.70999999999,Bills, 
08-Nov-21,-1534.1,272526163,,TRANSFER DEBIT,303434176260636 HORTON-LITTLE ,-14087.80999999999,Financial, 
08-Nov-21,766.85,272526163,,INTER-BANK CREDIT,Holden-Garcia,-13320.95999999999,Other Income, 
09-Nov-21,-1162.65,272526163,,INTER-BANK CREDIT,535203395703587 GUTIERREZ-MARTINEZ ,-14483.60999999999,Bills, 
11-Nov-21,-966.8,272526163,,INTER-BANK CREDIT,674463860123537 FLORES JOYCE AND DUNCAN ,-15450.409999999989,Financial, 
11-Nov-21,263.63,272526163,,TRANSFER DEBIT,Taylor PLC,-15186.77999999999,Uncategorised, 
11-Nov-21,-1488.86,272526163,,AUTOMATIC DRAWING,550990029201195 TODD FOX AND SMITH ,-16675.63999999999,Uncategorised, 
14-Nov-21,-861.68,272526163,,INTER-BANK CREDIT,870683208767047 ALEXANDER-ROBINSON ,-17537.31999999999,Uncategorised, 
16-Nov-21,154.12,272526163,,AUTOMATIC DRAWING,Curry Henry and Jackson,-17383.19999999999,Uncategorised, 
19-Nov-21,-118.56,272526163,,TRANSFER DEBIT,777200377088586 SIMMONS COOPER AND THOMPSON ,-17501.75999999999,Bills, 
21-Nov-21,-444.73,272526163,,INTER-BANK CREDIT,377583096591630 JOHNSON STEVENS AND DUNCAN ,-17946.48999999999,Uncategorised, 
22-Nov-21,298.76,272526163,,TRANSFER DEBIT,281399304111024 GOODWIN STEWART AND HALL ,-17647.729999999992,Bills, 
23-Nov-21,642.35,272526163,,INTER-BANK CREDIT,691436366517986 CHASE LTD ,-17005.379999999994,Other Income, 
26-Nov-21,-310.6,272526163,,INTER-BANK CREDIT,Franklin PLC,-17315.979999999992,Financial, 
29-Nov-21,19.08,272526163,,INTER-BANK CREDIT,60266193805527 AUSTIN-HOLMES ,-17296.89999999999,Bills, 
29-Nov-21,-1313.76,272526163,,TRANSFER DEBIT,743618904476268 MARSHALL PLC ,-18610.65999999999,Uncategorised, 
02-Dec-21,-739.38,272526163,,INTER-BANK CREDIT,Thompson-Bates,-19350.03999999999,Financial, 
04-Dec-21,-135.34,272526163,,INTER-BANK CREDIT,Robertson Fox and Ho,-19485.37999999999,Uncategorised, 
07-Dec-21,-405.44,272526163,,TRANSFER DEBIT,755374742556232 KING EVANS AND BROOKS ,-19890.81999999999,Uncategorised, 
07-Dec-21,1783.84,272526163,,TRANSFER DEBIT,24801474810262 SCOTT-EDWARDS ,-18106.97999999999,Other Income, 
10-Dec-21,1684.3,272526163,,INTER-BANK CREDIT,204293791819195 WILLIAMS FRANK AND SCHNEIDER ,-16422.67999999999,Other Income, 
13-Dec-21,1297.65,272526163,,TRANSFER DEBIT,682835969654505 BROWN LEWIS AND WHITAKER ,-15125.02999999999,Other Income, 
13-Dec-21,-230.28,272526163,,AUTOMATIC DRAWING,856885862036595 HERNANDEZ ARNOLD AND RAMIREZ ,-15355.30999999999,Financial, 
14-Dec-21,1228.71,272526163,,INTER-BANK CREDIT,Davis PLC,-14126.599999999991,Uncategorised, 
15-Dec-21,1517.48,272526163,,AUTOMATIC DRAWING,Davis Inc,-12609.119999999992,Bills, 
15-Dec-21,-538.25,272526163,,INTER-BANK CREDIT,Reynolds Inc,-13147.369999999992,Financial, 
18-Dec-21,1213.93,272526163,,TRANSFER DEBIT,Parker Thomas and Miller,-11933.439999999991,Uncategorised, 
19-Dec-21,-1293.65,272526163,,TRANSFER DEBIT,759533974027269 JAMES-COOPER ,-13227.089999999991,Other Income, 
22-Dec-21,-458.31,272526163,,INTER-BANK CREDIT,953593062272011 ESTES GROUP ,-13685.39999999999,Uncategorised, 
23-Dec-21,-625.2,272526163,,INTER-BANK CREDIT,965689434878731 JENNINGS LLC ,-14310.599999999991,Uncategorised, 
23-Dec-21,362.42,272526163,,INTER-BANK CREDIT,Walters Yang and Marshall,-13948.179999999991,Bills, 
24-Dec-21,645.79,272526163,,INTER-BANK CREDIT,885506847458271 MILLER-RAMIREZ ,-13302.389999999992,Bills, 
25-Dec-21,315.61,272526163,,INTER-BANK CREDIT,May-Porter,-12986.779999999992,Other Income, 
28-Dec-21,-148.21,272526163,,TRANSFER DEBIT,9426438029091 WRIGHT GROUP ,-13134.98999999999,Other Income, 
31-Dec-21,-1236.83,272526163,,INTER-BANK CREDIT,782394320816557 BRUCE LLC ,-14371.81999999999,Financial, 
01-Jan-22,-1207.46,272526163,,INTER-BANK CREDIT,Robinson PLC,-15579.279999999992,Uncategorised, 
04-Jan-22,-241.98,272526163,,TRANSFER DEBIT,Carr Smith and Chapman,-15821.259999999991,Uncategorised, 
05-Jan-22,-345.51,272526163,,INTER-BANK CREDIT,Frederick and Sons,-16166.769999999991,Other Income, 
08-Jan-22,971.21,272526163,,AUTOMATIC DRAWING,Cohen Horton and Rice,-15195.55999999999,Uncategorised, 
10-Jan-22,104.48,272526163,,INTER-BANK CREDIT,809833640133455 WHITE LLC ,-15091.07999999999,Uncategorised, 
13-Jan-22,-1046.99,272526163,,INTER-BANK CREDIT,749275374693880 BOYD-NORRIS ,-16138.06999999999,Bills, 
15-Jan-22,-898.6,272526163,,INTER-BANK CREDIT,340747205479697 OBRIEN COSTA AND ALEXANDER ,-17036.66999999999,Financial, 
16-Jan-22,-1452.53,272526163,,TRANSFER DEBIT,Hall Christensen and Johnson,-18489.19999999999,Financial, 
16-Jan-22,-165.48,272526163,,TRANSFER DEBIT,Nelson PLC,-18654.67999999999,Other Income, 
18-Jan-22,5.83,272526163,,INTER-BANK CREDIT,807326648165784 HOLT MARTINEZ AND SANTIAGO ,-18648.849999999988,Other Income, 
18-Jan-22,746.95,272526163,,TRANSFER DEBIT,362580610359901 MAYER MCKINNEY AND HAYES ,-17901.899999999987,Uncategorised, 
18-Jan-22,-326.6,272526163,,TRANSFER DEBIT,40388907966082 GARCIA RICHARDS AND MARTIN ,-18228.499999999985,Other Income, 
19-Jan-22,-988.57,272526163,,INTER-BANK CREDIT,Crawford Hernandez and Patel,-19217.069999999985,Financial, 
20-Jan-22,-1718.37,272526163,,AUTOMATIC DRAWING,519379623504381 BAKER-REYNOLDS ,-20935.439999999984,Bills, 
21-Jan-22,-606.29,272526163,,INTER-BANK CREDIT,Medina-Bishop,-21541.729999999985,Other Income, 
21-Jan-22,901.67,272526163,,TRANSFER DEBIT,600202178603045 KEY HEBERT AND COOPER ,-20640.059999999987,Uncategorised, 
24-Jan-22,668.13,272526163,,TRANSFER DEBIT,Haynes Inc,-19971.929999999986,Bills, 
26-Jan-22,-327.89,272526163,,AUTOMATIC DRAWING,646825241464858 VAUGHN LTD ,-20299.819999999985,Bills, 
28-Jan-22,-221.18,272526163,,INTER-BANK CREDIT,Turner-Griffin,-20520.999999999985,Bills, 
29-Jan-22,-241.72,272526163,,INTER-BANK CREDIT,Weaver Ltd,-20762.719999999987,Financial, 
30-Jan-22,-1369.55,272526163,,AUTOMATIC DRAWING,Holland-Miles,-22132.269999999986,Financial, 
31-Jan-22,-980.8,272526163,,AUTOMATIC DRAWING,929467270177196 VARGAS-HURLEY ,-23113.069999999985,Bills, 
01-Feb-22,1271.07,272526163,,INTER-BANK CREDIT,Hall Vasquez and Cooper,-21841.999999999985,Other Income, 
03-Feb-22,-832.22,272526163,,INTER-BANK CREDIT,660123861331461 SCHNEIDER PLC ,-22674.219999999987,Bills, 
04-Feb-22,-706.56,272526163,,AUTOMATIC DRAWING,487217858235516 BOWERS-BELL ,-23380.779999999988,Financial, 
06-Feb-22,-1500.1,272526163,,INTER-BANK CREDIT,Schultz PLC,-24880.879999999986,Bills, 
07-Feb-22,-90.1,272526163,,AUTOMATIC DRAWING,Kline Barnett and Randolph,-24970.979999999985,Uncategorised, 
09-Feb-22,-1201.21,272526163,,INTER-BANK CREDIT,305182700209854 CARROLL BROWN AND BRYANT ,-26172.189999999984,Uncategorised, 
11-Feb-22,-1326.46,272526163,,INTER-BANK CREDIT,683166980541333 HUGHES-KAUFMAN ,-27498.649999999983,Uncategorised, 
12-Feb-22,-635.62,272526163,,INTER-BANK CREDIT,Lopez-Gordon,-28134.269999999982,Uncategorised, 
13-Feb-22,-1396.77,272526163,,AUTOMATIC DRAWING,236237138107143 CLAYTON REYES AND BROWN ,-29531.039999999983,Bills, 
13-Feb-22,1651.22,272526163,,TRANSFER DEBIT,126347066951307 ROSE-WATSON ,-27879.81999999998,Other Income, 
15-Feb-22,916.2,272526163,,TRANSFER DEBIT,761433730629608 KEITH COLE AND MURPHY ,-26963.61999999998,Bills, 
15-Feb-22,1495.77,272526163,,AUTOMATIC DRAWING,598913909663315 SOTO HERRING AND CONTRERAS ,-25467.84999999998,Other Income, 
