Date,Amount,Account Number,,Transaction Type,Transaction Details,Balance,Category,Merchants Name
23-Apr-16,-207.76,818726672,,TRANSFER DEBIT,355356312460872 ESPARZA INC ,-8161.76,Financial, 
24-Apr-16,-145.68,818726672,,TRANSFER DEBIT,Taylor Group,-8307.44,Financial, 
26-Apr-16,470.9,818726672,,TRANSFER DEBIT,664141708178837 VALDEZ INC ,-7836.540000000001,Bills, 
29-Apr-16,-518.83,818726672,,INTER-BANK CREDIT,May-Williams,-8355.37,Uncategorised, 
02-May-16,274.36,818726672,,AUTOMATIC DRAWING,Williams Neal and Fuentes,-8081.010000000001,Uncategorised, 
04-May-16,-901.44,818726672,,TRANSFER DEBIT,Nelson Duncan and Baird,-8982.45,Bills, 
06-May-16,-596.43,818726672,,TRANSFER DEBIT,982165197861722 HOBBS LUNA AND GARCIA ,-9578.880000000001,Uncategorised, 
07-May-16,544.4,818726672,,TRANSFER DEBIT,Harris Ayala and Richards,-9034.480000000001,Uncategorised, 
09-May-16,264.51,818726672,,INTER-BANK CREDIT,542451684260504 VELAZQUEZ PORTER AND BAILEY ,-8769.970000000001,Other Income, 
09-May-16,-1036.05,818726672,,INTER-BANK CREDIT,973130765459728 GONZALEZ LLC ,-9806.02,Bills, 
11-May-16,676.59,818726672,,TRANSFER DEBIT,816496406698671 PEREZ INC ,-9129.43,Financial, 
12-May-16,-200.62,818726672,,AUTOMATIC DRAWING,415480793872650 JOHNSON-WILLIAMS ,-9330.050000000001,Financial, 
15-May-16,-1499.63,818726672,,TRANSFER DEBIT,597086150527130 MOORE MORENO AND WHITE ,-10829.68,Uncategorised, 
15-May-16,-1409.36,818726672,,AUTOMATIC DRAWING,290767381225378 MARTINEZ PLC ,-12239.04,Other Income, 
17-May-16,1199.52,818726672,,TRANSFER DEBIT,355322055017938 POWERS-TAYLOR ,-11039.52,Uncategorised, 
19-May-16,-1124.97,818726672,,INTER-BANK CREDIT,Wheeler Morris and Allen,-12164.49,Other Income, 
21-May-16,-1499.51,818726672,,TRANSFER DEBIT,136400052046525 BUCK AND SONS ,-13664.0,Uncategorised, 
24-May-16,1482.66,818726672,,INTER-BANK CREDIT,337051758737215 JUAREZ HAMILTON AND MONTES ,-12181.34,Other Income, 
27-May-16,1702.1,818726672,,AUTOMATIC DRAWING,110116717050855 SMITH BROWN AND SAUNDERS ,-10479.24,Bills, 
29-May-16,-1071.53,818726672,,INTER-BANK CREDIT,Schneider Carlson and Brown,-11550.77,Other Income, 
29-May-16,-1322.31,818726672,,INTER-BANK CREDIT,589232306134567 SPARKS-JENNINGS ,-12873.08,Uncategorised, 
29-May-16,1406.46,818726672,,TRANSFER DEBIT,Dennis-Jensen,-11466.619999999999,Financial, 
30-May-16,-90.7,818726672,,AUTOMATIC DRAWING,386442502915295 POWELL CUNNINGHAM AND LOPEZ ,-11557.32,Financial, 
30-May-16,1807.74,818726672,,TRANSFER DEBIT,293343309518348 BELL GROUP ,-9749.58,Uncategorised, 
31-May-16,22.73,818726672,,AUTOMATIC DRAWING,Leonard-Mason,-9726.85,Other Income, 
31-May-16,-1163.79,818726672,,TRANSFER DEBIT,252895750279731 OLIVER PLC ,-10890.64,Financial, 
01-Jun-16,1781.89,818726672,,INTER-BANK CREDIT,352614129943210 PERRY-ROBERTS ,-9108.75,Uncategorised, 
01-Jun-16,-1434.42,818726672,,INTER-BANK CREDIT,796674953790134 SMITH GROUP ,-10543.17,Bills, 
01-Jun-16,407.79,818726672,,TRANSFER DEBIT,464352266198999 BARNETT AND SONS ,-10135.38,Other Income, 
01-Jun-16,-510.17,818726672,,INTER-BANK CREDIT,922259628106109 JOHNSON HENSON AND RUIZ ,-10645.55,Financial, 
03-Jun-16,310.06,818726672,,INTER-BANK CREDIT,Roach-Flores,-10335.49,Bills, 
04-Jun-16,1919.63,818726672,,TRANSFER DEBIT,Hawkins Group,-8415.86,Uncategorised, 
06-Jun-16,-317.75,818726672,,TRANSFER DEBIT,204461938306319 BROWN-WISE ,-8733.61,Uncategorised, 
09-Jun-16,949.73,818726672,,INTER-BANK CREDIT,41378264957543 HENDERSON LTD ,-7783.880000000001,Bills, 
09-Jun-16,1395.12,818726672,,TRANSFER DEBIT,382418581327798 HARRINGTON-HILL ,-6388.760000000001,Uncategorised, 
11-Jun-16,-706.57,818726672,,TRANSFER DEBIT,Cabrera Group,-7095.330000000001,Bills, 
12-Jun-16,-1804.73,818726672,,INTER-BANK CREDIT,819351492965800 HERRERA CLARK AND COLLINS ,-8900.060000000001,Bills, 
14-Jun-16,1074.9,818726672,,AUTOMATIC DRAWING,Vasquez Shaffer and Smith,-7825.160000000002,Other Income, 
15-Jun-16,-1856.79,818726672,,INTER-BANK CREDIT,Collins Weber and Newman,-9681.95,Uncategorised, 
16-Jun-16,-1264.7,818726672,,AUTOMATIC DRAWING,949664976388192 EATON PLC ,-10946.650000000001,Other Income, 
18-Jun-16,1952.07,818726672,,AUTOMATIC DRAWING,885871721014974 WHITAKER-WEBSTER ,-8994.580000000002,Bills, 
20-Jun-16,1059.98,818726672,,INTER-BANK CREDIT,563602363564125 HOLMES-WALLACE ,-7934.600000000002,Uncategorised, 
21-Jun-16,-689.01,818726672,,AUTOMATIC DRAWING,837446527933166 HILL JONES AND CAMPBELL ,-8623.610000000002,Bills, 
24-Jun-16,1055.86,818726672,,AUTOMATIC DRAWING,987062728865749 LOPEZ LTD ,-7567.750000000003,Bills, 
25-Jun-16,-1942.69,818726672,,TRANSFER DEBIT,615644891518768 ORTEGA AND SONS ,-9510.440000000002,Bills, 
25-Jun-16,1404.25,818726672,,TRANSFER DEBIT,Lawson-Williams,-8106.190000000002,Financial, 
26-Jun-16,310.03,818726672,,INTER-BANK CREDIT,Butler Walker and Moore,-7796.160000000003,Uncategorised, 
26-Jun-16,-766.18,818726672,,INTER-BANK CREDIT,Cain Inc,-8562.340000000002,Financial, 
28-Jun-16,-1814.19,818726672,,AUTOMATIC DRAWING,Patel LLC,-10376.530000000002,Financial, 
29-Jun-16,-1923.62,818726672,,TRANSFER DEBIT,Brown-Massey,-12300.150000000001,Other Income, 
02-Jul-16,-893.28,818726672,,INTER-BANK CREDIT,Sexton-Walsh,-13193.430000000002,Other Income, 
05-Jul-16,-1159.29,818726672,,AUTOMATIC DRAWING,758762132843979 ESTRADA AND SONS ,-14352.720000000001,Bills, 
05-Jul-16,-383.38,818726672,,INTER-BANK CREDIT,579843965158147 GARNER SMITH AND JOHNSON ,-14736.1,Other Income, 
08-Jul-16,1384.64,818726672,,TRANSFER DEBIT,Campbell-Kirby,-13351.460000000001,Uncategorised, 
10-Jul-16,1659.79,818726672,,TRANSFER DEBIT,Duran-Yoder,-11691.670000000002,Financial, 
13-Jul-16,-1392.35,818726672,,INTER-BANK CREDIT,277405148991768 REED PLC ,-13084.020000000002,Other Income, 
16-Jul-16,-1650.48,818726672,,AUTOMATIC DRAWING,Wells Morrow and Zimmerman,-14734.500000000002,Uncategorised, 
16-Jul-16,971.42,818726672,,TRANSFER DEBIT,Banks LLC,-13763.080000000002,Uncategorised, 
16-Jul-16,-1638.08,818726672,,INTER-BANK CREDIT,762270361350689 FITZGERALD FAULKNER AND COLLINS ,-15401.160000000002,Uncategorised, 
17-Jul-16,310.04,818726672,,INTER-BANK CREDIT,Woods Dickerson and Winters,-15091.12,Bills, 
18-Jul-16,-1489.92,818726672,,INTER-BANK CREDIT,Greene-Washington,-16581.04,Financial, 
19-Jul-16,-171.0,818726672,,TRANSFER DEBIT,Ford-White,-16752.04,Financial, 
22-Jul-16,321.61,818726672,,INTER-BANK CREDIT,419917699653623 CONTRERAS VAUGHN AND FARMER ,-16430.43,Financial, 
24-Jul-16,1549.72,818726672,,AUTOMATIC DRAWING,814286251607904 LEE-CAMPBELL ,-14880.710000000001,Uncategorised, 
27-Jul-16,-666.62,818726672,,TRANSFER DEBIT,445844370178828 LEE LLC ,-15547.330000000002,Uncategorised, 
28-Jul-16,672.37,818726672,,INTER-BANK CREDIT,Kane-Reed,-14874.960000000001,Other Income, 
31-Jul-16,810.54,818726672,,AUTOMATIC DRAWING,299058750934800 HICKS LLC ,-14064.420000000002,Uncategorised, 
01-Aug-16,1223.35,818726672,,INTER-BANK CREDIT,Love-Lowe,-12841.070000000002,Bills, 
02-Aug-16,-1202.49,818726672,,INTER-BANK CREDIT,Jones-Hanson,-14043.560000000001,Other Income, 
03-Aug-16,-1554.55,818726672,,TRANSFER DEBIT,518325526919824 WILLIAMS BARRY AND VASQUEZ ,-15598.11,Bills, 
04-Aug-16,1744.83,818726672,,INTER-BANK CREDIT,Fowler Callahan and Nelson,-13853.28,Bills, 
05-Aug-16,206.4,818726672,,AUTOMATIC DRAWING,Fisher Hanson and Weaver,-13646.880000000001,Financial, 
08-Aug-16,-986.11,818726672,,INTER-BANK CREDIT,Sullivan-Maldonado,-14632.990000000002,Bills, 
10-Aug-16,-1163.93,818726672,,AUTOMATIC DRAWING,Davis-Smith,-15796.920000000002,Financial, 
12-Aug-16,1006.51,818726672,,INTER-BANK CREDIT,524799345113237 ROBINSON PLC ,-14790.410000000002,Other Income, 
13-Aug-16,-1287.72,818726672,,AUTOMATIC DRAWING,Evans Ltd,-16078.130000000001,Bills, 
13-Aug-16,-858.86,818726672,,AUTOMATIC DRAWING,Osborn PLC,-16936.99,Bills, 
13-Aug-16,831.04,818726672,,AUTOMATIC DRAWING,571789171086534 ELLIS BRADLEY AND JACKSON ,-16105.95,Uncategorised, 
15-Aug-16,1696.56,818726672,,INTER-BANK CREDIT,310584443910322 GREEN HOWARD AND LEWIS ,-14409.390000000001,Financial, 
18-Aug-16,1559.4,818726672,,INTER-BANK CREDIT,622363092920805 WILLIAMS-DUNCAN ,-12849.990000000002,Financial, 
18-Aug-16,-1157.81,818726672,,TRANSFER DEBIT,543249022357410 LONG-HARTMAN ,-14007.800000000001,Bills, 
19-Aug-16,-523.51,818726672,,INTER-BANK CREDIT,997703002076328 FAULKNER PLC ,-14531.310000000001,Financial, 
19-Aug-16,110.27,818726672,,AUTOMATIC DRAWING,440844639042058 CHRISTIAN LLC ,-14421.04,Uncategorised, 
21-Aug-16,546.27,818726672,,INTER-BANK CREDIT,Hoffman Ltd,-13874.77,Other Income, 
23-Aug-16,1770.18,818726672,,AUTOMATIC DRAWING,99701343790966 SMITH LLC ,-12104.59,Bills, 
26-Aug-16,-1837.54,818726672,,INTER-BANK CREDIT,507288991381768 HALL GROUP ,-13942.130000000001,Uncategorised, 
26-Aug-16,-631.84,818726672,,INTER-BANK CREDIT,Rodriguez Evans and Gilmore,-14573.970000000001,Other Income, 
27-Aug-16,-1693.67,818726672,,INTER-BANK CREDIT,Russo Forbes and Bell,-16267.640000000001,Financial, 
27-Aug-16,-1508.67,818726672,,AUTOMATIC DRAWING,Chavez Beck and Hill,-17776.31,Uncategorised, 
27-Aug-16,-464.6,818726672,,INTER-BANK CREDIT,Jones-Flores,-18240.91,Bills, 
30-Aug-16,1625.05,818726672,,TRANSFER DEBIT,Newton PLC,-16615.86,Other Income, 
02-Sep-16,-1721.13,818726672,,INTER-BANK CREDIT,296428830408389 FARLEY PLC ,-18336.99,Uncategorised, 
05-Sep-16,517.34,818726672,,INTER-BANK CREDIT,52335187037965 WADE-HENDERSON ,-17819.65,Uncategorised, 
08-Sep-16,-1255.58,818726672,,INTER-BANK CREDIT,873149109449221 JOHNSON-CLINE ,-19075.230000000003,Uncategorised, 
10-Sep-16,-1489.25,818726672,,INTER-BANK CREDIT,662107911311519 RAMIREZ AND SONS ,-20564.480000000003,Financial, 
12-Sep-16,1904.43,818726672,,INTER-BANK CREDIT,548625470209045 KNIGHT-STEVENS ,-18660.050000000003,Bills, 
13-Sep-16,-497.53,818726672,,AUTOMATIC DRAWING,Taylor Hays and Hicks,-19157.58,Uncategorised, 
13-Sep-16,985.77,818726672,,TRANSFER DEBIT,Patel-Jackson,-18171.81,Financial, 
13-Sep-16,507.0,818726672,,INTER-BANK CREDIT,Wright and Sons,-17664.81,Uncategorised, 
15-Sep-16,-486.9,818726672,,INTER-BANK CREDIT,Perry Inc,-18151.710000000003,Bills, 
15-Sep-16,-1374.59,818726672,,TRANSFER DEBIT,35109495491347 KELLEY LEWIS AND JOHNSON ,-19526.300000000003,Uncategorised, 
17-Sep-16,1507.49,818726672,,INTER-BANK CREDIT,Simpson LLC,-18018.81,Bills, 
18-Sep-16,-1072.68,818726672,,INTER-BANK CREDIT,Morris Group,-19091.49,Bills, 
21-Sep-16,-648.91,818726672,,INTER-BANK CREDIT,Thompson-Burke,-19740.4,Bills, 
23-Sep-16,-1547.72,818726672,,TRANSFER DEBIT,273286943733188 MEDINA PLC ,-21288.120000000003,Other Income, 
26-Sep-16,1157.8,818726672,,INTER-BANK CREDIT,Johns and Sons,-20130.320000000003,Uncategorised, 
28-Sep-16,-926.0,818726672,,INTER-BANK CREDIT,Nash LLC,-21056.320000000003,Other Income, 
01-Oct-16,903.84,818726672,,AUTOMATIC DRAWING,Mitchell Horton and Thompson,-20152.480000000003,Uncategorised, 
02-Oct-16,-549.0,818726672,,AUTOMATIC DRAWING,Nelson Inc,-20701.480000000003,Other Income, 
04-Oct-16,704.01,818726672,,TRANSFER DEBIT,Martin Fields and Mitchell,-19997.470000000005,Uncategorised, 
06-Oct-16,694.64,818726672,,TRANSFER DEBIT,464466217825772 JONES-PATRICK ,-19302.830000000005,Other Income, 
08-Oct-16,1423.38,818726672,,INTER-BANK CREDIT,Roberts Blevins and Rice,-17879.450000000004,Other Income, 
09-Oct-16,1852.28,818726672,,TRANSFER DEBIT,297085678272402 HARRELL-HARRIS ,-16027.170000000004,Other Income, 
10-Oct-16,1127.31,818726672,,INTER-BANK CREDIT,Robbins Morgan and Smith,-14899.860000000004,Bills, 
12-Oct-16,-968.86,818726672,,TRANSFER DEBIT,520663389007241 COLE AND SONS ,-15868.720000000005,Uncategorised, 
15-Oct-16,-1495.27,818726672,,INTER-BANK CREDIT,Black Inc,-17363.990000000005,Other Income, 
15-Oct-16,-332.99,818726672,,AUTOMATIC DRAWING,464611569067022 SHAW BATES AND ALLEN ,-17696.980000000007,Financial, 
16-Oct-16,80.28,818726672,,INTER-BANK CREDIT,970582825796402 MORGAN LEVINE AND JORDAN ,-17616.700000000008,Other Income, 
18-Oct-16,-1165.6,818726672,,TRANSFER DEBIT,Smith Lewis and Hunt,-18782.300000000007,Other Income, 
21-Oct-16,-1823.61,818726672,,INTER-BANK CREDIT,Hicks-Bryan,-20605.910000000007,Bills, 
21-Oct-16,1095.88,818726672,,TRANSFER DEBIT,Gates LLC,-19510.030000000006,Financial, 
22-Oct-16,1655.8,818726672,,INTER-BANK CREDIT,470533318525910 KIM-WILLIAMS ,-17854.230000000007,Other Income, 
22-Oct-16,1727.72,818726672,,TRANSFER DEBIT,Walker Lamb and Curry,-16126.510000000007,Bills, 
23-Oct-16,667.62,818726672,,INTER-BANK CREDIT,576570895138365 MERCADO SMITH AND RIVERA ,-15458.890000000007,Bills, 
24-Oct-16,1598.63,818726672,,TRANSFER DEBIT,957702692074592 ANDERSON GROUP ,-13860.260000000006,Financial, 
26-Oct-16,392.29,818726672,,INTER-BANK CREDIT,949045778318580 WILSON-CAMPBELL ,-13467.970000000005,Uncategorised, 
28-Oct-16,1821.95,818726672,,AUTOMATIC DRAWING,699212227408640 SELLERS BOONE AND WILSON ,-11646.020000000004,Financial, 
28-Oct-16,887.22,818726672,,TRANSFER DEBIT,648380544307000 NGUYEN AND SONS ,-10758.800000000005,Uncategorised, 
31-Oct-16,-689.12,818726672,,INTER-BANK CREDIT,Bennett-Walters,-11447.920000000006,Financial, 
03-Nov-16,522.97,818726672,,TRANSFER DEBIT,Taylor Group,-10924.950000000006,Bills, 
05-Nov-16,1124.2,818726672,,INTER-BANK CREDIT,533726611616419 STRICKLAND DAVIS AND PHILLIPS ,-9800.750000000005,Uncategorised, 
07-Nov-16,244.0,818726672,,TRANSFER DEBIT,934480840319271 POTTS JIMENEZ AND HILL ,-9556.750000000005,Bills, 
07-Nov-16,282.65,818726672,,INTER-BANK CREDIT,357877775289802 SIMMONS-HERNANDEZ ,-9274.100000000006,Financial, 
10-Nov-16,-1523.76,818726672,,INTER-BANK CREDIT,908545905581938 WILSON-POPE ,-10797.860000000006,Other Income, 
10-Nov-16,315.66,818726672,,TRANSFER DEBIT,538014989585286 PARKER LLC ,-10482.200000000006,Financial, 
13-Nov-16,-1509.04,818726672,,INTER-BANK CREDIT,Reyes Simmons and Gibson,-11991.240000000005,Bills, 
13-Nov-16,-1914.1,818726672,,AUTOMATIC DRAWING,369488268727801 CRAWFORD TORRES AND WELLS ,-13905.340000000006,Other Income, 
15-Nov-16,1094.32,818726672,,INTER-BANK CREDIT,310321784803378 ANDERSON GARZA AND STEWART ,-12811.020000000006,Bills, 
17-Nov-16,-1785.0,818726672,,INTER-BANK CREDIT,465065178357678 LAMBERT LLC ,-14596.020000000006,Bills, 
19-Nov-16,1946.52,818726672,,TRANSFER DEBIT,Ball Inc,-12649.500000000005,Financial, 
21-Nov-16,1986.71,818726672,,INTER-BANK CREDIT,Reynolds Ward and Edwards,-10662.790000000005,Bills, 
22-Nov-16,-847.72,818726672,,INTER-BANK CREDIT,Smith Ltd,-11510.510000000004,Uncategorised, 
23-Nov-16,1688.87,818726672,,AUTOMATIC DRAWING,455998568787014 RAMIREZ LTD ,-9821.640000000003,Uncategorised, 
23-Nov-16,226.52,818726672,,TRANSFER DEBIT,727817008424233 HERNANDEZ PLC ,-9595.120000000003,Financial, 
23-Nov-16,1978.81,818726672,,AUTOMATIC DRAWING,Eaton-Serrano,-7616.310000000003,Other Income, 
26-Nov-16,1731.33,818726672,,TRANSFER DEBIT,838974070696446 LOWE LTD ,-5884.980000000003,Other Income, 
27-Nov-16,-1182.31,818726672,,INTER-BANK CREDIT,Anderson Fry and Jackson,-7067.290000000003,Bills, 
30-Nov-16,1086.91,818726672,,INTER-BANK CREDIT,241061126987763 GOMEZ LLC ,-5980.380000000003,Financial, 
03-Dec-16,1497.67,818726672,,TRANSFER DEBIT,Thompson-Perez,-4482.710000000003,Financial, 
05-Dec-16,193.03,818726672,,TRANSFER DEBIT,Mccarthy Cox and Allen,-4289.680000000003,Bills, 
06-Dec-16,-908.0,818726672,,INTER-BANK CREDIT,491598053572414 HARTMAN INC ,-5197.680000000003,Bills, 
07-Dec-16,908.59,818726672,,INTER-BANK CREDIT,412136343029345 ALLEN LLC ,-4289.090000000003,Uncategorised, 
07-Dec-16,126.43,818726672,,INTER-BANK CREDIT,Molina PLC,-4162.660000000003,Uncategorised, 
07-Dec-16,-1330.73,818726672,,AUTOMATIC DRAWING,347785020188291 MCPHERSON GROUP ,-5493.390000000003,Bills, 
08-Dec-16,-1974.93,818726672,,TRANSFER DEBIT,254143212870001 CHURCH WILSON AND GARDNER ,-7468.320000000003,Financial, 
10-Dec-16,-1149.01,818726672,,INTER-BANK CREDIT,802644648679274 JOHNSON-FOWLER ,-8617.330000000004,Bills, 
10-Dec-16,-964.83,818726672,,TRANSFER DEBIT,Shea-Yang,-9582.160000000003,Financial, 
13-Dec-16,1062.73,818726672,,AUTOMATIC DRAWING,Johnson LLC,-8519.430000000004,Bills, 
13-Dec-16,-1681.32,818726672,,AUTOMATIC DRAWING,Martinez Petersen and Gomez,-10200.750000000004,Bills, 
16-Dec-16,398.74,818726672,,INTER-BANK CREDIT,Perez LLC,-9802.010000000004,Other Income, 
19-Dec-16,-576.88,818726672,,INTER-BANK CREDIT,720508571584353 RODRIGUEZ-MITCHELL ,-10378.890000000003,Financial, 
19-Dec-16,-197.31,818726672,,INTER-BANK CREDIT,Miller-Lyons,-10576.200000000003,Uncategorised, 
20-Dec-16,995.74,818726672,,INTER-BANK CREDIT,90987862528657 TUCKER JOHNS AND THOMPSON ,-9580.460000000003,Financial, 
22-Dec-16,-1527.54,818726672,,INTER-BANK CREDIT,306731023504607 MILLER-FIELDS ,-11108.000000000004,Other Income, 
23-Dec-16,-469.42,818726672,,INTER-BANK CREDIT,Wright Yates and Potter,-11577.420000000004,Financial, 
26-Dec-16,1135.01,818726672,,AUTOMATIC DRAWING,380171190000654 LEON-EDWARDS ,-10442.410000000003,Other Income, 
26-Dec-16,1186.73,818726672,,INTER-BANK CREDIT,506991337004403 BENNETT-ELLIOTT ,-9255.680000000004,Uncategorised, 
26-Dec-16,1746.93,818726672,,AUTOMATIC DRAWING,Benson Inc,-7508.750000000004,Uncategorised, 
26-Dec-16,1194.61,818726672,,INTER-BANK CREDIT,Williams Long and Harris,-6314.140000000004,Uncategorised, 
29-Dec-16,-1437.4,818726672,,INTER-BANK CREDIT,Douglas-Arnold,-7751.5400000000045,Other Income, 
30-Dec-16,1764.72,818726672,,TRANSFER DEBIT,Chavez Williams and Mitchell,-5986.820000000004,Other Income, 
30-Dec-16,-757.01,818726672,,INTER-BANK CREDIT,585664847206673 RODRIGUEZ GROUP ,-6743.8300000000045,Uncategorised, 
31-Dec-16,-1264.51,818726672,,AUTOMATIC DRAWING,Paul Inc,-8008.340000000005,Financial, 
02-Jan-17,-1775.09,818726672,,INTER-BANK CREDIT,Richards Sweeney and Johnson,-9783.430000000004,Uncategorised, 
05-Jan-17,1838.95,818726672,,INTER-BANK CREDIT,14244689813198 MARTIN BARRETT AND PERKINS ,-7944.480000000004,Financial, 
05-Jan-17,-406.28,818726672,,AUTOMATIC DRAWING,4382559374670 JONES-WOOD ,-8350.760000000004,Uncategorised, 
08-Jan-17,1351.49,818726672,,INTER-BANK CREDIT,Jenkins-Bray,-6999.270000000004,Uncategorised, 
09-Jan-17,-1956.64,818726672,,TRANSFER DEBIT,Dunn-Obrien,-8955.910000000003,Other Income, 
10-Jan-17,-1554.81,818726672,,INTER-BANK CREDIT,42459857308908 HOLMES INC ,-10510.720000000003,Financial, 
12-Jan-17,342.38,818726672,,INTER-BANK CREDIT,642113737746011 REID-COLLINS ,-10168.340000000004,Other Income, 
14-Jan-17,1578.08,818726672,,TRANSFER DEBIT,849412091542166 BROOKS SMITH AND CARROLL ,-8590.260000000004,Other Income, 
15-Jan-17,-1199.32,818726672,,AUTOMATIC DRAWING,769669757092521 PATTERSON-ADAMS ,-9789.580000000004,Financial, 
15-Jan-17,-1493.65,818726672,,TRANSFER DEBIT,Smith Monroe and Peterson,-11283.230000000003,Uncategorised, 
17-Jan-17,-1855.54,818726672,,AUTOMATIC DRAWING,902026228512744 BRENNAN TATE AND SIMMONS ,-13138.770000000004,Bills, 
18-Jan-17,1725.92,818726672,,AUTOMATIC DRAWING,Wilson Richardson and Butler,-11412.850000000004,Financial, 
20-Jan-17,114.08,818726672,,TRANSFER DEBIT,Harris-Munoz,-11298.770000000004,Financial, 
23-Jan-17,1991.7,818726672,,INTER-BANK CREDIT,768322345919057 BAUER-JUAREZ ,-9307.070000000003,Uncategorised, 
26-Jan-17,-496.81,818726672,,INTER-BANK CREDIT,912409229714855 GARCIA BUTLER AND BROWN ,-9803.880000000003,Other Income, 
28-Jan-17,1879.16,818726672,,INTER-BANK CREDIT,496622792543644 COOPER INC ,-7924.720000000003,Uncategorised, 
31-Jan-17,1942.65,818726672,,TRANSFER DEBIT,196338715360175 GAY LLC ,-5982.070000000003,Other Income, 
02-Feb-17,908.68,818726672,,INTER-BANK CREDIT,799235989969374 GARDNER WEBER AND JONES ,-5073.390000000003,Financial, 
02-Feb-17,-1038.72,818726672,,INTER-BANK CREDIT,Jones Perez and Vaughn,-6112.110000000003,Bills, 
05-Feb-17,1331.05,818726672,,TRANSFER DEBIT,Hughes-Benitez,-4781.060000000003,Financial, 
05-Feb-17,1039.53,818726672,,INTER-BANK CREDIT,Brown Ltd,-3741.5300000000034,Other Income, 
08-Feb-17,1327.88,818726672,,AUTOMATIC DRAWING,Phillips-Schneider,-2413.6500000000033,Bills, 
11-Feb-17,-742.16,818726672,,TRANSFER DEBIT,Thomas Inc,-3155.810000000003,Financial, 
14-Feb-17,-975.79,818726672,,TRANSFER DEBIT,208230325059530 MAXWELL BLAKE AND HUFFMAN ,-4131.600000000003,Bills, 
14-Feb-17,151.89,818726672,,INTER-BANK CREDIT,Wolfe-Morris,-3979.710000000003,Uncategorised, 
14-Feb-17,1078.02,818726672,,INTER-BANK CREDIT,280773749955675 HUTCHINSON GROUP ,-2901.6900000000032,Other Income, 
17-Feb-17,310.18,818726672,,TRANSFER DEBIT,Hill Martin and White,-2591.5100000000034,Financial, 
19-Feb-17,-1107.32,818726672,,AUTOMATIC DRAWING,143585082579589 RIVERA GROUP ,-3698.8300000000036,Uncategorised, 
20-Feb-17,1361.23,818726672,,INTER-BANK CREDIT,280393081675203 CHANEY LOPEZ AND KLEIN ,-2337.6000000000035,Uncategorised, 
22-Feb-17,1528.02,818726672,,TRANSFER DEBIT,Fields Ltd,-809.5800000000036,Bills, 
23-Feb-17,-1929.71,818726672,,AUTOMATIC DRAWING,Roth Casey and Lindsey,-2739.2900000000036,Financial, 
23-Feb-17,-1751.42,818726672,,TRANSFER DEBIT,Griffin-Peck,-4490.710000000004,Uncategorised, 
25-Feb-17,1852.83,818726672,,INTER-BANK CREDIT,370160854089235 RYAN DOYLE AND SELLERS ,-2637.8800000000037,Financial, 
25-Feb-17,-36.75,818726672,,TRANSFER DEBIT,Lewis Ltd,-2674.6300000000037,Other Income, 
26-Feb-17,1474.58,818726672,,INTER-BANK CREDIT,Wolf-Howe,-1200.0500000000038,Other Income, 
28-Feb-17,1824.64,818726672,,INTER-BANK CREDIT,820805563170893 COPELAND MYERS AND SULLIVAN ,624.5899999999963,Bills, 
28-Feb-17,1739.61,818726672,,INTER-BANK CREDIT,Medina Lewis and Garcia,2364.199999999996,Financial, 
03-Mar-17,201.78,818726672,,TRANSFER DEBIT,Young Cordova and Russell,2565.9799999999964,Financial, 
06-Mar-17,-1673.78,818726672,,INTER-BANK CREDIT,Ball Group,892.1999999999964,Financial, 
08-Mar-17,1433.65,818726672,,INTER-BANK CREDIT,Washington Group,2325.8499999999967,Bills, 
10-Mar-17,-500.3,818726672,,TRANSFER DEBIT,23003503582366 CHANG PORTER AND ROMERO ,1825.5499999999968,Financial, 
12-Mar-17,1838.53,818726672,,INTER-BANK CREDIT,255715910132702 JOHNSON GROUP ,3664.0799999999967,Bills, 
12-Mar-17,-21.03,818726672,,TRANSFER DEBIT,Johnson Anderson and Robbins,3643.0499999999965,Uncategorised, 
12-Mar-17,-255.81,818726672,,INTER-BANK CREDIT,Underwood-Williams,3387.2399999999966,Uncategorised, 
13-Mar-17,1597.05,818726672,,INTER-BANK CREDIT,193399217758685 CUNNINGHAM LTD ,4984.289999999996,Bills, 
13-Mar-17,-723.68,818726672,,TRANSFER DEBIT,344166111460675 REYNOLDS LLC ,4260.609999999996,Financial, 
15-Mar-17,1059.98,818726672,,AUTOMATIC DRAWING,Harris Jones and Santos,5320.5899999999965,Financial, 
18-Mar-17,68.45,818726672,,INTER-BANK CREDIT,290957827080855 CRUZ PRICE AND KIM ,5389.039999999996,Financial, 
21-Mar-17,1163.36,818726672,,INTER-BANK CREDIT,Horton Ltd,6552.399999999996,Financial, 
23-Mar-17,1277.91,818726672,,TRANSFER DEBIT,White Luna and Ortega,7830.309999999996,Bills, 
23-Mar-17,1886.85,818726672,,INTER-BANK CREDIT,23211687414280 JOHNSON RAMIREZ AND FORBES ,9717.159999999996,Other Income, 
25-Mar-17,329.73,818726672,,TRANSFER DEBIT,354315528690023 PRINCE-ERICKSON ,10046.889999999996,Bills, 
27-Mar-17,595.26,818726672,,AUTOMATIC DRAWING,Garza Martin and Cooper,10642.149999999996,Uncategorised, 
28-Mar-17,-1321.61,818726672,,AUTOMATIC DRAWING,Thomas-Brown,9320.539999999995,Other Income, 
31-Mar-17,1286.1,818726672,,TRANSFER DEBIT,361531336387075 SCOTT PLC ,10606.639999999996,Bills, 
31-Mar-17,1913.91,818726672,,AUTOMATIC DRAWING,Blackwell-Payne,12520.549999999996,Uncategorised, 
02-Apr-17,27.18,818726672,,INTER-BANK CREDIT,Roberts Banks and Pace,12547.729999999996,Other Income, 
03-Apr-17,-1421.73,818726672,,TRANSFER DEBIT,672005424592513 RICHARDSON-TAYLOR ,11125.999999999996,Uncategorised, 
06-Apr-17,487.1,818726672,,INTER-BANK CREDIT,Ferguson Cruz and Wiley,11613.099999999997,Uncategorised, 
06-Apr-17,-1261.96,818726672,,INTER-BANK CREDIT,Cherry Davis and Green,10351.139999999996,Financial, 
09-Apr-17,-1896.49,818726672,,INTER-BANK CREDIT,Chen Inc,8454.649999999996,Other Income, 
11-Apr-17,-1581.31,818726672,,TRANSFER DEBIT,Beard Moore and Riley,6873.3399999999965,Bills, 
12-Apr-17,1784.92,818726672,,INTER-BANK CREDIT,Sellers-Porter,8658.259999999997,Uncategorised, 
14-Apr-17,489.24,818726672,,AUTOMATIC DRAWING,100578310358089 WILLIAMS PLC ,9147.499999999996,Uncategorised, 
15-Apr-17,-595.63,818726672,,INTER-BANK CREDIT,Hicks PLC,8551.869999999997,Financial, 
17-Apr-17,1541.96,818726672,,INTER-BANK CREDIT,129217922298198 WILKINSON GOMEZ AND JONES ,10093.829999999998,Uncategorised, 
19-Apr-17,582.69,818726672,,INTER-BANK CREDIT,Tyler-Garza,10676.519999999999,Financial, 
21-Apr-17,-355.9,818726672,,TRANSFER DEBIT,Foster Mcdonald and Travis,10320.619999999999,Uncategorised, 
22-Apr-17,-996.05,818726672,,INTER-BANK CREDIT,226560547040706 GARDNER LLC ,9324.57,Other Income, 
24-Apr-17,-991.83,818726672,,AUTOMATIC DRAWING,608258027443646 MALDONADO HENRY AND PARSONS ,8332.74,Bills, 
24-Apr-17,1864.61,818726672,,INTER-BANK CREDIT,776818430073646 GEORGE GROUP ,10197.35,Financial, 
24-Apr-17,1815.34,818726672,,INTER-BANK CREDIT,825393056785167 COOLEY PLC ,12012.69,Financial, 
24-Apr-17,833.29,818726672,,AUTOMATIC DRAWING,Ortiz Kerr and Taylor,12845.98,Uncategorised, 
25-Apr-17,-979.64,818726672,,INTER-BANK CREDIT,224163548293147 BROWN-BRYAN ,11866.34,Uncategorised, 
27-Apr-17,927.5,818726672,,INTER-BANK CREDIT,802547340224873 HOOD DOMINGUEZ AND GONZALEZ ,12793.84,Financial, 
30-Apr-17,863.96,818726672,,AUTOMATIC DRAWING,Williams-Kelley,13657.8,Other Income, 
03-May-17,1539.72,818726672,,AUTOMATIC DRAWING,Calderon Inc,15197.519999999999,Bills, 
03-May-17,-107.94,818726672,,INTER-BANK CREDIT,647657266852350 SMITH LLC ,15089.579999999998,Uncategorised, 
05-May-17,-23.8,818726672,,INTER-BANK CREDIT,Benton Ltd,15065.779999999999,Uncategorised, 
05-May-17,1530.44,818726672,,AUTOMATIC DRAWING,Miller-Woodard,16596.219999999998,Other Income, 
05-May-17,-1873.75,818726672,,INTER-BANK CREDIT,Harris Martinez and Forbes,14722.469999999998,Other Income, 
05-May-17,758.93,818726672,,INTER-BANK CREDIT,Peterson Inc,15481.399999999998,Bills, 
08-May-17,-1675.49,818726672,,INTER-BANK CREDIT,Robertson Inc,13805.909999999998,Financial, 
09-May-17,-1424.36,818726672,,AUTOMATIC DRAWING,915918408124143 SMITH INC ,12381.549999999997,Other Income, 
12-May-17,1858.53,818726672,,INTER-BANK CREDIT,Anderson Inc,14240.079999999998,Uncategorised, 
14-May-17,-1686.83,818726672,,INTER-BANK CREDIT,21922143048357 GRIFFIN AND SONS ,12553.249999999998,Bills, 
14-May-17,1453.76,818726672,,AUTOMATIC DRAWING,342066816738556 MILES AND SONS ,14007.009999999998,Other Income, 
16-May-17,1736.53,818726672,,AUTOMATIC DRAWING,540798553544088 RYAN JONES AND BRIGHT ,15743.539999999999,Bills, 
18-May-17,1324.49,818726672,,INTER-BANK CREDIT,Dodson Velez and Moore,17068.03,Uncategorised, 
20-May-17,528.51,818726672,,INTER-BANK CREDIT,Humphrey Group,17596.539999999997,Bills, 
21-May-17,-597.79,818726672,,TRANSFER DEBIT,Peterson Charles and Johnson,16998.749999999996,Other Income, 
23-May-17,-1003.87,818726672,,INTER-BANK CREDIT,Woods and Sons,15994.879999999996,Financial, 
23-May-17,-1550.67,818726672,,AUTOMATIC DRAWING,Chang-Guzman,14444.209999999995,Bills, 
25-May-17,353.18,818726672,,INTER-BANK CREDIT,710343056703699 FROST-RAY ,14797.389999999996,Financial, 
25-May-17,1738.33,818726672,,INTER-BANK CREDIT,686985946097597 GARCIA-KIM ,16535.719999999994,Uncategorised, 
25-May-17,1148.72,818726672,,INTER-BANK CREDIT,555286591592777 MARSHALL WHITE AND ELLIS ,17684.439999999995,Uncategorised, 
25-May-17,-1414.05,818726672,,INTER-BANK CREDIT,Brown-Morris,16270.389999999996,Financial, 
25-May-17,-235.19,818726672,,AUTOMATIC DRAWING,Brown Inc,16035.199999999995,Other Income, 
25-May-17,1378.58,818726672,,INTER-BANK CREDIT,908926300542400 REED STARK AND DAVIDSON ,17413.779999999995,Uncategorised, 
28-May-17,113.57,818726672,,INTER-BANK CREDIT,Ferrell Group,17527.349999999995,Financial, 
31-May-17,813.5,818726672,,INTER-BANK CREDIT,899691542177493 CARRILLO PARKER AND KIRK ,18340.849999999995,Financial, 
01-Jun-17,-1777.44,818726672,,INTER-BANK CREDIT,Greene-Nelson,16563.409999999996,Other Income, 
03-Jun-17,1782.53,818726672,,INTER-BANK CREDIT,1007714359615 FOX-VELEZ ,18345.939999999995,Financial, 
04-Jun-17,-1777.83,818726672,,INTER-BANK CREDIT,Scott LLC,16568.109999999993,Financial, 
04-Jun-17,85.88,818726672,,INTER-BANK CREDIT,Larson Munoz and Stewart,16653.989999999994,Uncategorised, 
05-Jun-17,-353.61,818726672,,TRANSFER DEBIT,Sawyer-Solis,16300.379999999994,Other Income, 
08-Jun-17,665.93,818726672,,INTER-BANK CREDIT,Palmer-Day,16966.309999999994,Other Income, 
10-Jun-17,-753.56,818726672,,TRANSFER DEBIT,840789362850841 KNIGHT BOYD AND CARPENTER ,16212.749999999995,Bills, 
13-Jun-17,1948.49,818726672,,AUTOMATIC DRAWING,853337600709124 SMITH WATSON AND COOK ,18161.239999999994,Financial, 
15-Jun-17,52.21,818726672,,AUTOMATIC DRAWING,579492086223556 LE LTD ,18213.449999999993,Uncategorised, 
17-Jun-17,-666.63,818726672,,INTER-BANK CREDIT,2636180473239 JOHNSON WALKER AND PRESTON ,17546.819999999992,Uncategorised, 
19-Jun-17,356.49,818726672,,INTER-BANK CREDIT,Perry Jacobs and Massey,17903.309999999994,Bills, 
19-Jun-17,1655.98,818726672,,AUTOMATIC DRAWING,108674468989488 BARNES GREGORY AND KIRBY ,19559.289999999994,Uncategorised, 
21-Jun-17,389.13,818726672,,INTER-BANK CREDIT,Adams and Sons,19948.419999999995,Bills, 
21-Jun-17,146.77,818726672,,TRANSFER DEBIT,Simmons-Wu,20095.189999999995,Uncategorised, 
24-Jun-17,-1990.4,818726672,,INTER-BANK CREDIT,Roberts Inc,18104.789999999994,Uncategorised, 
24-Jun-17,440.87,818726672,,AUTOMATIC DRAWING,Skinner-Sims,18545.659999999993,Bills, 
26-Jun-17,-1065.61,818726672,,AUTOMATIC DRAWING,249888691354226 MALDONADO-RODGERS ,17480.049999999992,Financial, 
26-Jun-17,734.07,818726672,,AUTOMATIC DRAWING,749706829181980 RIOS-JONES ,18214.11999999999,Financial, 
28-Jun-17,-790.82,818726672,,AUTOMATIC DRAWING,Huynh Morrow and Sandoval,17423.299999999992,Uncategorised, 
28-Jun-17,-895.73,818726672,,INTER-BANK CREDIT,153207141477902 SNYDER GROUP ,16527.569999999992,Uncategorised, 
01-Jul-17,-1380.94,818726672,,INTER-BANK CREDIT,905772324985276 MEADOWS-DECKER ,15146.629999999992,Other Income, 
04-Jul-17,-1363.82,818726672,,INTER-BANK CREDIT,Thompson Robinson and Levine,13782.809999999992,Uncategorised, 
04-Jul-17,-847.63,818726672,,AUTOMATIC DRAWING,Diaz Collins and Reed,12935.179999999993,Other Income, 
06-Jul-17,-379.95,818726672,,TRANSFER DEBIT,Palmer Ltd,12555.229999999992,Other Income, 
07-Jul-17,1998.09,818726672,,TRANSFER DEBIT,10274610537459 GORDON COLLINS AND HERNANDEZ ,14553.319999999992,Financial, 
07-Jul-17,-635.14,818726672,,TRANSFER DEBIT,Wiley Hayden and Conrad,13918.179999999993,Bills, 
09-Jul-17,-1568.48,818726672,,INTER-BANK CREDIT,728499970995221 WALLER MENDEZ AND WILLIS ,12349.699999999993,Uncategorised, 
09-Jul-17,-1863.08,818726672,,TRANSFER DEBIT,Lewis-Robles,10486.619999999994,Bills, 
09-Jul-17,-1158.6,818726672,,INTER-BANK CREDIT,716025272939065 GALLOWAY GROUP ,9328.019999999993,Uncategorised, 
12-Jul-17,-752.07,818726672,,AUTOMATIC DRAWING,York Ltd,8575.949999999993,Bills, 
13-Jul-17,-1497.84,818726672,,INTER-BANK CREDIT,Braun Johnson and Martinez,7078.109999999993,Uncategorised, 
16-Jul-17,-707.82,818726672,,TRANSFER DEBIT,105976080623570 SMITH-ANTHONY ,6370.289999999994,Bills, 
19-Jul-17,1049.55,818726672,,INTER-BANK CREDIT,138712999837062 MCCLURE BALDWIN AND MANNING ,7419.839999999994,Bills, 
21-Jul-17,-242.66,818726672,,TRANSFER DEBIT,Heath LLC,7177.179999999994,Other Income, 
23-Jul-17,1990.76,818726672,,INTER-BANK CREDIT,Evans-Crosby,9167.939999999993,Bills, 
25-Jul-17,-1490.54,818726672,,INTER-BANK CREDIT,229731825917397 GILBERT-CHEN ,7677.399999999993,Uncategorised, 
27-Jul-17,1269.59,818726672,,INTER-BANK CREDIT,647275715107488 HERNANDEZ MARTINEZ AND HO ,8946.989999999993,Financial, 
30-Jul-17,354.29,818726672,,INTER-BANK CREDIT,386945659119946 SMITH LANDRY AND GRIFFIN ,9301.279999999993,Bills, 
02-Aug-17,-1311.63,818726672,,INTER-BANK CREDIT,Long Henson and Yu,7989.649999999993,Financial, 
02-Aug-17,1242.57,818726672,,TRANSFER DEBIT,Carlson-Taylor,9232.219999999994,Financial, 
04-Aug-17,1357.86,818726672,,INTER-BANK CREDIT,389395565938859 LEVINE LLC ,10590.079999999994,Financial, 
07-Aug-17,-1733.56,818726672,,TRANSFER DEBIT,270455203926558 SERRANO-WHEELER ,8856.519999999995,Other Income, 
10-Aug-17,-134.04,818726672,,TRANSFER DEBIT,383371913901274 REYES-YOUNG ,8722.479999999994,Bills, 
12-Aug-17,-311.54,818726672,,TRANSFER DEBIT,Soto Ray and Webb,8410.939999999993,Uncategorised, 
14-Aug-17,-986.04,818726672,,INTER-BANK CREDIT,613008551504303 LEE PLC ,7424.899999999993,Bills, 
14-Aug-17,1405.56,818726672,,INTER-BANK CREDIT,Lee White and Hull,8830.459999999994,Other Income, 
17-Aug-17,-1865.02,818726672,,INTER-BANK CREDIT,Medina Molina and Morrison,6965.439999999993,Bills, 
17-Aug-17,-1048.18,818726672,,INTER-BANK CREDIT,Camacho Group,5917.259999999993,Bills, 
19-Aug-17,-74.33,818726672,,AUTOMATIC DRAWING,141015621165198 BOONE-HANSEN ,5842.929999999993,Bills, 
21-Aug-17,80.97,818726672,,INTER-BANK CREDIT,601837340658047 MOORE-PORTER ,5923.899999999993,Bills, 
21-Aug-17,-1312.16,818726672,,AUTOMATIC DRAWING,494366756661264 DAVIS TERRELL AND GARCIA ,4611.739999999993,Bills, 
24-Aug-17,-720.5,818726672,,INTER-BANK CREDIT,Goodman-Jackson,3891.2399999999934,Financial, 
25-Aug-17,1326.25,818726672,,TRANSFER DEBIT,Stevenson-Robertson,5217.489999999993,Other Income, 
25-Aug-17,-134.68,818726672,,AUTOMATIC DRAWING,Mckay-Russell,5082.809999999993,Uncategorised, 
26-Aug-17,1902.5,818726672,,INTER-BANK CREDIT,205228411719275 SANCHEZ-MARTINEZ ,6985.309999999993,Uncategorised, 
27-Aug-17,-1994.14,818726672,,INTER-BANK CREDIT,403845670091695 BARKER SHAW AND HAWKINS ,4991.169999999993,Uncategorised, 
30-Aug-17,-555.77,818726672,,INTER-BANK CREDIT,Herrera Robinson and Mclean,4435.399999999992,Financial, 
30-Aug-17,-355.48,818726672,,AUTOMATIC DRAWING,863323297273178 PIERCE LAMB AND HOGAN ,4079.9199999999923,Other Income, 
02-Sep-17,1838.57,818726672,,INTER-BANK CREDIT,Cochran-Chapman,5918.4899999999925,Financial, 
04-Sep-17,452.28,818726672,,INTER-BANK CREDIT,Santiago Inc,6370.769999999992,Other Income, 
07-Sep-17,-798.61,818726672,,INTER-BANK CREDIT,Hudson Group,5572.159999999993,Financial, 
09-Sep-17,-916.94,818726672,,TRANSFER DEBIT,59752276567858 WEST-ELLIOTT ,4655.219999999992,Other Income, 
12-Sep-17,-1341.78,818726672,,AUTOMATIC DRAWING,282752476684218 FERGUSON WILLIAMS AND PACHECO ,3313.4399999999923,Other Income, 
15-Sep-17,1927.79,818726672,,AUTOMATIC DRAWING,324678271299593 MUELLER-WILSON ,5241.229999999992,Uncategorised, 
15-Sep-17,26.16,818726672,,INTER-BANK CREDIT,Taylor-Lloyd,5267.389999999992,Other Income, 
16-Sep-17,84.22,818726672,,AUTOMATIC DRAWING,372536249246611 HAWKINS INC ,5351.609999999992,Other Income, 
16-Sep-17,-1434.0,818726672,,TRANSFER DEBIT,824199163744294 BROWN INC ,3917.6099999999924,Uncategorised, 
16-Sep-17,1664.71,818726672,,INTER-BANK CREDIT,996168443566286 RICHARDSON ABBOTT AND PARSONS ,5582.319999999992,Other Income, 
17-Sep-17,1539.74,818726672,,AUTOMATIC DRAWING,White and Sons,7122.059999999992,Financial, 
18-Sep-17,1126.69,818726672,,AUTOMATIC DRAWING,279857860848550 MILLS LTD ,8248.749999999993,Other Income, 
18-Sep-17,1813.72,818726672,,INTER-BANK CREDIT,913589376730842 NELSON AND SONS ,10062.469999999992,Other Income, 
19-Sep-17,-795.79,818726672,,AUTOMATIC DRAWING,602533278612539 WIGGINS INC ,9266.679999999993,Financial, 
20-Sep-17,-578.82,818726672,,AUTOMATIC DRAWING,Hogan Rowe and Velez,8687.859999999993,Financial, 
20-Sep-17,-1577.54,818726672,,INTER-BANK CREDIT,707921141968002 ESTRADA PLC ,7110.319999999993,Other Income, 
20-Sep-17,1505.14,818726672,,AUTOMATIC DRAWING,983500865199608 RAMIREZ-ANDREWS ,8615.459999999994,Financial, 
20-Sep-17,1641.52,818726672,,INTER-BANK CREDIT,989339061507544 GATES-MORAN ,10256.979999999994,Bills, 
22-Sep-17,332.53,818726672,,AUTOMATIC DRAWING,Parker Rodriguez and Reyes,10589.509999999995,Bills, 
22-Sep-17,-1779.5,818726672,,INTER-BANK CREDIT,940646814159772 MASON-WEBSTER ,8810.009999999995,Bills, 
22-Sep-17,1113.75,818726672,,AUTOMATIC DRAWING,Roberts and Sons,9923.759999999995,Financial, 
23-Sep-17,-1393.21,818726672,,TRANSFER DEBIT,18550358799150 BUSH-FERNANDEZ ,8530.549999999996,Uncategorised, 
26-Sep-17,317.54,818726672,,INTER-BANK CREDIT,298568464551549 SMITH VAUGHN AND RUSSO ,8848.089999999997,Financial, 
28-Sep-17,-734.84,818726672,,AUTOMATIC DRAWING,Hunter Group,8113.249999999996,Other Income, 
29-Sep-17,-203.6,818726672,,TRANSFER DEBIT,Huff PLC,7909.649999999996,Financial, 
01-Oct-17,-1894.44,818726672,,TRANSFER DEBIT,Watson and Sons,6015.2099999999955,Other Income, 
02-Oct-17,-386.56,818726672,,INTER-BANK CREDIT,187825190563495 MILLER STEPHENS AND VELASQUEZ ,5628.649999999995,Uncategorised, 
05-Oct-17,562.89,818726672,,AUTOMATIC DRAWING,Jordan Johnson and Brown,6191.539999999995,Financial, 
08-Oct-17,-1177.58,818726672,,INTER-BANK CREDIT,Chung LLC,5013.9599999999955,Other Income, 
09-Oct-17,-1820.37,818726672,,INTER-BANK CREDIT,337204298340342 ROBBINS-MORALES ,3193.5899999999956,Other Income, 
09-Oct-17,229.56,818726672,,INTER-BANK CREDIT,790668862982698 STRONG-TOWNSEND ,3423.1499999999955,Uncategorised, 
12-Oct-17,-1480.36,818726672,,TRANSFER DEBIT,Perkins-Fitzgerald,1942.7899999999956,Uncategorised, 
14-Oct-17,60.8,818726672,,TRANSFER DEBIT,287683976096311 EDWARDS LTD ,2003.5899999999956,Uncategorised, 
16-Oct-17,1487.02,818726672,,INTER-BANK CREDIT,Blake Myers and Cooper,3490.6099999999956,Bills, 
17-Oct-17,-973.21,818726672,,INTER-BANK CREDIT,233456012233926 MURPHY-REYES ,2517.3999999999955,Financial, 
17-Oct-17,-789.32,818726672,,AUTOMATIC DRAWING,646539305772720 ALLEN WOOD AND CARPENTER ,1728.0799999999954,Financial, 
20-Oct-17,-1284.58,818726672,,INTER-BANK CREDIT,979438046399104 SMITH PLC ,443.49999999999545,Financial, 
22-Oct-17,-467.17,818726672,,TRANSFER DEBIT,Beltran Herman and Patterson,-23.670000000004563,Other Income, 
22-Oct-17,937.82,818726672,,INTER-BANK CREDIT,Rosales Fitzgerald and Sweeney,914.1499999999955,Bills, 
25-Oct-17,1243.86,818726672,,INTER-BANK CREDIT,808370308884966 ANTHONY GONZALEZ AND CANTRELL ,2158.0099999999957,Uncategorised, 
28-Oct-17,-1266.39,818726672,,TRANSFER DEBIT,Strong LLC,891.6199999999956,Uncategorised, 
28-Oct-17,-1982.37,818726672,,TRANSFER DEBIT,Chavez-Jones,-1090.7500000000043,Other Income, 
28-Oct-17,1772.94,818726672,,INTER-BANK CREDIT,Reyes Ltd,682.1899999999957,Uncategorised, 
28-Oct-17,1314.16,818726672,,AUTOMATIC DRAWING,587932965035232 THOMPSON-HOGAN ,1996.3499999999958,Uncategorised, 
28-Oct-17,-436.18,818726672,,TRANSFER DEBIT,426272904339997 CANNON-TODD ,1560.1699999999958,Uncategorised, 
28-Oct-17,-1737.87,818726672,,INTER-BANK CREDIT,997053639980539 RAMIREZ-HERNANDEZ ,-177.70000000000414,Other Income, 
29-Oct-17,1578.17,818726672,,INTER-BANK CREDIT,807028079477116 PETERSON LTD ,1400.469999999996,Uncategorised, 
30-Oct-17,-559.29,818726672,,INTER-BANK CREDIT,Lin-Bennett,841.179999999996,Bills, 
02-Nov-17,1496.11,818726672,,INTER-BANK CREDIT,Hickman-Brown,2337.289999999996,Bills, 
05-Nov-17,-1594.86,818726672,,AUTOMATIC DRAWING,Chen-Garcia,742.429999999996,Uncategorised, 
07-Nov-17,1992.9,818726672,,INTER-BANK CREDIT,966202164252641 MORAN-WILLIAMS ,2735.3299999999963,Bills, 
10-Nov-17,-1153.69,818726672,,AUTOMATIC DRAWING,621791849875365 BARRY FOX AND BARNETT ,1581.6399999999962,Bills, 
12-Nov-17,17.46,818726672,,INTER-BANK CREDIT,953067346538192 CLARK-HAMPTON ,1599.0999999999963,Financial, 
14-Nov-17,-32.96,818726672,,INTER-BANK CREDIT,Downs-Foster,1566.1399999999962,Other Income, 
16-Nov-17,607.17,818726672,,AUTOMATIC DRAWING,Webb Moore and Braun,2173.3099999999963,Financial, 
19-Nov-17,-1199.19,818726672,,INTER-BANK CREDIT,Randall-Stephenson,974.1199999999963,Other Income, 
22-Nov-17,156.0,818726672,,INTER-BANK CREDIT,Costa Group,1130.1199999999963,Other Income, 
23-Nov-17,1302.04,818726672,,INTER-BANK CREDIT,481997678169249 ALEXANDER-DUKE ,2432.159999999996,Bills, 
23-Nov-17,-329.77,818726672,,INTER-BANK CREDIT,350273542364842 BLAIR LLC ,2102.3899999999962,Other Income, 
25-Nov-17,1881.11,818726672,,INTER-BANK CREDIT,98390812729549 SCHWARTZ WILLIAMS AND MOORE ,3983.4999999999964,Other Income, 
28-Nov-17,-625.54,818726672,,INTER-BANK CREDIT,Mejia-Clark,3357.9599999999964,Bills, 
29-Nov-17,-894.43,818726672,,AUTOMATIC DRAWING,Graves-Thompson,2463.5299999999966,Financial, 
29-Nov-17,-1413.3,818726672,,INTER-BANK CREDIT,409261756304714 DAVIS MARTIN AND ALLEN ,1050.2299999999966,Other Income, 
29-Nov-17,1035.33,818726672,,INTER-BANK CREDIT,353349186276554 MORRISON GROUP ,2085.5599999999968,Other Income, 
02-Dec-17,-288.24,818726672,,AUTOMATIC DRAWING,Ryan Ltd,1797.3199999999968,Bills, 
03-Dec-17,1440.06,818726672,,INTER-BANK CREDIT,639997258067479 WHITE DANIELS AND HOLDER ,3237.3799999999965,Other Income, 
03-Dec-17,1908.29,818726672,,TRANSFER DEBIT,732267913220145 PARK-BEARD ,5145.669999999996,Other Income, 
06-Dec-17,143.23,818726672,,INTER-BANK CREDIT,482428714799460 KELLY-MARSHALL ,5288.899999999996,Financial, 
07-Dec-17,92.54,818726672,,AUTOMATIC DRAWING,Mitchell PLC,5381.439999999996,Financial, 
10-Dec-17,590.61,818726672,,TRANSFER DEBIT,146808237265727 MCGUIRE PLC ,5972.049999999996,Financial, 
11-Dec-17,1480.76,818726672,,INTER-BANK CREDIT,968224024462630 SANDERS-RILEY ,7452.809999999996,Other Income, 
12-Dec-17,1730.22,818726672,,TRANSFER DEBIT,Griffin-Paul,9183.029999999995,Other Income, 
14-Dec-17,-1589.71,818726672,,INTER-BANK CREDIT,698466431675625 BUTLER-BIRD ,7593.319999999995,Financial, 
17-Dec-17,1829.17,818726672,,AUTOMATIC DRAWING,Chavez-Jackson,9422.489999999994,Bills, 
19-Dec-17,0.62,818726672,,INTER-BANK CREDIT,353422600478127 COX-WARREN ,9423.109999999995,Uncategorised, 
21-Dec-17,1885.93,818726672,,TRANSFER DEBIT,718917903238765 CARTER JACKSON AND RAMOS ,11309.039999999995,Financial, 
22-Dec-17,760.89,818726672,,AUTOMATIC DRAWING,Johnston-Wright,12069.929999999995,Financial, 
22-Dec-17,940.25,818726672,,AUTOMATIC DRAWING,Kim Frederick and Atkinson,13010.179999999995,Other Income, 
24-Dec-17,-1054.73,818726672,,INTER-BANK CREDIT,620748896476323 ELLIS GROUP ,11955.449999999995,Bills, 
26-Dec-17,1931.15,818726672,,INTER-BANK CREDIT,289711945465794 MILLER INC ,13886.599999999995,Other Income, 
26-Dec-17,-1431.29,818726672,,TRANSFER DEBIT,Cross LLC,12455.309999999994,Other Income, 
26-Dec-17,-1572.65,818726672,,INTER-BANK CREDIT,Best Trujillo and Jones,10882.659999999994,Bills, 
28-Dec-17,412.42,818726672,,AUTOMATIC DRAWING,469083871898310 VILLA-CLARK ,11295.079999999994,Other Income, 
28-Dec-17,1773.16,818726672,,AUTOMATIC DRAWING,Contreras PLC,13068.239999999994,Uncategorised, 
29-Dec-17,683.15,818726672,,INTER-BANK CREDIT,491531876978269 SMITH MIDDLETON AND JONES ,13751.389999999994,Financial, 
01-Jan-18,-1707.67,818726672,,AUTOMATIC DRAWING,Little Inc,12043.719999999994,Other Income, 
04-Jan-18,-1062.64,818726672,,INTER-BANK CREDIT,934224519437522 BLAKE LLC ,10981.079999999994,Financial, 
04-Jan-18,-865.8,818726672,,INTER-BANK CREDIT,Smith PLC,10115.279999999995,Uncategorised, 
05-Jan-18,1180.03,818726672,,INTER-BANK CREDIT,282449945026723 MCKEE-SCHULTZ ,11295.309999999996,Bills, 
08-Jan-18,-1122.91,818726672,,INTER-BANK CREDIT,Moore PLC,10172.399999999996,Other Income, 
08-Jan-18,490.26,818726672,,INTER-BANK CREDIT,366615195236270 RODRIGUEZ JACKSON AND JACKSON ,10662.659999999996,Financial, 
08-Jan-18,-14.51,818726672,,AUTOMATIC DRAWING,Chan Ltd,10648.149999999996,Uncategorised, 
09-Jan-18,658.57,818726672,,TRANSFER DEBIT,132056030978978 BISHOP WEAVER AND WHITAKER ,11306.719999999996,Bills, 
12-Jan-18,-1018.23,818726672,,AUTOMATIC DRAWING,635499916547829 FRY-THOMAS ,10288.489999999996,Financial, 
14-Jan-18,599.39,818726672,,TRANSFER DEBIT,404965422725929 ALVAREZ-RAMIREZ ,10887.879999999996,Financial, 
16-Jan-18,1494.48,818726672,,INTER-BANK CREDIT,721856365492072 WRIGHT LLC ,12382.359999999995,Uncategorised, 
17-Jan-18,-983.89,818726672,,TRANSFER DEBIT,Smith PLC,11398.469999999996,Financial, 
18-Jan-18,-45.19,818726672,,TRANSFER DEBIT,128193655214288 THOMPSON LLC ,11353.279999999995,Financial, 
20-Jan-18,1424.96,818726672,,AUTOMATIC DRAWING,849552895041342 COX GROUP ,12778.239999999994,Other Income, 
22-Jan-18,-279.15,818726672,,TRANSFER DEBIT,362619877832237 REESE ROBERTS AND MILLER ,12499.089999999995,Bills, 
25-Jan-18,566.94,818726672,,INTER-BANK CREDIT,Wheeler Rivera and Torres,13066.029999999995,Uncategorised, 
25-Jan-18,-533.93,818726672,,INTER-BANK CREDIT,Hurst-Hayden,12532.099999999995,Bills, 
27-Jan-18,756.96,818726672,,INTER-BANK CREDIT,638149179653613 SUAREZ WRIGHT AND BAKER ,13289.059999999994,Other Income, 
30-Jan-18,1179.35,818726672,,TRANSFER DEBIT,507971705995823 HARRISON DAVIDSON AND DELEON ,14468.409999999994,Uncategorised, 
01-Feb-18,525.82,818726672,,INTER-BANK CREDIT,Jacobson-Blankenship,14994.229999999994,Uncategorised, 
02-Feb-18,608.81,818726672,,INTER-BANK CREDIT,852237480508527 BECKER MERRITT AND GIBSON ,15603.039999999994,Financial, 
04-Feb-18,1362.1,818726672,,AUTOMATIC DRAWING,73166022724781 WHITE-FLOYD ,16965.139999999992,Financial, 
06-Feb-18,-455.49,818726672,,INTER-BANK CREDIT,Cochran LLC,16509.64999999999,Uncategorised, 
09-Feb-18,597.2,818726672,,AUTOMATIC DRAWING,487619511899904 POWERS GROUP ,17106.84999999999,Financial, 
09-Feb-18,-1774.21,818726672,,TRANSFER DEBIT,Jones PLC,15332.639999999992,Uncategorised, 
12-Feb-18,4.86,818726672,,AUTOMATIC DRAWING,482397835851323 WALLS LTD ,15337.499999999993,Bills, 
15-Feb-18,1520.03,818726672,,INTER-BANK CREDIT,Paul Ltd,16857.52999999999,Bills, 
17-Feb-18,912.71,818726672,,TRANSFER DEBIT,Warner Joseph and Wall,17770.23999999999,Financial, 
18-Feb-18,236.45,818726672,,TRANSFER DEBIT,96886080770721 PRUITT-CHRISTENSEN ,18006.68999999999,Financial, 
18-Feb-18,-471.98,818726672,,INTER-BANK CREDIT,600922713232958 HARRIS THOMPSON AND BRENNAN ,17534.709999999992,Financial, 
21-Feb-18,81.4,818726672,,AUTOMATIC DRAWING,Johnson Wilson and Higgins,17616.109999999993,Other Income, 
23-Feb-18,481.01,818726672,,INTER-BANK CREDIT,Perez-Jones,18097.11999999999,Financial, 
26-Feb-18,-1007.42,818726672,,TRANSFER DEBIT,86153714156706 ONEAL-HANSEN ,17089.699999999993,Bills, 
26-Feb-18,-239.71,818726672,,INTER-BANK CREDIT,Lopez Baird and Curtis,16849.989999999994,Other Income, 
27-Feb-18,1529.85,818726672,,INTER-BANK CREDIT,Butler LLC,18379.839999999993,Financial, 
27-Feb-18,1698.03,818726672,,AUTOMATIC DRAWING,326917499313476 GRIFFIN-WANG ,20077.86999999999,Uncategorised, 
02-Mar-18,986.1,818726672,,TRANSFER DEBIT,Vasquez-Walsh,21063.96999999999,Financial, 
03-Mar-18,-157.5,818726672,,INTER-BANK CREDIT,Davis Goodman and Stevenson,20906.46999999999,Financial, 
06-Mar-18,-423.06,818726672,,INTER-BANK CREDIT,21967601054305 HARDIN-MAY ,20483.40999999999,Financial, 
08-Mar-18,-737.97,818726672,,AUTOMATIC DRAWING,Knapp and Sons,19745.439999999988,Financial, 
09-Mar-18,639.93,818726672,,INTER-BANK CREDIT,368084311007916 PAUL BROWN AND COLEMAN ,20385.369999999988,Financial, 
10-Mar-18,-1885.11,818726672,,INTER-BANK CREDIT,302259019498722 CORTEZ PLC ,18500.259999999987,Other Income, 
13-Mar-18,-797.22,818726672,,AUTOMATIC DRAWING,Hamilton-Bauer,17703.039999999986,Financial, 
13-Mar-18,-815.56,818726672,,TRANSFER DEBIT,Martin Lewis and Williams,16887.479999999985,Bills, 
14-Mar-18,1466.05,818726672,,AUTOMATIC DRAWING,118546764601080 MULLINS-RICHARDSON ,18353.529999999984,Uncategorised, 
15-Mar-18,371.22,818726672,,INTER-BANK CREDIT,280285245501498 BOYER PLC ,18724.749999999985,Bills, 
15-Mar-18,-1209.55,818726672,,TRANSFER DEBIT,Buckley-Conrad,17515.199999999986,Financial, 
15-Mar-18,-952.79,818726672,,INTER-BANK CREDIT,Gonzalez Garcia and Olson,16562.409999999985,Uncategorised, 
17-Mar-18,278.96,818726672,,TRANSFER DEBIT,Johnson Ltd,16841.369999999984,Uncategorised, 
17-Mar-18,-1833.15,818726672,,AUTOMATIC DRAWING,Mosley Myers and Fisher,15008.219999999985,Bills, 
20-Mar-18,1492.92,818726672,,INTER-BANK CREDIT,Molina and Sons,16501.139999999985,Uncategorised, 
21-Mar-18,643.06,818726672,,AUTOMATIC DRAWING,944080633908091 HORN GOODWIN AND ANDREWS ,17144.199999999986,Bills, 
21-Mar-18,1170.16,818726672,,INTER-BANK CREDIT,471492443840787 DAY-FERGUSON ,18314.359999999986,Other Income, 
22-Mar-18,798.54,818726672,,AUTOMATIC DRAWING,738546875119062 VARGAS-SANTIAGO ,19112.899999999987,Other Income, 
25-Mar-18,1705.87,818726672,,AUTOMATIC DRAWING,319701156859590 GROSS INC ,20818.769999999986,Uncategorised, 
26-Mar-18,-1049.94,818726672,,INTER-BANK CREDIT,Shah-Cooper,19768.829999999987,Bills, 
26-Mar-18,-559.59,818726672,,AUTOMATIC DRAWING,Evans-Andersen,19209.239999999987,Financial, 
27-Mar-18,757.83,818726672,,INTER-BANK CREDIT,23811201909161 LOPEZ OWENS AND WISE ,19967.06999999999,Bills, 
29-Mar-18,-1568.78,818726672,,INTER-BANK CREDIT,Sanchez Ingram and Briggs,18398.28999999999,Uncategorised, 
29-Mar-18,-1869.66,818726672,,INTER-BANK CREDIT,Curtis LLC,16528.62999999999,Uncategorised, 
01-Apr-18,945.12,818726672,,AUTOMATIC DRAWING,Garcia-Gilmore,17473.74999999999,Financial, 
04-Apr-18,1071.63,818726672,,INTER-BANK CREDIT,293609990482860 BROWN-FLETCHER ,18545.37999999999,Other Income, 
06-Apr-18,-1861.07,818726672,,INTER-BANK CREDIT,Hill LLC,16684.30999999999,Other Income, 
08-Apr-18,1145.64,818726672,,AUTOMATIC DRAWING,173992881000579 ZHANG GROUP ,17829.94999999999,Other Income, 
09-Apr-18,-1208.34,818726672,,TRANSFER DEBIT,Williams Ltd,16621.60999999999,Uncategorised, 
12-Apr-18,1907.32,818726672,,TRANSFER DEBIT,Mccarthy and Sons,18528.92999999999,Financial, 
14-Apr-18,1754.65,818726672,,INTER-BANK CREDIT,Kelly Chavez and Silva,20283.57999999999,Financial, 
15-Apr-18,1211.16,818726672,,INTER-BANK CREDIT,Johnson Harris and Hopkins,21494.73999999999,Uncategorised, 
15-Apr-18,-985.13,818726672,,AUTOMATIC DRAWING,Mathews Ferrell and Flores,20509.60999999999,Uncategorised, 
17-Apr-18,1254.22,818726672,,AUTOMATIC DRAWING,383968396540462 DAVIS LEE AND KING ,21763.82999999999,Other Income, 
18-Apr-18,537.62,818726672,,INTER-BANK CREDIT,Fuller Group,22301.44999999999,Financial, 
19-Apr-18,-1363.01,818726672,,INTER-BANK CREDIT,Roberts-Bishop,20938.43999999999,Financial, 
21-Apr-18,156.14,818726672,,INTER-BANK CREDIT,10670902648821 BROWN GROUP ,21094.57999999999,Uncategorised, 
22-Apr-18,-1235.72,818726672,,INTER-BANK CREDIT,Jones Parker and Johnson,19858.85999999999,Bills, 
25-Apr-18,-1451.51,818726672,,AUTOMATIC DRAWING,507587536372145 NOLAN GROUP ,18407.34999999999,Bills, 
27-Apr-18,-1454.14,818726672,,TRANSFER DEBIT,387389875691286 PALMER HERNANDEZ AND BROWN ,16953.209999999992,Financial, 
30-Apr-18,-1689.36,818726672,,INTER-BANK CREDIT,944926340168382 SWANSON GROUP ,15263.849999999991,Bills, 
01-May-18,1577.73,818726672,,AUTOMATIC DRAWING,888537180492219 LIU-WHITE ,16841.57999999999,Uncategorised, 
02-May-18,950.24,818726672,,TRANSFER DEBIT,48865387854427 HANSEN CHAPMAN AND WONG ,17791.819999999992,Financial, 
05-May-18,-1618.5,818726672,,TRANSFER DEBIT,Smith Cobb and Thompson,16173.319999999992,Financial, 
06-May-18,1551.34,818726672,,INTER-BANK CREDIT,876650431908200 GARCIA-THOMPSON ,17724.659999999993,Other Income, 
06-May-18,-1202.48,818726672,,INTER-BANK CREDIT,Little Baker and Hardin,16522.179999999993,Uncategorised, 
07-May-18,1472.47,818726672,,INTER-BANK CREDIT,James-Hernandez,17994.649999999994,Uncategorised, 
07-May-18,-485.83,818726672,,INTER-BANK CREDIT,983592968331202 BROWNING FOWLER AND CASTANEDA ,17508.819999999992,Financial, 
10-May-18,-115.52,818726672,,AUTOMATIC DRAWING,721821967547385 CHRISTENSEN-SHEPPARD ,17393.299999999992,Financial, 
11-May-18,-1558.91,818726672,,INTER-BANK CREDIT,886778420361591 MEDINA-HORNE ,15834.389999999992,Uncategorised, 
13-May-18,799.21,818726672,,TRANSFER DEBIT,Larson Inc,16633.59999999999,Other Income, 
13-May-18,-585.32,818726672,,AUTOMATIC DRAWING,Kelly PLC,16048.279999999992,Other Income, 
15-May-18,6.1,818726672,,AUTOMATIC DRAWING,339366284490992 SMALL-MORAN ,16054.379999999992,Other Income, 
15-May-18,-988.45,818726672,,INTER-BANK CREDIT,Walter-Monroe,15065.929999999991,Uncategorised, 
18-May-18,-1774.51,818726672,,INTER-BANK CREDIT,Torres Miller and Williams,13291.419999999991,Uncategorised, 
20-May-18,-1031.74,818726672,,INTER-BANK CREDIT,Allison Foster and Pace,12259.679999999991,Other Income, 
20-May-18,1101.29,818726672,,INTER-BANK CREDIT,637794857299880 MORGAN INC ,13360.96999999999,Bills, 
20-May-18,-1942.71,818726672,,AUTOMATIC DRAWING,287222930696965 SHEPARD LLC ,11418.259999999991,Bills, 
20-May-18,1684.83,818726672,,TRANSFER DEBIT,898485985398725 STANLEY-WELLS ,13103.089999999991,Other Income, 
20-May-18,628.05,818726672,,INTER-BANK CREDIT,793110013549527 JONES AND SONS ,13731.13999999999,Uncategorised, 
20-May-18,1378.58,818726672,,INTER-BANK CREDIT,Blair-Mays,15109.71999999999,Uncategorised, 
21-May-18,-1774.31,818726672,,AUTOMATIC DRAWING,Fisher Pennington and Horton,13335.40999999999,Other Income, 
24-May-18,1994.67,818726672,,INTER-BANK CREDIT,220502820280374 JACKSON-VALDEZ ,15330.07999999999,Other Income, 
26-May-18,-681.95,818726672,,INTER-BANK CREDIT,222079995168053 GARCIA CLARK AND WILSON ,14648.12999999999,Bills, 
27-May-18,-667.33,818726672,,TRANSFER DEBIT,57981138049433 GONZALES INC ,13980.79999999999,Financial, 
27-May-18,-1148.7,818726672,,TRANSFER DEBIT,398797357329140 MOLINA VELASQUEZ AND WILLIAMS ,12832.09999999999,Bills, 
27-May-18,1986.48,818726672,,AUTOMATIC DRAWING,916438165715740 DOUGLAS LTD ,14818.579999999989,Uncategorised, 
29-May-18,-1648.17,818726672,,INTER-BANK CREDIT,934633851044841 NICHOLS INC ,13170.409999999989,Uncategorised, 
31-May-18,-833.15,818726672,,TRANSFER DEBIT,Galvan-Dawson,12337.25999999999,Other Income, 
03-Jun-18,-1748.03,818726672,,INTER-BANK CREDIT,514196789698376 MARTIN GROUP ,10589.229999999989,Bills, 
03-Jun-18,1800.36,818726672,,INTER-BANK CREDIT,725509094514317 MURPHY-GALVAN ,12389.58999999999,Bills, 
06-Jun-18,918.61,818726672,,TRANSFER DEBIT,728191353179613 HIGGINS-PATEL ,13308.19999999999,Uncategorised, 
08-Jun-18,-531.54,818726672,,INTER-BANK CREDIT,Buchanan Garcia and Williams,12776.659999999989,Bills, 
09-Jun-18,761.43,818726672,,INTER-BANK CREDIT,401538885257822 WHITE-BROWN ,13538.08999999999,Bills, 
10-Jun-18,654.5,818726672,,INTER-BANK CREDIT,555929013777684 IBARRA GROUP ,14192.58999999999,Financial, 
13-Jun-18,-540.47,818726672,,INTER-BANK CREDIT,987689341567464 SANCHEZ LYNCH AND ADAMS ,13652.11999999999,Financial, 
14-Jun-18,555.25,818726672,,TRANSFER DEBIT,Dunn Anderson and Dodson,14207.36999999999,Bills, 
17-Jun-18,-1948.01,818726672,,INTER-BANK CREDIT,Hester Brown and Cruz,12259.35999999999,Uncategorised, 
18-Jun-18,-113.08,818726672,,INTER-BANK CREDIT,92636244355568 GONZALEZ DOMINGUEZ AND RICE ,12146.27999999999,Uncategorised, 
21-Jun-18,904.41,818726672,,INTER-BANK CREDIT,138585600618017 BRYANT-MORGAN ,13050.68999999999,Bills, 
24-Jun-18,619.54,818726672,,INTER-BANK CREDIT,402162957106789 HENDERSON-FRANCIS ,13670.229999999989,Other Income, 
26-Jun-18,728.03,818726672,,INTER-BANK CREDIT,Waters Novak and Wood,14398.25999999999,Other Income, 
26-Jun-18,-1124.5,818726672,,INTER-BANK CREDIT,525623639458583 HUNT AND SONS ,13273.75999999999,Other Income, 
27-Jun-18,-1550.99,818726672,,TRANSFER DEBIT,306701093230248 MORRIS-CARDENAS ,11722.76999999999,Uncategorised, 
28-Jun-18,-1077.96,818726672,,INTER-BANK CREDIT,White Schaefer and Bartlett,10644.80999999999,Other Income, 
28-Jun-18,-1258.86,818726672,,TRANSFER DEBIT,152348983573070 GARCIA COFFEY AND MILLER ,9385.94999999999,Bills, 
30-Jun-18,-1826.13,818726672,,INTER-BANK CREDIT,344617196774729 BRYANT INC ,7559.81999999999,Uncategorised, 
30-Jun-18,-652.94,818726672,,INTER-BANK CREDIT,Nash Ltd,6906.87999999999,Financial, 
03-Jul-18,-209.57,818726672,,TRANSFER DEBIT,Castro PLC,6697.30999999999,Financial, 
05-Jul-18,-1895.81,818726672,,AUTOMATIC DRAWING,499077934233543 BRANDT-DYER ,4801.499999999991,Bills, 
06-Jul-18,-1383.64,818726672,,INTER-BANK CREDIT,935898882030276 TAYLOR-MONROE ,3417.8599999999906,Uncategorised, 
06-Jul-18,-442.64,818726672,,INTER-BANK CREDIT,379519869789277 DAVIS AND SONS ,2975.2199999999907,Other Income, 
09-Jul-18,-245.73,818726672,,TRANSFER DEBIT,95145407425164 KRUEGER TAYLOR AND PENNINGTON ,2729.4899999999907,Other Income, 
12-Jul-18,1498.52,818726672,,INTER-BANK CREDIT,866102018621048 RYAN-ROBBINS ,4228.009999999991,Uncategorised, 
14-Jul-18,-303.3,818726672,,INTER-BANK CREDIT,377035210529050 MILLER GROUP ,3924.709999999991,Financial, 
15-Jul-18,-751.58,818726672,,AUTOMATIC DRAWING,Small Taylor and Cox,3173.129999999991,Other Income, 
18-Jul-18,92.51,818726672,,INTER-BANK CREDIT,380408172144866 HOLMES-ESCOBAR ,3265.6399999999912,Financial, 
19-Jul-18,320.77,818726672,,INTER-BANK CREDIT,Hancock and Sons,3586.409999999991,Uncategorised, 
19-Jul-18,-281.32,818726672,,AUTOMATIC DRAWING,Hammond Reed and Gutierrez,3305.089999999991,Other Income, 
22-Jul-18,497.27,818726672,,INTER-BANK CREDIT,Dean Kerr and Dixon,3802.359999999991,Uncategorised, 
25-Jul-18,-1149.1,818726672,,INTER-BANK CREDIT,Mcknight Inc,2653.259999999991,Financial, 
26-Jul-18,-721.85,818726672,,INTER-BANK CREDIT,Gonzalez Ltd,1931.4099999999912,Other Income, 
29-Jul-18,1487.46,818726672,,INTER-BANK CREDIT,Brown-Hodges,3418.8699999999913,Financial, 
31-Jul-18,1627.85,818726672,,AUTOMATIC DRAWING,Werner Valdez and Perkins,5046.719999999991,Bills, 
31-Jul-18,586.7,818726672,,INTER-BANK CREDIT,87580372692468 SHARP MOORE AND FLORES ,5633.419999999991,Other Income, 
02-Aug-18,1579.73,818726672,,AUTOMATIC DRAWING,Myers Johnson and Smith,7213.1499999999905,Financial, 
02-Aug-18,291.97,818726672,,TRANSFER DEBIT,Griffin Fuller and Miranda,7505.119999999991,Uncategorised, 
02-Aug-18,-1025.51,818726672,,AUTOMATIC DRAWING,Rios Baker and Estrada,6479.609999999991,Uncategorised, 
04-Aug-18,-690.63,818726672,,AUTOMATIC DRAWING,420266842751860 LIU INC ,5788.9799999999905,Uncategorised, 
05-Aug-18,-281.15,818726672,,AUTOMATIC DRAWING,804426739473305 FOWLER-DUNN ,5507.829999999991,Financial, 
06-Aug-18,1697.94,818726672,,TRANSFER DEBIT,512368954235626 BENNETT INC ,7205.769999999991,Financial, 
08-Aug-18,-571.48,818726672,,AUTOMATIC DRAWING,724605031734618 GRAY MADDOX AND ROMAN ,6634.289999999992,Other Income, 
11-Aug-18,-911.08,818726672,,AUTOMATIC DRAWING,921694930155667 FERRELL-DOUGLAS ,5723.209999999992,Financial, 
14-Aug-18,492.71,818726672,,AUTOMATIC DRAWING,Newton-Miller,6215.919999999992,Uncategorised, 
16-Aug-18,1829.99,818726672,,INTER-BANK CREDIT,Pearson PLC,8045.909999999992,Other Income, 
19-Aug-18,-137.57,818726672,,AUTOMATIC DRAWING,Proctor Tucker and Glass,7908.339999999992,Financial, 
19-Aug-18,1906.72,818726672,,INTER-BANK CREDIT,985697343432256 AYALA-MEDINA ,9815.059999999992,Bills, 
21-Aug-18,-675.91,818726672,,AUTOMATIC DRAWING,694721992847003 PERRY-BARKER ,9139.149999999992,Uncategorised, 
23-Aug-18,1348.92,818726672,,TRANSFER DEBIT,Campos Williams and Huff,10488.069999999992,Other Income, 
23-Aug-18,-832.82,818726672,,TRANSFER DEBIT,70204284305155 MORGAN INC ,9655.249999999993,Bills, 
25-Aug-18,-428.93,818726672,,AUTOMATIC DRAWING,Watkins-Charles,9226.319999999992,Other Income, 
26-Aug-18,-148.69,818726672,,AUTOMATIC DRAWING,Roberts-Hayes,9077.629999999992,Bills, 
29-Aug-18,1488.47,818726672,,AUTOMATIC DRAWING,142573163022295 MILLER-BUTLER ,10566.099999999991,Uncategorised, 
29-Aug-18,-828.05,818726672,,INTER-BANK CREDIT,304338516526202 HENDERSON BARTON AND STARK ,9738.049999999992,Bills, 
31-Aug-18,1728.25,818726672,,AUTOMATIC DRAWING,Henderson Adams and Watson,11466.299999999992,Uncategorised, 
03-Sep-18,496.68,818726672,,INTER-BANK CREDIT,185138990229507 SCHMIDT LTD ,11962.979999999992,Financial, 
03-Sep-18,1006.77,818726672,,TRANSFER DEBIT,Brennan Malone and Stewart,12969.749999999993,Other Income, 
03-Sep-18,1036.79,818726672,,AUTOMATIC DRAWING,17265276528992 ROBINSON-MCDONALD ,14006.539999999994,Other Income, 
05-Sep-18,127.31,818726672,,TRANSFER DEBIT,863455036327455 BALL-ANDERSON ,14133.849999999993,Financial, 
08-Sep-18,-1656.3,818726672,,INTER-BANK CREDIT,Cabrera Inc,12477.549999999994,Financial, 
09-Sep-18,-563.64,818726672,,INTER-BANK CREDIT,499867591785310 SMITH AND SONS ,11913.909999999994,Uncategorised, 
09-Sep-18,-110.77,818726672,,TRANSFER DEBIT,176346412895108 RICHMOND COOPER AND STRONG ,11803.139999999994,Bills, 
10-Sep-18,1437.96,818726672,,INTER-BANK CREDIT,Love PLC,13241.099999999995,Financial, 
12-Sep-18,624.38,818726672,,TRANSFER DEBIT,Ryan Hensley and Pearson,13865.479999999994,Financial, 
12-Sep-18,1761.59,818726672,,INTER-BANK CREDIT,Koch Inc,15627.069999999994,Bills, 
13-Sep-18,-866.79,818726672,,TRANSFER DEBIT,Mendez-Bush,14760.279999999995,Other Income, 
13-Sep-18,-102.17,818726672,,AUTOMATIC DRAWING,329708416905389 POOLE-RODRIGUEZ ,14658.109999999995,Bills, 
14-Sep-18,1015.68,818726672,,INTER-BANK CREDIT,Olson-Garcia,15673.789999999995,Uncategorised, 
14-Sep-18,717.96,818726672,,AUTOMATIC DRAWING,Ponce and Sons,16391.749999999996,Other Income, 
14-Sep-18,-555.29,818726672,,INTER-BANK CREDIT,94325353814151 BATES AND SONS ,15836.459999999995,Bills, 
17-Sep-18,-1369.92,818726672,,INTER-BANK CREDIT,553027023774485 WILSON LTD ,14466.539999999995,Financial, 
20-Sep-18,-927.43,818726672,,INTER-BANK CREDIT,Wilson-Bryant,13539.109999999995,Other Income, 
23-Sep-18,1247.78,818726672,,INTER-BANK CREDIT,171751503856057 MAYO ADAMS AND MARSH ,14786.889999999996,Other Income, 
24-Sep-18,1595.34,818726672,,INTER-BANK CREDIT,Horn-Horton,16382.229999999996,Bills, 
24-Sep-18,-758.87,818726672,,TRANSFER DEBIT,19048920742219 WILLIAMS-BELL ,15623.359999999995,Other Income, 
26-Sep-18,1052.28,818726672,,AUTOMATIC DRAWING,Phillips-Snyder,16675.639999999996,Uncategorised, 
26-Sep-18,-690.31,818726672,,AUTOMATIC DRAWING,961978760517459 RODRIGUEZ-KELLEY ,15985.329999999996,Bills, 
28-Sep-18,-1054.15,818726672,,AUTOMATIC DRAWING,416803946169120 DUNLAP RUSSELL AND AGUIRRE ,14931.179999999997,Bills, 
30-Sep-18,1358.66,818726672,,TRANSFER DEBIT,969648995075996 SCOTT LTD ,16289.839999999997,Uncategorised, 
01-Oct-18,1232.36,818726672,,TRANSFER DEBIT,105600427341751 WILLIAMS JENSEN AND EVANS ,17522.199999999997,Financial, 
03-Oct-18,-41.87,818726672,,INTER-BANK CREDIT,Ward Sanders and Smith,17480.329999999998,Other Income, 
06-Oct-18,-20.53,818726672,,AUTOMATIC DRAWING,Montes Ltd,17459.8,Bills, 
09-Oct-18,630.16,818726672,,INTER-BANK CREDIT,Lewis Inc,18089.96,Other Income, 
10-Oct-18,1858.28,818726672,,INTER-BANK CREDIT,629718031470150 BROWN GARCIA AND CHRISTENSEN ,19948.239999999998,Bills, 
11-Oct-18,788.91,818726672,,INTER-BANK CREDIT,952176488817923 WELLS VALENCIA AND DOYLE ,20737.149999999998,Uncategorised, 
13-Oct-18,-849.29,818726672,,TRANSFER DEBIT,Kaufman Ltd,19887.859999999997,Other Income, 
15-Oct-18,-1205.88,818726672,,TRANSFER DEBIT,Anderson Group,18681.979999999996,Financial, 
16-Oct-18,-700.65,818726672,,INTER-BANK CREDIT,216627871909060 HARRISON LLC ,17981.329999999994,Other Income, 
18-Oct-18,-434.87,818726672,,INTER-BANK CREDIT,97045017951174 POWELL MORALES AND SIMMONS ,17546.459999999995,Other Income, 
20-Oct-18,332.7,818726672,,INTER-BANK CREDIT,690689603694025 BOND-VANG ,17879.159999999996,Uncategorised, 
21-Oct-18,1099.84,818726672,,INTER-BANK CREDIT,391349904475107 PEREZ PEREZ AND HATFIELD ,18978.999999999996,Financial, 
21-Oct-18,-237.96,818726672,,INTER-BANK CREDIT,489613369321332 EDWARDS PLC ,18741.039999999997,Bills, 
23-Oct-18,1244.78,818726672,,INTER-BANK CREDIT,777867823924224 BAILEY BRADLEY AND PRUITT ,19985.819999999996,Bills, 
23-Oct-18,1931.96,818726672,,INTER-BANK CREDIT,793375106975150 LEE FIELDS AND LUTZ ,21917.779999999995,Bills, 
26-Oct-18,-1346.97,818726672,,INTER-BANK CREDIT,Holt-Rogers,20570.809999999994,Other Income, 
26-Oct-18,376.22,818726672,,INTER-BANK CREDIT,Rodriguez-Moss,20947.029999999995,Other Income, 
29-Oct-18,462.69,818726672,,TRANSFER DEBIT,Yoder Inc,21409.719999999994,Financial, 
01-Nov-18,-948.05,818726672,,INTER-BANK CREDIT,Castillo Robinson and Galloway,20461.669999999995,Uncategorised, 
01-Nov-18,998.06,818726672,,INTER-BANK CREDIT,Garza Rhodes and Walker,21459.729999999996,Financial, 
02-Nov-18,765.28,818726672,,INTER-BANK CREDIT,598811109289835 TOWNSEND FRANKLIN AND LEWIS ,22225.009999999995,Financial, 
05-Nov-18,1075.95,818726672,,AUTOMATIC DRAWING,Gordon Horton and Smith,23300.959999999995,Bills, 
07-Nov-18,-417.52,818726672,,INTER-BANK CREDIT,497396246237746 YOUNG JOHNSON AND CRAWFORD ,22883.439999999995,Other Income, 
07-Nov-18,-239.29,818726672,,TRANSFER DEBIT,Gonzalez LLC,22644.149999999994,Uncategorised, 
08-Nov-18,-435.63,818726672,,INTER-BANK CREDIT,139826727722653 DEAN-WELLS ,22208.519999999993,Other Income, 
11-Nov-18,-1138.26,818726672,,INTER-BANK CREDIT,223688009311350 GREEN-KENNEDY ,21070.259999999995,Financial, 
12-Nov-18,993.85,818726672,,AUTOMATIC DRAWING,7905206792420 MOORE GROUP ,22064.109999999993,Uncategorised, 
13-Nov-18,-1480.53,818726672,,INTER-BANK CREDIT,160360357269478 SOLOMON-THOMPSON ,20583.579999999994,Uncategorised, 
15-Nov-18,-1422.39,818726672,,INTER-BANK CREDIT,Wang-Williams,19161.189999999995,Financial, 
15-Nov-18,1225.34,818726672,,INTER-BANK CREDIT,825659544739864 COOK WILLIAMS AND BLACK ,20386.529999999995,Bills, 
15-Nov-18,1037.11,818726672,,INTER-BANK CREDIT,261579793381013 SMALL-VEGA ,21423.639999999996,Other Income, 
16-Nov-18,-48.36,818726672,,INTER-BANK CREDIT,Rowe PLC,21375.279999999995,Bills, 
19-Nov-18,263.08,818726672,,AUTOMATIC DRAWING,684930667037942 WILEY-PATTERSON ,21638.359999999997,Uncategorised, 
20-Nov-18,-1568.64,818726672,,TRANSFER DEBIT,Franklin Glenn and Smith,20069.719999999998,Bills, 
20-Nov-18,1392.06,818726672,,INTER-BANK CREDIT,Price Ltd,21461.78,Financial, 
21-Nov-18,-1261.95,818726672,,INTER-BANK CREDIT,604210040708706 HUDSON PRINCE AND DELACRUZ ,20199.829999999998,Financial, 
23-Nov-18,195.89,818726672,,INTER-BANK CREDIT,997688708036294 GUZMAN PLC ,20395.719999999998,Other Income, 
24-Nov-18,-1825.92,818726672,,INTER-BANK CREDIT,575376760058140 WALKER-THOMAS ,18569.799999999996,Other Income, 
24-Nov-18,1999.19,818726672,,INTER-BANK CREDIT,57960391358365 BALLARD KNIGHT AND BURKE ,20568.989999999994,Uncategorised, 
27-Nov-18,1327.74,818726672,,INTER-BANK CREDIT,Walker Ltd,21896.729999999996,Uncategorised, 
29-Nov-18,87.1,818726672,,INTER-BANK CREDIT,328237290474503 SMITH-DAY ,21983.829999999994,Other Income, 
29-Nov-18,-1086.07,818726672,,AUTOMATIC DRAWING,294277775595758 CRAWFORD CASTRO AND MARTIN ,20897.759999999995,Other Income, 
29-Nov-18,1644.91,818726672,,TRANSFER DEBIT,Williams PLC,22542.669999999995,Financial, 
29-Nov-18,360.2,818726672,,TRANSFER DEBIT,Lucas-Webb,22902.869999999995,Bills, 
01-Dec-18,-419.88,818726672,,INTER-BANK CREDIT,Carlson Valentine and Johnson,22482.989999999994,Uncategorised, 
02-Dec-18,1944.04,818726672,,AUTOMATIC DRAWING,729781102865284 HOUSTON HINTON AND JOHNSON ,24427.029999999995,Financial, 
03-Dec-18,889.92,818726672,,AUTOMATIC DRAWING,624147599465400 BUSH GROUP ,25316.949999999993,Uncategorised, 
03-Dec-18,-1445.72,818726672,,INTER-BANK CREDIT,178191653437490 MENDOZA MARSHALL AND WAGNER ,23871.229999999992,Financial, 
05-Dec-18,1334.59,818726672,,AUTOMATIC DRAWING,Smith Inc,25205.819999999992,Financial, 
08-Dec-18,-739.62,818726672,,AUTOMATIC DRAWING,Wilkerson and Sons,24466.199999999993,Uncategorised, 
11-Dec-18,1509.65,818726672,,INTER-BANK CREDIT,681723436263853 WILLIAMSON PLC ,25975.849999999995,Uncategorised, 
11-Dec-18,-1788.7,818726672,,INTER-BANK CREDIT,696292653368412 SMITH FRAZIER AND JOHNSON ,24187.149999999994,Uncategorised, 
13-Dec-18,-512.31,818726672,,AUTOMATIC DRAWING,Boone Kirk and Hall,23674.839999999993,Financial, 
16-Dec-18,1185.96,818726672,,AUTOMATIC DRAWING,Schneider and Sons,24860.799999999992,Bills, 
16-Dec-18,-558.09,818726672,,TRANSFER DEBIT,Barnes Ltd,24302.709999999992,Other Income, 
17-Dec-18,-479.51,818726672,,AUTOMATIC DRAWING,569166038478809 HENRY-SMITH ,23823.199999999993,Uncategorised, 
18-Dec-18,-751.73,818726672,,AUTOMATIC DRAWING,Stone-Murray,23071.469999999994,Financial, 
21-Dec-18,-1605.74,818726672,,AUTOMATIC DRAWING,Hansen Inc,21465.729999999992,Financial, 
24-Dec-18,1526.68,818726672,,INTER-BANK CREDIT,438015863967099 DAVIS-OCONNELL ,22992.409999999993,Bills, 
25-Dec-18,424.47,818726672,,TRANSFER DEBIT,Martinez Sullivan and Yang,23416.879999999994,Uncategorised, 
25-Dec-18,790.11,818726672,,INTER-BANK CREDIT,Davis Ltd,24206.989999999994,Bills, 
26-Dec-18,273.81,818726672,,INTER-BANK CREDIT,Carlson and Sons,24480.799999999996,Other Income, 
28-Dec-18,-919.75,818726672,,AUTOMATIC DRAWING,374224277839733 FRANKLIN-CROSS ,23561.049999999996,Other Income, 
28-Dec-18,325.31,818726672,,AUTOMATIC DRAWING,Bates-Peters,23886.359999999997,Uncategorised, 
