Date,Amount,Account Number,,Transaction Type,Transaction Details,Balance,Category,Merchants Name
07-Jan-21,-1185.21,100728232,,INTER-BANK CREDIT,Ruiz Ltd,-5054.85,Other Income, 
07-Jan-21,1128.04,100728232,,INTER-BANK CREDIT,389544415248084 HICKS INC ,-3926.8100000000004,Uncategorised, 
07-Jan-21,1303.54,100728232,,INTER-BANK CREDIT,655972070035554 MOORE PLC ,-2623.2700000000004,Other Income, 
10-Jan-21,604.56,100728232,,INTER-BANK CREDIT,Foster-Smith,-2018.7100000000005,Bills, 
12-Jan-21,-1321.69,100728232,,INTER-BANK CREDIT,Garrett-Richard,-3340.4000000000005,Financial, 
13-Jan-21,1789.4,100728232,,INTER-BANK CREDIT,907924833265449 JONES KING AND RIVERA ,-1551.0000000000005,Bills, 
15-Jan-21,-699.68,100728232,,INTER-BANK CREDIT,Franco-Holmes,-2250.6800000000003,Other Income, 
15-Jan-21,-333.07,100728232,,TRANSFER DEBIT,Duran-Gray,-2583.7500000000005,Uncategorised, 
18-Jan-21,1600.05,100728232,,INTER-BANK CREDIT,Walsh Ibarra and Mayo,-983.7000000000005,Financial, 
20-Jan-21,454.78,100728232,,INTER-BANK CREDIT,Fisher Oliver and Davis,-528.9200000000005,Other Income, 
21-Jan-21,-163.7,100728232,,INTER-BANK CREDIT,Smith-Carter,-692.6200000000006,Uncategorised, 
22-Jan-21,1416.09,100728232,,AUTOMATIC DRAWING,Singh Roberts and Hernandez,723.4699999999993,Bills, 
23-Jan-21,1926.01,100728232,,INTER-BANK CREDIT,Smith-Edwards,2649.4799999999996,Other Income, 
23-Jan-21,-684.93,100728232,,INTER-BANK CREDIT,619963596877951 MEDINA THOMPSON AND ROSE ,1964.5499999999997,Uncategorised, 
25-Jan-21,-1922.0,100728232,,TRANSFER DEBIT,Morton Ltd,42.54999999999973,Bills, 
27-Jan-21,-273.87,100728232,,TRANSFER DEBIT,334311358609677 KENNEDY SPENCER AND MASSEY ,-231.32000000000028,Uncategorised, 
28-Jan-21,-404.02,100728232,,TRANSFER DEBIT,Perry-Williams,-635.3400000000003,Bills, 
28-Jan-21,621.25,100728232,,AUTOMATIC DRAWING,386009312982711 BAXTER INC ,-14.09000000000026,Financial, 
31-Jan-21,-1362.79,100728232,,INTER-BANK CREDIT,358955824152488 MURRAY-ALLISON ,-1376.88,Bills, 
02-Feb-21,1961.79,100728232,,AUTOMATIC DRAWING,Simpson Ltd,584.9099999999999,Other Income, 
04-Feb-21,-152.49,100728232,,TRANSFER DEBIT,590159841800080 MARSHALL HAWKINS AND HAYES ,432.41999999999985,Other Income, 
07-Feb-21,637.09,100728232,,INTER-BANK CREDIT,Cole Mack and Jacobs,1069.5099999999998,Uncategorised, 
07-Feb-21,1258.28,100728232,,INTER-BANK CREDIT,883215482396463 MULLEN JONES AND MOORE ,2327.79,Financial, 
09-Feb-21,-887.0,100728232,,AUTOMATIC DRAWING,148804491658331 CHAVEZ GARCIA AND DOMINGUEZ ,1440.79,Other Income, 
09-Feb-21,951.5,100728232,,TRANSFER DEBIT,Franco Hogan and Pearson,2392.29,Other Income, 
12-Feb-21,621.58,100728232,,TRANSFER DEBIT,Maxwell-Murphy,3013.87,Other Income, 
12-Feb-21,1765.86,100728232,,INTER-BANK CREDIT,67288561522909 FISCHER PEREZ AND WILLIAMS ,4779.73,Uncategorised, 
15-Feb-21,-770.8,100728232,,AUTOMATIC DRAWING,722169907263096 BURKE MOORE AND GONZALES ,4008.9299999999994,Financial, 
18-Feb-21,923.63,100728232,,INTER-BANK CREDIT,Fitzgerald-Luna,4932.5599999999995,Uncategorised, 
19-Feb-21,245.01,100728232,,TRANSFER DEBIT,236877327855610 BRADLEY AND SONS ,5177.57,Uncategorised, 
19-Feb-21,-1468.27,100728232,,INTER-BANK CREDIT,Smith-Richardson,3709.2999999999997,Uncategorised, 
19-Feb-21,-678.23,100728232,,AUTOMATIC DRAWING,416775724580609 BELTRAN GONZALES AND SANTIAGO ,3031.0699999999997,Uncategorised, 
21-Feb-21,-29.25,100728232,,INTER-BANK CREDIT,Ellis Ltd,3001.8199999999997,Uncategorised, 
24-Feb-21,-757.92,100728232,,INTER-BANK CREDIT,Ortiz-Henry,2243.8999999999996,Other Income, 
27-Feb-21,540.49,100728232,,INTER-BANK CREDIT,Morton Inc,2784.3899999999994,Uncategorised, 
01-Mar-21,-1336.34,100728232,,AUTOMATIC DRAWING,469330639133491 LOPEZ-LOWERY ,1448.0499999999995,Financial, 
01-Mar-21,1977.86,100728232,,INTER-BANK CREDIT,534709063242657 GRAY INC ,3425.9099999999994,Uncategorised, 
04-Mar-21,-1970.62,100728232,,TRANSFER DEBIT,Gordon PLC,1455.2899999999995,Financial, 
05-Mar-21,-1005.63,100728232,,INTER-BANK CREDIT,Taylor LLC,449.6599999999995,Other Income, 
08-Mar-21,-1616.54,100728232,,INTER-BANK CREDIT,Shelton Ltd,-1166.8800000000006,Financial, 
08-Mar-21,1506.87,100728232,,AUTOMATIC DRAWING,Wallace-Travis,339.9899999999993,Financial, 
11-Mar-21,-408.84,100728232,,AUTOMATIC DRAWING,485918974452697 ELLISON-ALLEN ,-68.85000000000065,Uncategorised, 
11-Mar-21,-1549.37,100728232,,AUTOMATIC DRAWING,Yu-Martinez,-1618.2200000000005,Bills, 
14-Mar-21,-1618.43,100728232,,INTER-BANK CREDIT,606514419548089 RAMIREZ-HAHN ,-3236.6500000000005,Financial, 
14-Mar-21,765.0,100728232,,AUTOMATIC DRAWING,Gill-Jackson,-2471.6500000000005,Financial, 
14-Mar-21,-721.05,100728232,,TRANSFER DEBIT,818336442255174 PETERSON JOHNSON AND GARCIA ,-3192.7000000000007,Other Income, 
14-Mar-21,-1566.61,100728232,,TRANSFER DEBIT,Graves PLC,-4759.31,Uncategorised, 
15-Mar-21,1301.0,100728232,,TRANSFER DEBIT,Ruiz Webster and Taylor,-3458.3100000000004,Bills, 
16-Mar-21,1215.51,100728232,,INTER-BANK CREDIT,Martin Montgomery and Rivera,-2242.8,Uncategorised, 
18-Mar-21,1620.36,100728232,,AUTOMATIC DRAWING,Nunez Jones and Landry,-622.4400000000003,Bills, 
18-Mar-21,-1537.45,100728232,,INTER-BANK CREDIT,Maldonado Brooks and Esparza,-2159.8900000000003,Financial, 
21-Mar-21,-1262.03,100728232,,INTER-BANK CREDIT,Cohen Ritter and Green,-3421.92,Uncategorised, 
21-Mar-21,302.75,100728232,,INTER-BANK CREDIT,Briggs Cuevas and Lee,-3119.17,Uncategorised, 
24-Mar-21,-1775.91,100728232,,AUTOMATIC DRAWING,106058560711665 RAMOS INC ,-4895.08,Financial, 
27-Mar-21,-338.68,100728232,,AUTOMATIC DRAWING,182303094259066 MOORE LLC ,-5233.76,Uncategorised, 
30-Mar-21,-1283.3,100728232,,AUTOMATIC DRAWING,809211645230594 JOHNS-SANCHEZ ,-6517.06,Uncategorised, 
30-Mar-21,-1853.31,100728232,,INTER-BANK CREDIT,928046002953211 JACOBS-MAXWELL ,-8370.37,Other Income, 
02-Apr-21,570.54,100728232,,AUTOMATIC DRAWING,524240627667115 JOHNSON INC ,-7799.830000000001,Uncategorised, 
05-Apr-21,-700.63,100728232,,INTER-BANK CREDIT,124578494216216 CAREY LLC ,-8500.460000000001,Other Income, 
07-Apr-21,1400.46,100728232,,AUTOMATIC DRAWING,943556997125831 HOLLAND INC ,-7100.000000000001,Other Income, 
08-Apr-21,-521.49,100728232,,INTER-BANK CREDIT,Brock-Parker,-7621.490000000001,Bills, 
09-Apr-21,-521.47,100728232,,AUTOMATIC DRAWING,Saunders Ltd,-8142.960000000001,Financial, 
12-Apr-21,93.08,100728232,,AUTOMATIC DRAWING,Herring Fisher and Miller,-8049.880000000001,Other Income, 
13-Apr-21,-1036.2,100728232,,TRANSFER DEBIT,Mcdonald-White,-9086.080000000002,Bills, 
16-Apr-21,-304.48,100728232,,TRANSFER DEBIT,871486706292435 EVANS SILVA AND PERRY ,-9390.560000000001,Financial, 
16-Apr-21,1852.71,100728232,,TRANSFER DEBIT,Robinson-Anderson,-7537.850000000001,Bills, 
18-Apr-21,-798.38,100728232,,AUTOMATIC DRAWING,161468888409074 RIVAS MOORE AND ORR ,-8336.230000000001,Financial, 
19-Apr-21,-1559.73,100728232,,TRANSFER DEBIT,Stevenson Harris and Short,-9895.960000000001,Uncategorised, 
21-Apr-21,402.85,100728232,,INTER-BANK CREDIT,Gonzales-Bullock,-9493.11,Other Income, 
22-Apr-21,45.99,100728232,,INTER-BANK CREDIT,635462571430493 BRIGHT JOHNSON AND BENTLEY ,-9447.12,Bills, 
22-Apr-21,-1087.52,100728232,,INTER-BANK CREDIT,858553858781783 HENDRICKS PALMER AND WILLIAMS ,-10534.640000000001,Other Income, 
25-Apr-21,-1705.16,100728232,,AUTOMATIC DRAWING,Clark-Allen,-12239.800000000001,Financial, 
28-Apr-21,-893.42,100728232,,INTER-BANK CREDIT,645492862247264 SMITH GARCIA AND GUERRA ,-13133.220000000001,Bills, 
29-Apr-21,-1616.51,100728232,,INTER-BANK CREDIT,Haynes Inc,-14749.730000000001,Other Income, 
30-Apr-21,-1229.92,100728232,,TRANSFER DEBIT,335122595372124 WOODS NICHOLS AND MCCULLOUGH ,-15979.650000000001,Uncategorised, 
02-May-21,1817.87,100728232,,INTER-BANK CREDIT,852532186601367 LEWIS AVERY AND ROMAN ,-14161.780000000002,Other Income, 
05-May-21,-1413.07,100728232,,INTER-BANK CREDIT,Williams-Hebert,-15574.850000000002,Uncategorised, 
06-May-21,1912.24,100728232,,AUTOMATIC DRAWING,Hinton-Martinez,-13662.610000000002,Uncategorised, 
06-May-21,115.01,100728232,,AUTOMATIC DRAWING,412723053258745 WATSON MCDOWELL AND WARREN ,-13547.600000000002,Bills, 
09-May-21,962.68,100728232,,INTER-BANK CREDIT,304839741664417 HURST-RICE ,-12584.920000000002,Other Income, 
09-May-21,1016.58,100728232,,TRANSFER DEBIT,Gonzalez Silva and Glenn,-11568.340000000002,Other Income, 
11-May-21,679.25,100728232,,TRANSFER DEBIT,39972276844022 GREEN-CAIN ,-10889.090000000002,Other Income, 
11-May-21,-679.85,100728232,,TRANSFER DEBIT,Beck Inc,-11568.940000000002,Uncategorised, 
12-May-21,-16.34,100728232,,AUTOMATIC DRAWING,Parks-Miller,-11585.280000000002,Bills, 
12-May-21,1865.65,100728232,,INTER-BANK CREDIT,Hopkins Inc,-9719.630000000003,Bills, 
13-May-21,1878.28,100728232,,INTER-BANK CREDIT,Gonzales Ltd,-7841.350000000003,Uncategorised, 
14-May-21,1625.86,100728232,,INTER-BANK CREDIT,27623125222094 PAYNE-GREEN ,-6215.490000000003,Bills, 
15-May-21,1367.57,100728232,,AUTOMATIC DRAWING,Lewis Mack and Turner,-4847.920000000004,Other Income, 
16-May-21,-1109.3,100728232,,AUTOMATIC DRAWING,440096022639519 DUFFY-PATTERSON ,-5957.220000000004,Other Income, 
19-May-21,-941.31,100728232,,INTER-BANK CREDIT,706749169950198 VALENCIA JACKSON AND GIBSON ,-6898.530000000004,Financial, 
19-May-21,437.92,100728232,,TRANSFER DEBIT,660765723631894 TAYLOR LARA AND PETTY ,-6460.610000000004,Uncategorised, 
20-May-21,1829.54,100728232,,INTER-BANK CREDIT,96550518314546 GARDNER AND SONS ,-4631.070000000004,Other Income, 
21-May-21,-1793.19,100728232,,AUTOMATIC DRAWING,60926556329070 MORRIS GROUP ,-6424.260000000004,Financial, 
21-May-21,65.2,100728232,,INTER-BANK CREDIT,691467695089658 GOLDEN PERRY AND BUCK ,-6359.060000000004,Other Income, 
22-May-21,-1757.52,100728232,,INTER-BANK CREDIT,Perkins and Sons,-8116.580000000004,Other Income, 
24-May-21,117.8,100728232,,INTER-BANK CREDIT,Shea-Munoz,-7998.780000000003,Bills, 
27-May-21,-1377.37,100728232,,INTER-BANK CREDIT,Walsh Adams and Ortega,-9376.150000000003,Bills, 
28-May-21,891.0,100728232,,INTER-BANK CREDIT,548884907832014 BALL GROUP ,-8485.150000000003,Financial, 
31-May-21,-1561.5,100728232,,INTER-BANK CREDIT,584278645178721 HEBERT TUCKER AND KING ,-10046.650000000003,Uncategorised, 
02-Jun-21,-1575.1,100728232,,AUTOMATIC DRAWING,143412865242986 MARTIN-NAVARRO ,-11621.750000000004,Bills, 
05-Jun-21,-251.68,100728232,,INTER-BANK CREDIT,278543499886972 REYNOLDS TORRES AND BARTON ,-11873.430000000004,Uncategorised, 
05-Jun-21,-268.96,100728232,,INTER-BANK CREDIT,903340255397971 NUNEZ-ANDREWS ,-12142.390000000003,Other Income, 
08-Jun-21,1595.61,100728232,,INTER-BANK CREDIT,427931991320546 WILSON-ROBINSON ,-10546.780000000002,Other Income, 
10-Jun-21,-759.03,100728232,,TRANSFER DEBIT,871328513532915 BLAIR NGUYEN AND BOWMAN ,-11305.810000000003,Other Income, 
10-Jun-21,592.26,100728232,,TRANSFER DEBIT,565037458489584 TUCKER-SNOW ,-10713.550000000003,Bills, 
13-Jun-21,-637.68,100728232,,INTER-BANK CREDIT,157886519012318 SHERMAN-LOPEZ ,-11351.230000000003,Uncategorised, 
15-Jun-21,-929.97,100728232,,INTER-BANK CREDIT,695817004302173 MACDONALD AND SONS ,-12281.200000000003,Financial, 
16-Jun-21,-1528.92,100728232,,INTER-BANK CREDIT,483388501636120 PENNINGTON DRAKE AND SMITH ,-13810.120000000003,Uncategorised, 
16-Jun-21,1858.83,100728232,,AUTOMATIC DRAWING,952535299363755 LOVE GROUP ,-11951.290000000003,Uncategorised, 
17-Jun-21,-1995.14,100728232,,TRANSFER DEBIT,Rice-Carter,-13946.430000000002,Bills, 
20-Jun-21,1279.24,100728232,,INTER-BANK CREDIT,526698532882583 OCONNOR LTD ,-12667.190000000002,Other Income, 
23-Jun-21,-1157.18,100728232,,INTER-BANK CREDIT,Mahoney LLC,-13824.370000000003,Financial, 
24-Jun-21,-466.83,100728232,,INTER-BANK CREDIT,135488118454698 ALVAREZ-GONZALES ,-14291.200000000003,Other Income, 
26-Jun-21,472.79,100728232,,TRANSFER DEBIT,514868966981678 MILLER INC ,-13818.410000000002,Financial, 
28-Jun-21,11.91,100728232,,INTER-BANK CREDIT,963186705995610 HERRERA-WOOD ,-13806.500000000002,Other Income, 
29-Jun-21,83.95,100728232,,TRANSFER DEBIT,Sosa Holland and Davis,-13722.550000000001,Other Income, 
29-Jun-21,1566.21,100728232,,AUTOMATIC DRAWING,Phillips-Hicks,-12156.34,Bills, 
30-Jun-21,473.88,100728232,,AUTOMATIC DRAWING,Anderson Chavez and Salinas,-11682.460000000001,Financial, 
02-Jul-21,520.24,100728232,,TRANSFER DEBIT,Lawrence-Melendez,-11162.220000000001,Bills, 
04-Jul-21,1038.53,100728232,,TRANSFER DEBIT,155079338957016 RICH SMITH AND MARTINEZ ,-10123.69,Other Income, 
07-Jul-21,853.28,100728232,,TRANSFER DEBIT,Young LLC,-9270.41,Bills, 
09-Jul-21,1192.37,100728232,,INTER-BANK CREDIT,Williams Ltd,-8078.04,Financial, 
12-Jul-21,-1734.97,100728232,,TRANSFER DEBIT,705066161710579 SWEENEY LTD ,-9813.01,Bills, 
12-Jul-21,-1786.47,100728232,,AUTOMATIC DRAWING,622598639046380 STEELE-DAVIDSON ,-11599.48,Bills, 
12-Jul-21,491.31,100728232,,INTER-BANK CREDIT,971058320807737 STEVENS HOFFMAN AND HULL ,-11108.17,Other Income, 
15-Jul-21,-1764.22,100728232,,TRANSFER DEBIT,Schmidt Inc,-12872.39,Bills, 
16-Jul-21,-1182.59,100728232,,INTER-BANK CREDIT,97746770395463 JONES PLC ,-14054.98,Other Income, 
18-Jul-21,-294.37,100728232,,AUTOMATIC DRAWING,713072973323086 KLEIN-GRAY ,-14349.35,Financial, 
19-Jul-21,53.76,100728232,,INTER-BANK CREDIT,824475304071019 HOWARD BROWN AND GONZALEZ ,-14295.59,Other Income, 
21-Jul-21,-1108.23,100728232,,TRANSFER DEBIT,Esparza-Hicks,-15403.82,Financial, 
23-Jul-21,1464.15,100728232,,TRANSFER DEBIT,Huerta-Warner,-13939.67,Other Income, 
23-Jul-21,887.44,100728232,,TRANSFER DEBIT,Santiago LLC,-13052.23,Financial, 
24-Jul-21,-960.87,100728232,,INTER-BANK CREDIT,948762123374045 HOFFMAN PLC ,-14013.1,Bills, 
27-Jul-21,-1705.9,100728232,,AUTOMATIC DRAWING,16398551018453 GRIFFIN-WILSON ,-15719.0,Other Income, 
28-Jul-21,991.32,100728232,,AUTOMATIC DRAWING,473652587627458 SCHMITT AND SONS ,-14727.68,Uncategorised, 
30-Jul-21,739.09,100728232,,TRANSFER DEBIT,2853422577413 WOODARD BROWN AND GONZALEZ ,-13988.59,Bills, 
31-Jul-21,-646.43,100728232,,INTER-BANK CREDIT,Lee Ltd,-14635.02,Financial, 
02-Aug-21,826.01,100728232,,INTER-BANK CREDIT,870674559200667 BOOKER HOWELL AND BARRETT ,-13809.01,Bills, 
04-Aug-21,1038.57,100728232,,TRANSFER DEBIT,Juarez and Sons,-12770.44,Other Income, 
07-Aug-21,627.21,100728232,,INTER-BANK CREDIT,Thomas and Sons,-12143.23,Uncategorised, 
07-Aug-21,-96.3,100728232,,TRANSFER DEBIT,Williams-Lozano,-12239.529999999999,Bills, 
09-Aug-21,185.79,100728232,,INTER-BANK CREDIT,Perkins and Sons,-12053.739999999998,Uncategorised, 
09-Aug-21,-1954.25,100728232,,INTER-BANK CREDIT,55061968256707 POWELL-SUAREZ ,-14007.989999999998,Financial, 
11-Aug-21,-24.56,100728232,,INTER-BANK CREDIT,474093888846504 NGUYEN-OWENS ,-14032.549999999997,Financial, 
12-Aug-21,-1917.01,100728232,,AUTOMATIC DRAWING,253992268847681 MANNING-TORRES ,-15949.559999999998,Uncategorised, 
14-Aug-21,1245.67,100728232,,AUTOMATIC DRAWING,Huang-Taylor,-14703.889999999998,Financial, 
15-Aug-21,-439.34,100728232,,AUTOMATIC DRAWING,255131137617981 LANDRY AND SONS ,-15143.229999999998,Financial, 
18-Aug-21,123.41,100728232,,INTER-BANK CREDIT,Woods Wilson and Turner,-15019.819999999998,Bills, 
19-Aug-21,1338.22,100728232,,TRANSFER DEBIT,Blake Anderson and Moore,-13681.599999999999,Uncategorised, 
19-Aug-21,-1931.63,100728232,,AUTOMATIC DRAWING,Valdez Owens and Moore,-15613.23,Financial, 
20-Aug-21,20.15,100728232,,INTER-BANK CREDIT,773573565741504 JONES LLC ,-15593.08,Other Income, 
21-Aug-21,1767.01,100728232,,INTER-BANK CREDIT,Beck-Owen,-13826.07,Bills, 
21-Aug-21,-1746.1,100728232,,AUTOMATIC DRAWING,Wiley-Thomas,-15572.17,Uncategorised, 
24-Aug-21,1816.26,100728232,,INTER-BANK CREDIT,317323278875153 DAVIS GONZALES AND MILLER ,-13755.91,Bills, 
25-Aug-21,101.23,100728232,,TRANSFER DEBIT,Rice Ltd,-13654.68,Financial, 
27-Aug-21,1958.83,100728232,,AUTOMATIC DRAWING,421873266701545 BISHOP INC ,-11695.85,Other Income, 
30-Aug-21,-1500.0,100728232,,TRANSFER DEBIT,Butler Swanson and Robbins,-13195.85,Uncategorised, 
31-Aug-21,-1075.27,100728232,,AUTOMATIC DRAWING,Moore Hartman and Flores,-14271.12,Other Income, 
02-Sep-21,-1519.78,100728232,,INTER-BANK CREDIT,436170658918520 SMITH-MITCHELL ,-15790.900000000001,Uncategorised, 
04-Sep-21,-34.39,100728232,,INTER-BANK CREDIT,Mccann-Ashley,-15825.29,Bills, 
05-Sep-21,995.96,100728232,,TRANSFER DEBIT,Torres-Hess,-14829.330000000002,Uncategorised, 
08-Sep-21,-1955.19,100728232,,AUTOMATIC DRAWING,459906779113990 BROOKS INC ,-16784.52,Uncategorised, 
08-Sep-21,663.61,100728232,,AUTOMATIC DRAWING,300329930094906 PACHECO ALVARADO AND RASMUSSEN ,-16120.91,Other Income, 
10-Sep-21,-381.08,100728232,,AUTOMATIC DRAWING,224505286245857 CARPENTER-JONES ,-16501.99,Financial, 
12-Sep-21,-1968.08,100728232,,INTER-BANK CREDIT,Vega Inc,-18470.07,Bills, 
15-Sep-21,-1288.51,100728232,,AUTOMATIC DRAWING,West-Collins,-19758.579999999998,Other Income, 
15-Sep-21,-849.5,100728232,,INTER-BANK CREDIT,White-King,-20608.079999999998,Other Income, 
16-Sep-21,-249.16,100728232,,AUTOMATIC DRAWING,339122651821006 DOMINGUEZ LLC ,-20857.239999999998,Bills, 
16-Sep-21,301.05,100728232,,INTER-BANK CREDIT,Shaffer Gay and Martin,-20556.19,Uncategorised, 
17-Sep-21,139.6,100728232,,AUTOMATIC DRAWING,Williamson-Green,-20416.59,Other Income, 
18-Sep-21,158.84,100728232,,INTER-BANK CREDIT,96899629621149 ROBINSON LTD ,-20257.75,Bills, 
20-Sep-21,-279.23,100728232,,AUTOMATIC DRAWING,Raymond Watson and Adams,-20536.98,Financial, 
21-Sep-21,774.13,100728232,,INTER-BANK CREDIT,782892518489316 BUTLER NAVARRO AND SMITH ,-19762.85,Bills, 
21-Sep-21,693.7,100728232,,AUTOMATIC DRAWING,949931661478825 ROBINSON LTD ,-19069.149999999998,Financial, 
24-Sep-21,-1495.66,100728232,,TRANSFER DEBIT,194302444954381 CHEN-HALE ,-20564.809999999998,Bills, 
26-Sep-21,-146.27,100728232,,INTER-BANK CREDIT,Crawford Butler and Owens,-20711.079999999998,Bills, 
29-Sep-21,190.83,100728232,,INTER-BANK CREDIT,Kemp Ltd,-20520.249999999996,Uncategorised, 
02-Oct-21,-1013.06,100728232,,AUTOMATIC DRAWING,White-Wolfe,-21533.309999999998,Financial, 
04-Oct-21,-1874.85,100728232,,INTER-BANK CREDIT,Gutierrez Ramirez and Smith,-23408.159999999996,Financial, 
05-Oct-21,-1746.71,100728232,,TRANSFER DEBIT,Peters-Koch,-25154.869999999995,Bills, 
07-Oct-21,-706.3,100728232,,AUTOMATIC DRAWING,Jensen LLC,-25861.169999999995,Uncategorised, 
09-Oct-21,47.81,100728232,,INTER-BANK CREDIT,Aguilar-Singleton,-25813.359999999993,Uncategorised, 
11-Oct-21,-1111.04,100728232,,INTER-BANK CREDIT,887937356562220 MACK RODRIGUEZ AND FERNANDEZ ,-26924.399999999994,Bills, 
14-Oct-21,-618.8,100728232,,INTER-BANK CREDIT,Evans Inc,-27543.199999999993,Other Income, 
16-Oct-21,-1597.37,100728232,,INTER-BANK CREDIT,Harrell-Brown,-29140.569999999992,Other Income, 
16-Oct-21,-977.49,100728232,,AUTOMATIC DRAWING,111881358797462 HOWARD WILLIAMS AND HOWELL ,-30118.059999999994,Uncategorised, 
19-Oct-21,-670.26,100728232,,INTER-BANK CREDIT,436462961906360 MILLER INC ,-30788.319999999992,Bills, 
21-Oct-21,-1463.85,100728232,,TRANSFER DEBIT,358097820567541 BARNETT BURNS AND HOPKINS ,-32252.16999999999,Bills, 
24-Oct-21,1985.48,100728232,,INTER-BANK CREDIT,959693583507247 NELSON-MILLER ,-30266.68999999999,Other Income, 
26-Oct-21,-1982.08,100728232,,TRANSFER DEBIT,Ryan Ltd,-32248.76999999999,Uncategorised, 
28-Oct-21,515.69,100728232,,INTER-BANK CREDIT,456922568535723 CASTRO ALEXANDER AND HAAS ,-31733.07999999999,Uncategorised, 
28-Oct-21,-1868.26,100728232,,INTER-BANK CREDIT,Morrison Jones and Burnett,-33601.33999999999,Uncategorised, 
29-Oct-21,-605.78,100728232,,INTER-BANK CREDIT,880910353673878 MARTINEZ HILL AND LEWIS ,-34207.11999999999,Bills, 
01-Nov-21,-211.46,100728232,,INTER-BANK CREDIT,777985126011233 MCLEAN-YOUNG ,-34418.57999999999,Financial, 
03-Nov-21,1907.69,100728232,,INTER-BANK CREDIT,Ramos Anderson and Frank,-32510.88999999999,Uncategorised, 
05-Nov-21,83.63,100728232,,INTER-BANK CREDIT,Wang-Thompson,-32427.259999999987,Financial, 
08-Nov-21,895.32,100728232,,AUTOMATIC DRAWING,Garcia-Olson,-31531.939999999988,Uncategorised, 
08-Nov-21,338.59,100728232,,TRANSFER DEBIT,Downs and Sons,-31193.349999999988,Financial, 
11-Nov-21,106.23,100728232,,INTER-BANK CREDIT,Nelson-Gilmore,-31087.119999999988,Bills, 
14-Nov-21,136.14,100728232,,INTER-BANK CREDIT,Rhodes-Heath,-30950.97999999999,Uncategorised, 
16-Nov-21,676.13,100728232,,TRANSFER DEBIT,Ortiz-Lutz,-30274.849999999988,Bills, 
19-Nov-21,-375.27,100728232,,INTER-BANK CREDIT,Todd Murray and Humphrey,-30650.119999999988,Other Income, 
21-Nov-21,-359.38,100728232,,INTER-BANK CREDIT,Briggs Gibson and Alvarez,-31009.49999999999,Bills, 
22-Nov-21,-1262.46,100728232,,AUTOMATIC DRAWING,Lee Group,-32271.95999999999,Bills, 
23-Nov-21,-727.86,100728232,,AUTOMATIC DRAWING,Harmon PLC,-32999.819999999985,Financial, 
24-Nov-21,-1500.5,100728232,,AUTOMATIC DRAWING,454714103352808 HORNE KELLER AND ROBERTS ,-34500.319999999985,Financial, 
26-Nov-21,-1840.64,100728232,,INTER-BANK CREDIT,Cooper Kline and Christian,-36340.959999999985,Other Income, 
29-Nov-21,1235.32,100728232,,TRANSFER DEBIT,320933892474493 JOHNSON-BROWN ,-35105.639999999985,Uncategorised, 
29-Nov-21,-31.66,100728232,,INTER-BANK CREDIT,254668848210677 CHAVEZ LTD ,-35137.29999999999,Financial, 
29-Nov-21,-488.06,100728232,,TRANSFER DEBIT,Kane-Norris,-35625.359999999986,Bills, 
29-Nov-21,1839.92,100728232,,INTER-BANK CREDIT,Sexton Mitchell and Ward,-33785.43999999999,Financial, 
02-Dec-21,-912.19,100728232,,AUTOMATIC DRAWING,Hill-Torres,-34697.62999999999,Uncategorised, 
05-Dec-21,-1100.83,100728232,,INTER-BANK CREDIT,463146967831819 MORRIS-COLE ,-35798.45999999999,Financial, 
05-Dec-21,-342.98,100728232,,INTER-BANK CREDIT,Thompson-Simon,-36141.439999999995,Uncategorised, 
06-Dec-21,266.87,100728232,,TRANSFER DEBIT,Castro Gomez and Manning,-35874.56999999999,Bills, 
07-Dec-21,1745.63,100728232,,TRANSFER DEBIT,Leonard Coleman and Patterson,-34128.939999999995,Bills, 
10-Dec-21,-1925.79,100728232,,INTER-BANK CREDIT,639143657773730 KELLY-WRIGHT ,-36054.729999999996,Bills, 
11-Dec-21,1611.99,100728232,,TRANSFER DEBIT,Marquez and Sons,-34442.74,Bills, 
14-Dec-21,824.53,100728232,,INTER-BANK CREDIT,Patrick-Luna,-33618.21,Financial, 
16-Dec-21,1431.94,100728232,,TRANSFER DEBIT,Beck LLC,-32186.27,Uncategorised, 
18-Dec-21,1620.25,100728232,,TRANSFER DEBIT,702327949078071 GRAY-SWANSON ,-30566.02,Other Income, 
19-Dec-21,-139.83,100728232,,AUTOMATIC DRAWING,Johnson LLC,-30705.850000000002,Financial, 
19-Dec-21,-1578.46,100728232,,INTER-BANK CREDIT,648229590134875 DOMINGUEZ-MOORE ,-32284.31,Financial, 
19-Dec-21,550.69,100728232,,INTER-BANK CREDIT,455264524409791 HAWKINS BOONE AND KIRBY ,-31733.620000000003,Uncategorised, 
21-Dec-21,50.96,100728232,,AUTOMATIC DRAWING,679782056071296 COOKE-SHERMAN ,-31682.660000000003,Bills, 
24-Dec-21,158.27,100728232,,AUTOMATIC DRAWING,Miller Blake and Carey,-31524.390000000003,Financial, 
24-Dec-21,-1848.38,100728232,,AUTOMATIC DRAWING,Decker Wood and White,-33372.770000000004,Financial, 
27-Dec-21,-354.47,100728232,,INTER-BANK CREDIT,Cobb Ltd,-33727.240000000005,Other Income, 
30-Dec-21,1784.34,100728232,,AUTOMATIC DRAWING,862003242201926 BRADSHAW DAY AND SIMPSON ,-31942.900000000005,Financial, 
31-Dec-21,-105.39,100728232,,INTER-BANK CREDIT,Miles and Sons,-32048.290000000005,Bills, 
01-Jan-22,-1652.6,100728232,,INTER-BANK CREDIT,648358181259751 WOODS AUSTIN AND HARRIS ,-33700.89000000001,Uncategorised, 
01-Jan-22,-1841.04,100728232,,AUTOMATIC DRAWING,Adams PLC,-35541.93000000001,Uncategorised, 
02-Jan-22,-928.78,100728232,,TRANSFER DEBIT,703073796348102 WILLIAMS AND SONS ,-36470.71000000001,Uncategorised, 
02-Jan-22,1642.28,100728232,,TRANSFER DEBIT,476877257628457 BOYD-LEE ,-34828.43000000001,Bills, 
05-Jan-22,1909.38,100728232,,INTER-BANK CREDIT,225421905780791 CARNEY-NELSON ,-32919.05000000001,Uncategorised, 
08-Jan-22,962.9,100728232,,AUTOMATIC DRAWING,111928770413202 LEWIS HAMILTON AND PERRY ,-31956.15000000001,Uncategorised, 
10-Jan-22,-1757.98,100728232,,TRANSFER DEBIT,793516982752976 FRIEDMAN CHRISTENSEN AND DIXON ,-33714.13000000001,Other Income, 
10-Jan-22,728.28,100728232,,TRANSFER DEBIT,Grimes Robinson and Long,-32985.85000000001,Uncategorised, 
12-Jan-22,-1147.77,100728232,,INTER-BANK CREDIT,Parker Estrada and Mccall,-34133.62000000001,Bills, 
12-Jan-22,-1250.59,100728232,,INTER-BANK CREDIT,Howard PLC,-35384.21000000001,Bills, 
14-Jan-22,386.54,100728232,,INTER-BANK CREDIT,Palmer and Sons,-34997.670000000006,Bills, 
16-Jan-22,100.94,100728232,,TRANSFER DEBIT,Woods-Solomon,-34896.73,Uncategorised, 
17-Jan-22,-1934.33,100728232,,INTER-BANK CREDIT,Reynolds-Brown,-36831.060000000005,Other Income, 
20-Jan-22,695.59,100728232,,INTER-BANK CREDIT,825306001979785 LARA-SAMPSON ,-36135.47000000001,Bills, 
20-Jan-22,1082.44,100728232,,TRANSFER DEBIT,Schmitt Ltd,-35053.030000000006,Uncategorised, 
23-Jan-22,-1980.9,100728232,,TRANSFER DEBIT,290729028019989 HOWARD SHELTON AND RODRIGUEZ ,-37033.93000000001,Financial, 
23-Jan-22,1343.93,100728232,,AUTOMATIC DRAWING,Lawrence LLC,-35690.00000000001,Financial, 
23-Jan-22,-738.82,100728232,,INTER-BANK CREDIT,983161084904331 HANSEN ANDERSON AND WALLS ,-36428.82000000001,Financial, 
25-Jan-22,-698.15,100728232,,AUTOMATIC DRAWING,Johnson PLC,-37126.97000000001,Financial, 
27-Jan-22,-1560.56,100728232,,AUTOMATIC DRAWING,780659101795360 SEXTON POPE AND MONTGOMERY ,-38687.530000000006,Financial, 
27-Jan-22,1845.09,100728232,,INTER-BANK CREDIT,725587171557023 HARDING WILLIS AND LOWE ,-36842.44000000001,Other Income, 
30-Jan-22,-1985.91,100728232,,AUTOMATIC DRAWING,697330661073113 DIAZ-NICHOLSON ,-38828.35000000001,Other Income, 
01-Feb-22,-1295.17,100728232,,TRANSFER DEBIT,Hill-Miller,-40123.52000000001,Other Income, 
03-Feb-22,1808.64,100728232,,INTER-BANK CREDIT,Noble Walker and Barber,-38314.88000000001,Other Income, 
06-Feb-22,-1868.28,100728232,,INTER-BANK CREDIT,634224701686905 MEDINA KENNEDY AND TAYLOR ,-40183.16000000001,Financial, 
08-Feb-22,-330.0,100728232,,AUTOMATIC DRAWING,48780656601290 MOORE-HUGHES ,-40513.16000000001,Other Income, 
10-Feb-22,-1253.76,100728232,,INTER-BANK CREDIT,Webster Gordon and Cunningham,-41766.92000000001,Financial, 
13-Feb-22,-1070.32,100728232,,INTER-BANK CREDIT,299883090277733 LAMBERT LLC ,-42837.24000000001,Financial, 
16-Feb-22,-1686.8,100728232,,INTER-BANK CREDIT,Johnson-Meyer,-44524.040000000015,Uncategorised, 
17-Feb-22,643.35,100728232,,INTER-BANK CREDIT,Bradley Ltd,-43880.69000000002,Other Income, 
17-Feb-22,1024.92,100728232,,AUTOMATIC DRAWING,Bryant-Campbell,-42855.77000000002,Financial, 
17-Feb-22,1909.23,100728232,,TRANSFER DEBIT,Miller Group,-40946.540000000015,Uncategorised, 
18-Feb-22,1657.44,100728232,,INTER-BANK CREDIT,Mccoy Stevenson and Esparza,-39289.10000000001,Other Income, 
21-Feb-22,-550.76,100728232,,INTER-BANK CREDIT,Zamora Inc,-39839.860000000015,Financial, 
23-Feb-22,-58.23,100728232,,TRANSFER DEBIT,536994134966073 WILLIAMS-CASTRO ,-39898.09000000002,Other Income, 
26-Feb-22,-1185.4,100728232,,TRANSFER DEBIT,Arroyo Ltd,-41083.49000000002,Uncategorised, 
27-Feb-22,-1210.62,100728232,,TRANSFER DEBIT,Nelson-Eaton,-42294.11000000002,Financial, 
01-Mar-22,1475.38,100728232,,AUTOMATIC DRAWING,Pratt-Parker,-40818.730000000025,Uncategorised, 
04-Mar-22,-1235.14,100728232,,INTER-BANK CREDIT,941651951034593 WILSON BROWN AND BROWN ,-42053.870000000024,Uncategorised, 
06-Mar-22,-778.97,100728232,,INTER-BANK CREDIT,Davis LLC,-42832.840000000026,Uncategorised, 
06-Mar-22,-1955.68,100728232,,INTER-BANK CREDIT,184721823709749 BOYD INC ,-44788.520000000026,Bills, 
06-Mar-22,-964.01,100728232,,AUTOMATIC DRAWING,Vincent-Williams,-45752.53000000003,Uncategorised, 
09-Mar-22,16.16,100728232,,INTER-BANK CREDIT,72959291439635 BOYD-KEITH ,-45736.370000000024,Bills, 
09-Mar-22,-1067.54,100728232,,INTER-BANK CREDIT,815049897193863 HOOVER PLC ,-46803.910000000025,Bills, 
12-Mar-22,1539.42,100728232,,INTER-BANK CREDIT,487419029157049 MARTINEZ INC ,-45264.49000000003,Bills, 
15-Mar-22,-1253.5,100728232,,TRANSFER DEBIT,128600621942144 RHODES MORTON AND HERNANDEZ ,-46517.99000000003,Other Income, 
18-Mar-22,-735.78,100728232,,INTER-BANK CREDIT,Simmons Ltd,-47253.770000000026,Uncategorised, 
18-Mar-22,1335.94,100728232,,TRANSFER DEBIT,106258518840905 WEST-THOMPSON ,-45917.83000000002,Uncategorised, 
21-Mar-22,-711.39,100728232,,TRANSFER DEBIT,Huffman-Reed,-46629.22000000002,Financial, 
22-Mar-22,1112.24,100728232,,AUTOMATIC DRAWING,Ibarra Crawford and Brown,-45516.980000000025,Other Income, 
23-Mar-22,1598.83,100728232,,INTER-BANK CREDIT,Mays Hess and Weaver,-43918.15000000002,Other Income, 
23-Mar-22,-385.55,100728232,,INTER-BANK CREDIT,Bass Williams and Morrow,-44303.700000000026,Financial, 
23-Mar-22,1382.33,100728232,,AUTOMATIC DRAWING,Alexander Group,-42921.370000000024,Financial, 
23-Mar-22,-291.98,100728232,,INTER-BANK CREDIT,591762437735623 DENNIS-LUCERO ,-43213.35000000003,Financial, 
24-Mar-22,-1092.91,100728232,,AUTOMATIC DRAWING,619255871756505 WALLACE INC ,-44306.26000000003,Financial, 
24-Mar-22,698.72,100728232,,TRANSFER DEBIT,Burke-Brown,-43607.54000000003,Uncategorised, 
24-Mar-22,-1299.75,100728232,,TRANSFER DEBIT,Hernandez-Gonzalez,-44907.29000000003,Bills, 
27-Mar-22,814.27,100728232,,TRANSFER DEBIT,Gray-Santos,-44093.02000000003,Bills, 
30-Mar-22,1444.95,100728232,,INTER-BANK CREDIT,Alvarez-Thompson,-42648.070000000036,Financial, 
01-Apr-22,-1566.5,100728232,,INTER-BANK CREDIT,Kennedy LLC,-44214.570000000036,Other Income, 
02-Apr-22,115.29,100728232,,INTER-BANK CREDIT,511220033631016 MARSHALL AND SONS ,-44099.280000000035,Uncategorised, 
05-Apr-22,-63.66,100728232,,TRANSFER DEBIT,Hudson Ltd,-44162.94000000004,Financial, 
05-Apr-22,-1243.92,100728232,,TRANSFER DEBIT,99363088326370 EVANS-PERRY ,-45406.86000000004,Uncategorised, 
05-Apr-22,604.62,100728232,,AUTOMATIC DRAWING,Quinn Smith and Owens,-44802.240000000034,Financial, 
05-Apr-22,23.08,100728232,,AUTOMATIC DRAWING,798883639043517 HEBERT GRIFFITH AND SANDERS ,-44779.16000000003,Financial, 
07-Apr-22,102.97,100728232,,INTER-BANK CREDIT,807444021535048 MCKNIGHT GOMEZ AND HART ,-44676.19000000003,Other Income, 
09-Apr-22,1649.33,100728232,,INTER-BANK CREDIT,19190831203060 FLORES-PETERSON ,-43026.86000000003,Uncategorised, 
11-Apr-22,-1284.69,100728232,,TRANSFER DEBIT,Hunter-Gardner,-44311.55000000003,Bills, 
12-Apr-22,-1968.93,100728232,,INTER-BANK CREDIT,639298969732761 WHEELER-WILLIAMS ,-46280.48000000003,Financial, 
13-Apr-22,-1850.63,100728232,,INTER-BANK CREDIT,842251601383249 LUNA AND SONS ,-48131.11000000003,Bills, 
13-Apr-22,-1729.76,100728232,,INTER-BANK CREDIT,Wilson-Walls,-49860.87000000003,Bills, 
15-Apr-22,327.62,100728232,,INTER-BANK CREDIT,Wheeler LLC,-49533.25000000003,Uncategorised, 
18-Apr-22,-865.37,100728232,,TRANSFER DEBIT,21524019527863 COOPER-HANCOCK ,-50398.62000000003,Other Income, 
19-Apr-22,-1624.01,100728232,,INTER-BANK CREDIT,David PLC,-52022.630000000034,Other Income, 
20-Apr-22,-1598.27,100728232,,INTER-BANK CREDIT,Rose Ltd,-53620.90000000003,Financial, 
23-Apr-22,-423.88,100728232,,TRANSFER DEBIT,Blake-Butler,-54044.78000000003,Financial, 
24-Apr-22,-557.16,100728232,,INTER-BANK CREDIT,206411817863865 BUSH RICHARDS AND RODRIGUEZ ,-54601.94000000003,Bills, 
27-Apr-22,1686.16,100728232,,AUTOMATIC DRAWING,920382177639117 JEFFERSON-ARNOLD ,-52915.78000000003,Other Income, 
27-Apr-22,-415.15,100728232,,TRANSFER DEBIT,355292347532258 BRAY-SCHMIDT ,-53330.93000000003,Bills, 
29-Apr-22,-867.67,100728232,,TRANSFER DEBIT,457816555821648 FREEMAN LARSEN AND CARTER ,-54198.60000000003,Uncategorised, 
29-Apr-22,634.26,100728232,,AUTOMATIC DRAWING,702251486001374 CHEN NELSON AND HORN ,-53564.340000000026,Other Income, 
02-May-22,1986.31,100728232,,AUTOMATIC DRAWING,552719556081694 LEE BUTLER AND ARMSTRONG ,-51578.03000000003,Uncategorised, 
03-May-22,-926.8,100728232,,INTER-BANK CREDIT,Dunn French and Jacobs,-52504.83000000003,Other Income, 
03-May-22,850.45,100728232,,AUTOMATIC DRAWING,141599394066168 GRANT SANCHEZ AND ELLIOTT ,-51654.380000000034,Other Income, 
05-May-22,-333.77,100728232,,AUTOMATIC DRAWING,619612625558929 KING-ROMERO ,-51988.15000000003,Financial, 
06-May-22,324.32,100728232,,INTER-BANK CREDIT,923829179693326 MUELLER GROUP ,-51663.83000000003,Other Income, 
07-May-22,479.72,100728232,,TRANSFER DEBIT,Peterson-Garcia,-51184.11000000003,Uncategorised, 
09-May-22,-654.36,100728232,,INTER-BANK CREDIT,580108450550230 WELCH CRAWFORD AND STAFFORD ,-51838.47000000003,Financial, 
12-May-22,1836.56,100728232,,TRANSFER DEBIT,564902502534069 COLEMAN AND SONS ,-50001.91000000003,Bills, 
12-May-22,1622.04,100728232,,INTER-BANK CREDIT,Hernandez Group,-48379.87000000003,Financial, 
13-May-22,-1449.97,100728232,,INTER-BANK CREDIT,Scott and Sons,-49829.84000000003,Financial, 
15-May-22,-482.5,100728232,,TRANSFER DEBIT,Meadows Group,-50312.34000000003,Uncategorised, 
18-May-22,1412.37,100728232,,TRANSFER DEBIT,Ware Burke and Simpson,-48899.97000000003,Other Income, 
18-May-22,-1034.53,100728232,,INTER-BANK CREDIT,885318731445116 BRYANT LLC ,-49934.50000000003,Bills, 
19-May-22,523.16,100728232,,INTER-BANK CREDIT,540499392691998 OLSON LLC ,-49411.340000000026,Bills, 
20-May-22,-1088.47,100728232,,INTER-BANK CREDIT,218981256526921 DIAZ GROUP ,-50499.81000000003,Uncategorised, 
22-May-22,-992.47,100728232,,AUTOMATIC DRAWING,615760944963595 MULLINS DIXON AND JONES ,-51492.28000000003,Other Income, 
22-May-22,1882.69,100728232,,INTER-BANK CREDIT,373606994938322 JENNINGS-KNAPP ,-49609.590000000026,Financial, 
24-May-22,1268.63,100728232,,TRANSFER DEBIT,737526141312615 WRIGHT-ANDERSON ,-48340.96000000003,Bills, 
26-May-22,-1022.98,100728232,,TRANSFER DEBIT,776306071335707 MOORE GROUP ,-49363.94000000003,Other Income, 
28-May-22,19.26,100728232,,INTER-BANK CREDIT,497123203473909 NELSON-YOUNG ,-49344.68000000003,Other Income, 
29-May-22,-1912.62,100728232,,AUTOMATIC DRAWING,Olson PLC,-51257.30000000003,Uncategorised, 
29-May-22,1233.68,100728232,,INTER-BANK CREDIT,387500402171250 MOODY-RIVERA ,-50023.62000000003,Other Income, 
30-May-22,-189.2,100728232,,INTER-BANK CREDIT,918754563498324 HAYES WATSON AND HUNTER ,-50212.82000000003,Financial, 
31-May-22,1253.2,100728232,,AUTOMATIC DRAWING,Moran Group,-48959.62000000003,Bills, 
03-Jun-22,171.21,100728232,,AUTOMATIC DRAWING,38526580440603 VARGAS-FLEMING ,-48788.41000000003,Financial, 
05-Jun-22,-165.94,100728232,,AUTOMATIC DRAWING,Clark Hines and Williams,-48954.350000000035,Other Income, 
07-Jun-22,-1145.12,100728232,,INTER-BANK CREDIT,99029178858247 ATKINSON AND SONS ,-50099.47000000004,Bills, 
08-Jun-22,-1034.79,100728232,,AUTOMATIC DRAWING,Murphy Ltd,-51134.26000000004,Uncategorised, 
11-Jun-22,-182.71,100728232,,AUTOMATIC DRAWING,Harrison Woods and Flores,-51316.97000000004,Bills, 
14-Jun-22,614.51,100728232,,AUTOMATIC DRAWING,Stevens-Pham,-50702.460000000036,Bills, 
14-Jun-22,610.17,100728232,,INTER-BANK CREDIT,645193192576783 COLLINS-SMITH ,-50092.29000000004,Other Income, 
17-Jun-22,158.69,100728232,,TRANSFER DEBIT,836883027352101 HOGAN-RODRIGUEZ ,-49933.600000000035,Uncategorised, 
18-Jun-22,1777.55,100728232,,INTER-BANK CREDIT,Wilson PLC,-48156.05000000003,Uncategorised, 
19-Jun-22,659.43,100728232,,INTER-BANK CREDIT,Mccullough Smith and Guerra,-47496.62000000003,Uncategorised, 
19-Jun-22,-583.02,100728232,,INTER-BANK CREDIT,654082810622997 WEAVER-ROBINSON ,-48079.64000000003,Financial, 
19-Jun-22,1510.01,100728232,,AUTOMATIC DRAWING,Anderson LLC,-46569.63000000003,Bills, 
19-Jun-22,-953.16,100728232,,TRANSFER DEBIT,778167898599104 BUCK BOWERS AND PEREZ ,-47522.79000000003,Uncategorised, 
22-Jun-22,-1447.63,100728232,,TRANSFER DEBIT,Mays Hall and Ramos,-48970.42000000003,Uncategorised, 
24-Jun-22,1756.74,100728232,,TRANSFER DEBIT,Avery-Blair,-47213.68000000003,Financial, 
24-Jun-22,796.85,100728232,,AUTOMATIC DRAWING,692379636454131 CALDERON AND SONS ,-46416.83000000003,Financial, 
25-Jun-22,374.2,100728232,,INTER-BANK CREDIT,Mathews-Burns,-46042.630000000034,Financial, 
26-Jun-22,-125.0,100728232,,TRANSFER DEBIT,914307197814013 BURTON PLC ,-46167.630000000034,Other Income, 
28-Jun-22,-111.83,100728232,,AUTOMATIC DRAWING,Brooks Price and Johnson,-46279.460000000036,Bills, 
30-Jun-22,-1176.38,100728232,,INTER-BANK CREDIT,170490545623538 BURGESS-BERG ,-47455.84000000003,Other Income, 
02-Jul-22,806.14,100728232,,INTER-BANK CREDIT,Shelton Inc,-46649.70000000003,Other Income, 
02-Jul-22,-1869.66,100728232,,TRANSFER DEBIT,61812016020671 PITTMAN GROUP ,-48519.36000000004,Uncategorised, 
04-Jul-22,1601.51,100728232,,AUTOMATIC DRAWING,Anderson Brooks and Shaw,-46917.850000000035,Other Income, 
06-Jul-22,-1660.76,100728232,,AUTOMATIC DRAWING,195845780180040 MITCHELL-STEWART ,-48578.61000000004,Uncategorised, 
06-Jul-22,420.89,100728232,,TRANSFER DEBIT,Singh Delacruz and Jackson,-48157.72000000004,Financial, 
09-Jul-22,1602.33,100728232,,INTER-BANK CREDIT,552350182115893 MILLS-HERNANDEZ ,-46555.390000000036,Financial, 
12-Jul-22,-1903.81,100728232,,AUTOMATIC DRAWING,40090599736514 DUKE-COLLINS ,-48459.20000000003,Bills, 
13-Jul-22,4.45,100728232,,AUTOMATIC DRAWING,223220197498829 BLAIR INC ,-48454.75000000004,Bills, 
15-Jul-22,83.43,100728232,,AUTOMATIC DRAWING,Estrada Pollard and Berry,-48371.320000000036,Bills, 
15-Jul-22,1648.16,100728232,,TRANSFER DEBIT,178490778519452 HARRIS-HENDERSON ,-46723.16000000003,Uncategorised, 
15-Jul-22,-1096.39,100728232,,INTER-BANK CREDIT,413677054468054 HAMILTON-WALLACE ,-47819.55000000003,Uncategorised, 
18-Jul-22,677.81,100728232,,INTER-BANK CREDIT,904166661431903 JACKSON-CASTILLO ,-47141.740000000034,Financial, 
19-Jul-22,-441.43,100728232,,TRANSFER DEBIT,756803822232909 MATHEWS WARD AND SALAZAR ,-47583.170000000035,Uncategorised, 
19-Jul-22,-576.98,100728232,,TRANSFER DEBIT,439770864875347 LYONS HERNANDEZ AND WARREN ,-48160.15000000004,Bills, 
21-Jul-22,822.0,100728232,,AUTOMATIC DRAWING,70095847318222 DEAN AND SONS ,-47338.15000000004,Other Income, 
21-Jul-22,1056.17,100728232,,TRANSFER DEBIT,11622032300936 DANIELS PLC ,-46281.98000000004,Bills, 
23-Jul-22,1990.34,100728232,,AUTOMATIC DRAWING,Gardner LLC,-44291.64000000004,Other Income, 
25-Jul-22,-253.09,100728232,,TRANSFER DEBIT,351049661356533 MEYERS BENITEZ AND HARRIS ,-44544.73000000004,Bills, 
28-Jul-22,446.05,100728232,,TRANSFER DEBIT,486544526512409 BAILEY AND SONS ,-44098.68000000004,Uncategorised, 
29-Jul-22,762.65,100728232,,INTER-BANK CREDIT,855765530225534 LANG ROJAS AND TURNER ,-43336.030000000035,Bills, 
31-Jul-22,881.38,100728232,,TRANSFER DEBIT,Cabrera-Brown,-42454.65000000004,Other Income, 
02-Aug-22,42.5,100728232,,AUTOMATIC DRAWING,Mitchell and Sons,-42412.15000000004,Bills, 
02-Aug-22,-1715.22,100728232,,INTER-BANK CREDIT,Davis-Figueroa,-44127.37000000004,Bills, 
03-Aug-22,-1704.68,100728232,,AUTOMATIC DRAWING,360653307910149 JENSEN PLC ,-45832.05000000004,Financial, 
03-Aug-22,150.43,100728232,,AUTOMATIC DRAWING,Zuniga Ritter and Sanchez,-45681.62000000004,Uncategorised, 
03-Aug-22,1819.33,100728232,,TRANSFER DEBIT,Porter-Mercer,-43862.29000000004,Bills, 
03-Aug-22,-791.0,100728232,,INTER-BANK CREDIT,Oconnor-Hayden,-44653.29000000004,Bills, 
05-Aug-22,-298.6,100728232,,TRANSFER DEBIT,94580723163930 HERNANDEZ MCLEAN AND DAVIS ,-44951.890000000036,Uncategorised, 
07-Aug-22,444.62,100728232,,AUTOMATIC DRAWING,Andrews Inc,-44507.27000000003,Financial, 
07-Aug-22,-1824.93,100728232,,INTER-BANK CREDIT,963139114656571 GALVAN-FOWLER ,-46332.20000000003,Financial, 
07-Aug-22,1585.95,100728232,,TRANSFER DEBIT,899761404466690 DAVIS MEYER AND RODRIGUEZ ,-44746.25000000004,Uncategorised, 
08-Aug-22,-1338.72,100728232,,INTER-BANK CREDIT,Vargas PLC,-46084.97000000004,Uncategorised, 
11-Aug-22,-1414.72,100728232,,TRANSFER DEBIT,Deleon-Perry,-47499.69000000004,Other Income, 
12-Aug-22,-1596.64,100728232,,INTER-BANK CREDIT,624152358057046 CONLEY INC ,-49096.33000000004,Financial, 
15-Aug-22,1008.27,100728232,,INTER-BANK CREDIT,Schaefer Ltd,-48088.06000000004,Uncategorised, 
15-Aug-22,-1748.03,100728232,,INTER-BANK CREDIT,368065898644591 MCKNIGHT-MARTINEZ ,-49836.09000000004,Bills, 
17-Aug-22,1135.4,100728232,,AUTOMATIC DRAWING,383007946964818 HOBBS LEVY AND COOPER ,-48700.69000000004,Financial, 
18-Aug-22,-1966.42,100728232,,INTER-BANK CREDIT,Davis Ltd,-50667.11000000004,Uncategorised, 
18-Aug-22,222.82,100728232,,AUTOMATIC DRAWING,615335337504527 WARREN NGUYEN AND DAVIS ,-50444.29000000004,Financial, 
19-Aug-22,-944.42,100728232,,INTER-BANK CREDIT,684059107448341 MILLER MARTIN AND RICHARDSON ,-51388.710000000036,Bills, 
19-Aug-22,1145.76,100728232,,INTER-BANK CREDIT,975281844236547 BARKER INC ,-50242.95000000003,Uncategorised, 
20-Aug-22,-1531.36,100728232,,TRANSFER DEBIT,Gibson Ltd,-51774.310000000034,Financial, 
21-Aug-22,188.69,100728232,,INTER-BANK CREDIT,Douglas-Fisher,-51585.62000000003,Financial, 
22-Aug-22,15.05,100728232,,INTER-BANK CREDIT,Riley-Thompson,-51570.57000000003,Financial, 
25-Aug-22,1398.92,100728232,,INTER-BANK CREDIT,Mendoza Group,-50171.65000000003,Financial, 
26-Aug-22,-1988.98,100728232,,AUTOMATIC DRAWING,174447304636628 NORTON THOMAS AND WILLIAMS ,-52160.630000000034,Financial, 
26-Aug-22,-556.23,100728232,,INTER-BANK CREDIT,Massey PLC,-52716.86000000004,Financial, 
28-Aug-22,520.7,100728232,,INTER-BANK CREDIT,122051556283058 FOSTER-STEWART ,-52196.16000000004,Bills, 
31-Aug-22,-159.43,100728232,,INTER-BANK CREDIT,Mitchell Herrera and Hull,-52355.59000000004,Uncategorised, 
03-Sep-22,-286.35,100728232,,INTER-BANK CREDIT,511686728654017 DUNCAN GIBSON AND MILLER ,-52641.94000000004,Financial, 
04-Sep-22,1927.16,100728232,,TRANSFER DEBIT,318364757259525 RIVERA GARZA AND SMITH ,-50714.780000000035,Financial, 
07-Sep-22,1454.69,100728232,,AUTOMATIC DRAWING,Newton Ltd,-49260.09000000003,Other Income, 
07-Sep-22,1441.36,100728232,,INTER-BANK CREDIT,Brown Barrett and Evans,-47818.73000000003,Financial, 
09-Sep-22,-346.55,100728232,,INTER-BANK CREDIT,Garner Howard and Ibarra,-48165.280000000035,Financial, 
12-Sep-22,988.59,100728232,,AUTOMATIC DRAWING,659047670413938 GOODWIN CARTER AND GRAVES ,-47176.69000000004,Uncategorised, 
13-Sep-22,-669.17,100728232,,INTER-BANK CREDIT,Allen Patterson and Harrington,-47845.86000000004,Financial, 
14-Sep-22,-715.68,100728232,,INTER-BANK CREDIT,459092692857353 MULLINS SMITH AND YOUNG ,-48561.54000000004,Financial, 
15-Sep-22,1285.2,100728232,,AUTOMATIC DRAWING,Lopez-Castaneda,-47276.34000000004,Other Income, 
17-Sep-22,-1690.24,100728232,,INTER-BANK CREDIT,467840082712175 MOORE MILLER AND WRIGHT ,-48966.58000000004,Financial, 
17-Sep-22,408.16,100728232,,INTER-BANK CREDIT,Roberts Mckinney and Burke,-48558.420000000035,Financial, 
19-Sep-22,1302.89,100728232,,TRANSFER DEBIT,Perkins Ltd,-47255.530000000035,Other Income, 
19-Sep-22,1961.53,100728232,,AUTOMATIC DRAWING,Morris Steele and Fritz,-45294.00000000004,Other Income, 
21-Sep-22,-456.04,100728232,,TRANSFER DEBIT,Neal-Gilmore,-45750.04000000004,Financial, 
21-Sep-22,-962.43,100728232,,INTER-BANK CREDIT,475673537171439 BUSH-FRYE ,-46712.47000000004,Other Income, 
23-Sep-22,-1089.06,100728232,,INTER-BANK CREDIT,Combs PLC,-47801.530000000035,Other Income, 
26-Sep-22,-245.34,100728232,,AUTOMATIC DRAWING,406248015441056 INGRAM PLC ,-48046.87000000003,Bills, 
28-Sep-22,-583.89,100728232,,INTER-BANK CREDIT,Thompson-Bates,-48630.76000000003,Financial, 
28-Sep-22,-603.33,100728232,,INTER-BANK CREDIT,509963145133396 BUCK POWELL AND SANDERS ,-49234.09000000003,Other Income, 
01-Oct-22,1802.74,100728232,,AUTOMATIC DRAWING,Smith Kane and Lewis,-47431.350000000035,Bills, 
04-Oct-22,-371.64,100728232,,INTER-BANK CREDIT,896380858433827 STONE GROUP ,-47802.990000000034,Bills, 
04-Oct-22,-1976.35,100728232,,INTER-BANK CREDIT,836066492613839 BROWN GROUP ,-49779.34000000003,Bills, 
07-Oct-22,1943.02,100728232,,TRANSFER DEBIT,Dickson Ltd,-47836.320000000036,Uncategorised, 
10-Oct-22,1728.3,100728232,,TRANSFER DEBIT,Roberts-Johnson,-46108.02000000003,Bills, 
13-Oct-22,-1245.17,100728232,,AUTOMATIC DRAWING,887342746568535 FRANKLIN-MURRAY ,-47353.19000000003,Uncategorised, 
13-Oct-22,1908.89,100728232,,INTER-BANK CREDIT,699736701091959 LEWIS SALINAS AND RICH ,-45444.30000000003,Other Income, 
14-Oct-22,682.08,100728232,,INTER-BANK CREDIT,Ferguson and Sons,-44762.22000000003,Other Income, 
16-Oct-22,-424.35,100728232,,TRANSFER DEBIT,Chang Morales and Lee,-45186.57000000003,Uncategorised, 
18-Oct-22,-1430.24,100728232,,TRANSFER DEBIT,331828836223350 COSTA JAMES AND GAMBLE ,-46616.81000000003,Bills, 
21-Oct-22,1579.91,100728232,,INTER-BANK CREDIT,Holden-Carlson,-45036.90000000002,Uncategorised, 
21-Oct-22,1591.53,100728232,,TRANSFER DEBIT,Proctor-Wise,-43445.370000000024,Other Income, 
23-Oct-22,-1422.01,100728232,,INTER-BANK CREDIT,961562940782304 SHEPPARD DIXON AND FRAZIER ,-44867.38000000003,Uncategorised, 
24-Oct-22,1313.95,100728232,,INTER-BANK CREDIT,Bishop Ltd,-43553.43000000003,Other Income, 
25-Oct-22,-1988.79,100728232,,AUTOMATIC DRAWING,Garcia Hayes and Jones,-45542.22000000003,Uncategorised, 
28-Oct-22,1496.45,100728232,,INTER-BANK CREDIT,182396743313333 DIXON GREEN AND BRYANT ,-44045.77000000003,Uncategorised, 
28-Oct-22,81.53,100728232,,INTER-BANK CREDIT,Ryan-Smith,-43964.240000000034,Bills, 
29-Oct-22,584.2,100728232,,TRANSFER DEBIT,Mercado Contreras and Perez,-43380.04000000004,Financial, 
01-Nov-22,1893.0,100728232,,INTER-BANK CREDIT,May Gutierrez and Villegas,-41487.04000000004,Financial, 
04-Nov-22,1382.43,100728232,,INTER-BANK CREDIT,Silva Haas and Cooper,-40104.61000000004,Uncategorised, 
07-Nov-22,-179.45,100728232,,INTER-BANK CREDIT,650691902180443 RAY PLC ,-40284.060000000034,Uncategorised, 
09-Nov-22,-948.19,100728232,,AUTOMATIC DRAWING,Powers Burnett and Sanchez,-41232.25000000004,Other Income, 
09-Nov-22,787.85,100728232,,INTER-BANK CREDIT,Perez Group,-40444.40000000004,Bills, 
09-Nov-22,-1676.91,100728232,,AUTOMATIC DRAWING,Carrillo Inc,-42121.31000000004,Financial, 
10-Nov-22,1374.99,100728232,,INTER-BANK CREDIT,152723493324289 TREVINO JOHNSON AND RODRIGUEZ ,-40746.32000000004,Financial, 
10-Nov-22,1411.53,100728232,,AUTOMATIC DRAWING,765961599691513 MCCANN PLC ,-39334.790000000045,Uncategorised, 
10-Nov-22,-1616.94,100728232,,AUTOMATIC DRAWING,Watkins-Frazier,-40951.73000000005,Uncategorised, 
12-Nov-22,763.02,100728232,,AUTOMATIC DRAWING,Jackson PLC,-40188.71000000005,Bills, 
12-Nov-22,678.06,100728232,,INTER-BANK CREDIT,355958833639971 WEISS INC ,-39510.65000000005,Other Income, 
15-Nov-22,190.76,100728232,,INTER-BANK CREDIT,540578963036088 KANE DANIELS AND STAFFORD ,-39319.89000000005,Other Income, 
15-Nov-22,103.21,100728232,,INTER-BANK CREDIT,Henry Group,-39216.68000000005,Financial, 
16-Nov-22,-1483.62,100728232,,AUTOMATIC DRAWING,Doyle Inc,-40700.300000000054,Uncategorised, 
17-Nov-22,736.57,100728232,,AUTOMATIC DRAWING,Rodriguez Inc,-39963.730000000054,Financial, 
19-Nov-22,-1373.14,100728232,,AUTOMATIC DRAWING,432444601310133 ROTH-DAVIS ,-41336.87000000005,Financial, 
21-Nov-22,165.45,100728232,,TRANSFER DEBIT,Brown Cabrera and West,-41171.42000000006,Bills, 
22-Nov-22,1862.06,100728232,,INTER-BANK CREDIT,Coffey-Williams,-39309.36000000006,Financial, 
24-Nov-22,-445.0,100728232,,INTER-BANK CREDIT,180712487625205 WOODS AND SONS ,-39754.36000000006,Bills, 
25-Nov-22,-262.89,100728232,,INTER-BANK CREDIT,750884509450847 JOHNS MARTIN AND ARMSTRONG ,-40017.25000000006,Other Income, 
28-Nov-22,455.75,100728232,,AUTOMATIC DRAWING,834368911220034 MARTINEZ-NEWMAN ,-39561.50000000006,Financial, 
28-Nov-22,1566.72,100728232,,TRANSFER DEBIT,Haney Clay and Hall,-37994.78000000006,Other Income, 
30-Nov-22,1085.05,100728232,,TRANSFER DEBIT,Bautista-Reese,-36909.730000000054,Financial, 
03-Dec-22,1959.47,100728232,,INTER-BANK CREDIT,Carroll PLC,-34950.26000000005,Bills, 
03-Dec-22,313.05,100728232,,AUTOMATIC DRAWING,634345814880240 ROBINSON LLC ,-34637.21000000005,Other Income, 
06-Dec-22,601.42,100728232,,INTER-BANK CREDIT,969244421632641 LEWIS-ALVARADO ,-34035.79000000005,Bills, 
08-Dec-22,42.36,100728232,,AUTOMATIC DRAWING,233207650872665 KIM WILLIAMS AND HUNT ,-33993.43000000005,Financial, 
08-Dec-22,672.24,100728232,,INTER-BANK CREDIT,Monroe Fox and Roth,-33321.19000000005,Bills, 
08-Dec-22,520.78,100728232,,INTER-BANK CREDIT,649169913296738 BULLOCK LTD ,-32800.410000000054,Uncategorised, 
10-Dec-22,-1901.54,100728232,,AUTOMATIC DRAWING,Hill-Sims,-34701.950000000055,Uncategorised, 
10-Dec-22,195.73,100728232,,INTER-BANK CREDIT,904199262579565 FLEMING-FITZPATRICK ,-34506.22000000005,Bills, 
11-Dec-22,-1040.04,100728232,,TRANSFER DEBIT,Richmond-Williamson,-35546.26000000005,Uncategorised, 
14-Dec-22,1690.49,100728232,,AUTOMATIC DRAWING,Martinez-House,-33855.770000000055,Financial, 
14-Dec-22,693.97,100728232,,INTER-BANK CREDIT,Fox LLC,-33161.800000000054,Uncategorised, 
14-Dec-22,1726.56,100728232,,INTER-BANK CREDIT,730522913896214 HERNANDEZ-LYNCH ,-31435.240000000053,Other Income, 
14-Dec-22,933.29,100728232,,AUTOMATIC DRAWING,154984024622033 GRAVES EVANS AND GARCIA ,-30501.95000000005,Other Income, 
17-Dec-22,-414.58,100728232,,INTER-BANK CREDIT,616400167980412 MATHEWS REED AND ROBERTS ,-30916.530000000053,Uncategorised, 
18-Dec-22,1923.46,100728232,,INTER-BANK CREDIT,Pierce PLC,-28993.070000000054,Financial, 
21-Dec-22,1511.58,100728232,,INTER-BANK CREDIT,177690710847411 HARRIS GROUP ,-27481.490000000056,Financial, 
24-Dec-22,1164.82,100728232,,INTER-BANK CREDIT,422501407744749 HOWARD INC ,-26316.670000000056,Other Income, 
25-Dec-22,-185.55,100728232,,TRANSFER DEBIT,810478773443833 JOHNSON-CRAIG ,-26502.220000000056,Financial, 
28-Dec-22,-417.58,100728232,,AUTOMATIC DRAWING,737410857951554 JONES STEWART AND FOWLER ,-26919.800000000057,Other Income, 
29-Dec-22,-894.19,100728232,,INTER-BANK CREDIT,Quinn Burgess and Graham,-27813.990000000056,Uncategorised, 
29-Dec-22,-1554.55,100728232,,AUTOMATIC DRAWING,Walker PLC,-29368.540000000055,Financial, 
01-Jan-23,663.32,100728232,,INTER-BANK CREDIT,335542959245249 SMITH ALEXANDER AND MOORE ,-28705.220000000056,Financial, 
01-Jan-23,-1295.35,100728232,,AUTOMATIC DRAWING,Wilson Inc,-30000.570000000054,Bills, 
02-Jan-23,-459.11,100728232,,AUTOMATIC DRAWING,495461700803954 MILLER LOPEZ AND JOHNSON ,-30459.680000000055,Other Income, 
05-Jan-23,1238.24,100728232,,INTER-BANK CREDIT,Heath LLC,-29221.440000000053,Financial, 
05-Jan-23,-292.25,100728232,,AUTOMATIC DRAWING,557757131326988 SHAW-SHELTON ,-29513.690000000053,Other Income, 
06-Jan-23,15.57,100728232,,INTER-BANK CREDIT,921093248348550 BUSH-CURTIS ,-29498.120000000054,Bills, 
09-Jan-23,-510.94,100728232,,INTER-BANK CREDIT,349785172431473 PAYNE PLC ,-30009.060000000052,Financial, 
09-Jan-23,172.11,100728232,,INTER-BANK CREDIT,Alvarez Gonzalez and Brown,-29836.95000000005,Uncategorised, 
12-Jan-23,-762.17,100728232,,TRANSFER DEBIT,359892945772217 BOWEN LTD ,-30599.12000000005,Other Income, 
14-Jan-23,-1124.33,100728232,,AUTOMATIC DRAWING,Garza and Sons,-31723.450000000048,Financial, 
17-Jan-23,1516.69,100728232,,AUTOMATIC DRAWING,Hayes-Lopez,-30206.76000000005,Other Income, 
18-Jan-23,-1252.79,100728232,,TRANSFER DEBIT,355697318590101 SMITH KELLY AND PHILLIPS ,-31459.55000000005,Financial, 
19-Jan-23,-1812.0,100728232,,INTER-BANK CREDIT,167448917414044 JOHNSON-YORK ,-33271.55000000005,Other Income, 
19-Jan-23,-1859.33,100728232,,INTER-BANK CREDIT,Young Thomas and Nguyen,-35130.88000000005,Uncategorised, 
21-Jan-23,-883.79,100728232,,INTER-BANK CREDIT,Rogers Inc,-36014.67000000005,Uncategorised, 
21-Jan-23,86.31,100728232,,AUTOMATIC DRAWING,Michael Thomas and Alexander,-35928.36000000005,Uncategorised, 
23-Jan-23,1268.87,100728232,,TRANSFER DEBIT,Bush-Horn,-34659.49000000005,Other Income, 
24-Jan-23,390.79,100728232,,INTER-BANK CREDIT,227201912226609 COOPER-YU ,-34268.70000000005,Uncategorised, 
24-Jan-23,-1340.78,100728232,,INTER-BANK CREDIT,Garcia PLC,-35609.48000000005,Bills, 
25-Jan-23,951.88,100728232,,AUTOMATIC DRAWING,Beard and Sons,-34657.60000000005,Bills, 
27-Jan-23,-258.91,100728232,,AUTOMATIC DRAWING,Gonzales-Wall,-34916.51000000005,Bills, 
27-Jan-23,1483.29,100728232,,INTER-BANK CREDIT,928738449775595 WILLIAMSON-GRIFFIN ,-33433.22000000005,Bills, 
28-Jan-23,646.37,100728232,,INTER-BANK CREDIT,528336605773309 THOMPSON HORN AND MORENO ,-32786.85000000005,Uncategorised, 
29-Jan-23,836.48,100728232,,TRANSFER DEBIT,34749901524521 GARCIA MITCHELL AND AVILA ,-31950.37000000005,Bills, 
01-Feb-23,-1808.21,100728232,,AUTOMATIC DRAWING,245300497746297 GARDNER-JONES ,-33758.58000000005,Other Income, 
01-Feb-23,-1300.54,100728232,,INTER-BANK CREDIT,David Grant and Rodriguez,-35059.12000000005,Other Income, 
01-Feb-23,-255.51,100728232,,INTER-BANK CREDIT,529934822508078 PARKER HUNT AND GARRISON ,-35314.630000000056,Uncategorised, 
03-Feb-23,888.69,100728232,,AUTOMATIC DRAWING,Winters-Sanchez,-34425.94000000005,Financial, 
06-Feb-23,68.57,100728232,,INTER-BANK CREDIT,865294061705107 PEARSON GROUP ,-34357.37000000005,Bills, 
09-Feb-23,760.79,100728232,,TRANSFER DEBIT,Woods-Norman,-33596.58000000005,Uncategorised, 
12-Feb-23,-796.41,100728232,,INTER-BANK CREDIT,772778873275526 MORGAN-EDWARDS ,-34392.990000000056,Financial, 
15-Feb-23,1300.33,100728232,,INTER-BANK CREDIT,Williams Inc,-33092.660000000054,Bills, 
16-Feb-23,755.33,100728232,,AUTOMATIC DRAWING,Arroyo Martin and Dorsey,-32337.330000000053,Other Income, 
18-Feb-23,-1263.29,100728232,,TRANSFER DEBIT,622632981834794 LOPEZ-KEITH ,-33600.62000000005,Other Income, 
18-Feb-23,365.07,100728232,,AUTOMATIC DRAWING,619421764264341 GARDNER AND SONS ,-33235.550000000054,Financial, 
20-Feb-23,-966.47,100728232,,TRANSFER DEBIT,Maldonado Allen and Snyder,-34202.020000000055,Uncategorised, 
22-Feb-23,-1732.91,100728232,,TRANSFER DEBIT,632642483964418 WADE PLC ,-35934.93000000006,Financial, 
25-Feb-23,1831.11,100728232,,AUTOMATIC DRAWING,Solomon-Mcintyre,-34103.82000000006,Uncategorised, 
25-Feb-23,-1044.41,100728232,,INTER-BANK CREDIT,433422811184485 DAVIS-RANDOLPH ,-35148.23000000006,Financial, 
26-Feb-23,805.02,100728232,,TRANSFER DEBIT,502053013820949 WALTERS LLC ,-34343.210000000065,Financial, 
01-Mar-23,556.64,100728232,,INTER-BANK CREDIT,321788192540627 SMALL MCCOY AND BERG ,-33786.570000000065,Other Income, 
04-Mar-23,379.79,100728232,,TRANSFER DEBIT,Liu and Sons,-33406.780000000064,Uncategorised, 
07-Mar-23,-1492.43,100728232,,AUTOMATIC DRAWING,Davenport-Williams,-34899.210000000065,Other Income, 
09-Mar-23,-41.48,100728232,,INTER-BANK CREDIT,Mathis-Copeland,-34940.69000000007,Other Income, 
09-Mar-23,-956.31,100728232,,AUTOMATIC DRAWING,Davis-Mccoy,-35897.000000000065,Other Income, 
09-Mar-23,632.0,100728232,,INTER-BANK CREDIT,980584258756602 WILLIAMS HARRIS AND PHILLIPS ,-35265.000000000065,Bills, 
11-Mar-23,1766.15,100728232,,INTER-BANK CREDIT,Miller-James,-33498.850000000064,Bills, 
11-Mar-23,-690.16,100728232,,TRANSFER DEBIT,299818603770820 JACKSON JACOBS AND LONG ,-34189.01000000007,Bills, 
13-Mar-23,659.06,100728232,,INTER-BANK CREDIT,145984744465866 FLOWERS-SOSA ,-33529.95000000007,Bills, 
13-Mar-23,-1051.76,100728232,,AUTOMATIC DRAWING,Anderson Mathews and Johnson,-34581.71000000007,Other Income, 
15-Mar-23,-1354.58,100728232,,INTER-BANK CREDIT,827860715862086 WARD HARTMAN AND HOFFMAN ,-35936.29000000007,Other Income, 
17-Mar-23,-990.73,100728232,,INTER-BANK CREDIT,513764289550422 MILLER GROUP ,-36927.02000000008,Bills, 
19-Mar-23,1930.01,100728232,,INTER-BANK CREDIT,Ali Arnold and Donovan,-34997.010000000075,Other Income, 
20-Mar-23,1408.81,100728232,,INTER-BANK CREDIT,760018319373363 DUNN-BLACK ,-33588.20000000008,Other Income, 
20-Mar-23,667.87,100728232,,INTER-BANK CREDIT,Melton and Sons,-32920.330000000075,Bills, 
22-Mar-23,1601.09,100728232,,AUTOMATIC DRAWING,Galloway-Brown,-31319.240000000074,Other Income, 
24-Mar-23,1751.3,100728232,,TRANSFER DEBIT,Flores and Sons,-29567.940000000075,Bills, 
26-Mar-23,545.8,100728232,,INTER-BANK CREDIT,7275506933756 BARNES ARMSTRONG AND OCHOA ,-29022.140000000076,Other Income, 
27-Mar-23,-866.34,100728232,,INTER-BANK CREDIT,Wells-Gonzalez,-29888.480000000076,Financial, 
29-Mar-23,1574.55,100728232,,INTER-BANK CREDIT,Davila Bryan and Black,-28313.930000000077,Uncategorised, 
29-Mar-23,1340.03,100728232,,INTER-BANK CREDIT,422112565067517 INGRAM MALDONADO AND WATSON ,-26973.900000000078,Other Income, 
31-Mar-23,-1945.85,100728232,,INTER-BANK CREDIT,Marshall-Richardson,-28919.750000000076,Financial, 
31-Mar-23,1407.89,100728232,,AUTOMATIC DRAWING,79700326741868 SULLIVAN INC ,-27511.860000000077,Financial, 
31-Mar-23,978.76,100728232,,INTER-BANK CREDIT,721818626407775 TAYLOR-ROSALES ,-26533.10000000008,Uncategorised, 
03-Apr-23,369.6,100728232,,AUTOMATIC DRAWING,441791383996246 BRUCE-TAYLOR ,-26163.50000000008,Bills, 
06-Apr-23,-1760.44,100728232,,INTER-BANK CREDIT,Williams Lucero and Campbell,-27923.94000000008,Financial, 
07-Apr-23,-1464.02,100728232,,AUTOMATIC DRAWING,35828992838377 SMITH JONES AND MORALES ,-29387.96000000008,Other Income, 
08-Apr-23,431.63,100728232,,INTER-BANK CREDIT,128236987506752 HILL LLC ,-28956.330000000078,Uncategorised, 
08-Apr-23,-1140.28,100728232,,TRANSFER DEBIT,805960529884472 BARNES PLC ,-30096.610000000077,Bills, 
10-Apr-23,1592.57,100728232,,AUTOMATIC DRAWING,253338005303532 SHAH-SOLIS ,-28504.040000000077,Financial, 
13-Apr-23,379.22,100728232,,TRANSFER DEBIT,Lane-Bailey,-28124.820000000076,Bills, 
15-Apr-23,-1500.51,100728232,,INTER-BANK CREDIT,Miller Adams and Hansen,-29625.330000000075,Uncategorised, 
16-Apr-23,-350.27,100728232,,INTER-BANK CREDIT,Bennett-Reynolds,-29975.600000000075,Bills, 
19-Apr-23,-1059.16,100728232,,INTER-BANK CREDIT,Baldwin-Hood,-31034.760000000075,Other Income, 
21-Apr-23,-370.32,100728232,,TRANSFER DEBIT,330936324811921 BARTON-GILBERT ,-31405.080000000075,Financial, 
22-Apr-23,749.41,100728232,,AUTOMATIC DRAWING,179659906178486 GONZALEZ PHILLIPS AND BRIDGES ,-30655.670000000075,Bills, 
23-Apr-23,-990.93,100728232,,INTER-BANK CREDIT,632653084880069 BROWN GARCIA AND HOFFMAN ,-31646.600000000075,Bills, 
24-Apr-23,1992.27,100728232,,INTER-BANK CREDIT,Arnold Inc,-29654.330000000075,Bills, 
26-Apr-23,-555.54,100728232,,TRANSFER DEBIT,Williams Ltd,-30209.870000000075,Uncategorised, 
26-Apr-23,-1205.02,100728232,,AUTOMATIC DRAWING,Howe Group,-31414.890000000076,Other Income, 
29-Apr-23,-142.11,100728232,,INTER-BANK CREDIT,Wilson-Padilla,-31557.000000000076,Uncategorised, 
02-May-23,1879.53,100728232,,AUTOMATIC DRAWING,Woodard LLC,-29677.470000000078,Uncategorised, 
03-May-23,-1254.78,100728232,,AUTOMATIC DRAWING,919862730823024 ALEXANDER INGRAM AND COMBS ,-30932.250000000076,Uncategorised, 
03-May-23,-678.45,100728232,,TRANSFER DEBIT,98451145797676 SOSA-RIVERA ,-31610.700000000077,Bills, 
04-May-23,-709.23,100728232,,INTER-BANK CREDIT,371911302917970 COLEMAN-MOLINA ,-32319.930000000077,Other Income, 
07-May-23,1192.52,100728232,,TRANSFER DEBIT,Kennedy and Sons,-31127.410000000076,Uncategorised, 
09-May-23,-1169.62,100728232,,INTER-BANK CREDIT,784300686007186 MAYS-JACKSON ,-32297.030000000075,Financial, 
09-May-23,761.85,100728232,,INTER-BANK CREDIT,Vang Inc,-31535.180000000077,Other Income, 
09-May-23,-1630.79,100728232,,AUTOMATIC DRAWING,Avila-Sutton,-33165.970000000074,Financial, 
09-May-23,-1676.0,100728232,,INTER-BANK CREDIT,366466793331659 JOSEPH PLC ,-34841.970000000074,Bills, 
11-May-23,918.41,100728232,,TRANSFER DEBIT,70110114780378 CANTU PLC ,-33923.56000000007,Other Income, 
14-May-23,380.59,100728232,,TRANSFER DEBIT,Williamson-Greer,-33542.970000000074,Bills, 
17-May-23,563.73,100728232,,INTER-BANK CREDIT,107103393885984 RAY AND SONS ,-32979.24000000007,Other Income, 
17-May-23,-112.8,100728232,,TRANSFER DEBIT,Hall Group,-33092.04000000007,Other Income, 
19-May-23,596.31,100728232,,INTER-BANK CREDIT,Hill Group,-32495.730000000072,Financial, 
21-May-23,456.75,100728232,,TRANSFER DEBIT,Holmes Ford and Maldonado,-32038.980000000072,Uncategorised, 
21-May-23,969.45,100728232,,TRANSFER DEBIT,809275182529553 GONZALEZ-BERRY ,-31069.53000000007,Other Income, 
21-May-23,312.38,100728232,,INTER-BANK CREDIT,Adams Davis and Miranda,-30757.15000000007,Financial, 
23-May-23,-81.6,100728232,,INTER-BANK CREDIT,484457842834172 WYATT-WILLIAMS ,-30838.75000000007,Other Income, 
25-May-23,1889.04,100728232,,TRANSFER DEBIT,589382724764071 KELLER RAMOS AND SANCHEZ ,-28949.71000000007,Other Income, 
26-May-23,-804.38,100728232,,INTER-BANK CREDIT,787276879865854 WATSON-LEWIS ,-29754.09000000007,Bills, 
28-May-23,1451.23,100728232,,INTER-BANK CREDIT,Santiago Frost and Fuller,-28302.86000000007,Financial, 
29-May-23,300.72,100728232,,TRANSFER DEBIT,Foster Martinez and Webb,-28002.14000000007,Financial, 
31-May-23,1352.4,100728232,,TRANSFER DEBIT,Gonzalez LLC,-26649.740000000067,Uncategorised, 
31-May-23,156.81,100728232,,TRANSFER DEBIT,Reynolds LLC,-26492.930000000066,Uncategorised, 
02-Jun-23,-1264.66,100728232,,TRANSFER DEBIT,Lopez Clayton and Garza,-27757.590000000066,Bills, 
03-Jun-23,1783.68,100728232,,AUTOMATIC DRAWING,878048547493156 MADDOX-KIM ,-25973.910000000065,Other Income, 
04-Jun-23,855.48,100728232,,TRANSFER DEBIT,Clark-Barker,-25118.430000000066,Other Income, 
07-Jun-23,-708.99,100728232,,INTER-BANK CREDIT,174640136211324 NUNEZ GROUP ,-25827.420000000067,Bills, 
09-Jun-23,1089.44,100728232,,AUTOMATIC DRAWING,Lopez Ltd,-24737.98000000007,Uncategorised, 
12-Jun-23,-803.72,100728232,,INTER-BANK CREDIT,53771009184407 POWELL WASHINGTON AND LONG ,-25541.70000000007,Bills, 
15-Jun-23,1974.11,100728232,,TRANSFER DEBIT,177777099784813 AUSTIN-JOHNSON ,-23567.59000000007,Uncategorised, 
17-Jun-23,-1711.3,100728232,,INTER-BANK CREDIT,166274058634957 BURNS-GREEN ,-25278.89000000007,Uncategorised, 
19-Jun-23,-1624.9,100728232,,INTER-BANK CREDIT,Kirk Hartman and Anthony,-26903.79000000007,Bills, 
19-Jun-23,-129.81,100728232,,INTER-BANK CREDIT,Brown-Powell,-27033.60000000007,Other Income, 
22-Jun-23,731.87,100728232,,INTER-BANK CREDIT,Miranda-Lopez,-26301.730000000072,Financial, 
25-Jun-23,-1009.92,100728232,,INTER-BANK CREDIT,Harris Williams and Jensen,-27311.65000000007,Bills, 
25-Jun-23,445.91,100728232,,INTER-BANK CREDIT,787070970843762 THOMAS OLSEN AND MORALES ,-26865.74000000007,Financial, 
27-Jun-23,-1295.47,100728232,,INTER-BANK CREDIT,Carrillo Howard and Jones,-28161.210000000072,Bills, 
27-Jun-23,-719.96,100728232,,INTER-BANK CREDIT,479487332591951 MULLINS KELLY AND PORTER ,-28881.17000000007,Financial, 
30-Jun-23,1638.72,100728232,,AUTOMATIC DRAWING,212873787337351 MILLER DONOVAN AND PARKER ,-27242.45000000007,Uncategorised, 
03-Jul-23,1820.66,100728232,,AUTOMATIC DRAWING,Parker Banks and Rivera,-25421.79000000007,Other Income, 
03-Jul-23,-1593.84,100728232,,INTER-BANK CREDIT,Davis-Castillo,-27015.63000000007,Other Income, 
04-Jul-23,-1302.14,100728232,,INTER-BANK CREDIT,Moon Casey and Alvarez,-28317.77000000007,Financial, 
07-Jul-23,-1637.6,100728232,,TRANSFER DEBIT,381345197225064 RAMIREZ LLC ,-29955.370000000068,Uncategorised, 
10-Jul-23,-1801.53,100728232,,TRANSFER DEBIT,116858551631164 JONES-CHASE ,-31756.900000000067,Bills, 
11-Jul-23,-1431.16,100728232,,INTER-BANK CREDIT,Hicks-Phillips,-33188.06000000007,Uncategorised, 
13-Jul-23,-1493.47,100728232,,TRANSFER DEBIT,500917847361275 BECKER LLC ,-34681.53000000007,Financial, 
13-Jul-23,1043.35,100728232,,INTER-BANK CREDIT,170421590672236 MAYS THOMPSON AND SMITH ,-33638.18000000007,Bills, 
13-Jul-23,-769.18,100728232,,INTER-BANK CREDIT,876247083134262 WARNER INC ,-34407.36000000007,Financial, 
14-Jul-23,555.0,100728232,,AUTOMATIC DRAWING,Davidson Briggs and Marks,-33852.36000000007,Other Income, 
17-Jul-23,49.96,100728232,,TRANSFER DEBIT,93546094334751 CHAVEZ PEARSON AND HUMPHREY ,-33802.400000000074,Bills, 
17-Jul-23,1714.42,100728232,,TRANSFER DEBIT,Hardy Jackson and Santiago,-32087.980000000076,Bills, 
17-Jul-23,1511.89,100728232,,INTER-BANK CREDIT,Walker LLC,-30576.090000000077,Bills, 
18-Jul-23,-1382.33,100728232,,AUTOMATIC DRAWING,578115009178225 BLAIR SPARKS AND EVANS ,-31958.42000000008,Uncategorised, 
20-Jul-23,742.46,100728232,,INTER-BANK CREDIT,454818067890987 PRICE-JOHNSON ,-31215.96000000008,Bills, 
21-Jul-23,-756.21,100728232,,INTER-BANK CREDIT,196380918532045 GUZMAN-JACKSON ,-31972.17000000008,Other Income, 
21-Jul-23,1206.21,100728232,,INTER-BANK CREDIT,Brown Ltd,-30765.96000000008,Other Income, 
24-Jul-23,-1264.17,100728232,,INTER-BANK CREDIT,259676801543727 MCBRIDE-CHUNG ,-32030.130000000077,Bills, 
26-Jul-23,1198.41,100728232,,INTER-BANK CREDIT,Vega-Henry,-30831.720000000078,Financial, 
29-Jul-23,974.54,100728232,,AUTOMATIC DRAWING,62791985292569 FOSTER-HARRINGTON ,-29857.180000000077,Financial, 
31-Jul-23,-1628.04,100728232,,AUTOMATIC DRAWING,675190062664483 ROBERTSON MURPHY AND ROSS ,-31485.220000000078,Bills, 
03-Aug-23,-1834.15,100728232,,AUTOMATIC DRAWING,Warren Rivera and Trujillo,-33319.370000000075,Financial, 
03-Aug-23,-673.23,100728232,,TRANSFER DEBIT,Gomez-Jones,-33992.60000000008,Financial, 
06-Aug-23,-453.54,100728232,,INTER-BANK CREDIT,476743396609481 DAWSON-MILLER ,-34446.14000000008,Other Income, 
09-Aug-23,-1980.51,100728232,,TRANSFER DEBIT,647659258301722 PHELPS CLARK AND GONZALES ,-36426.65000000008,Bills, 
12-Aug-23,1327.12,100728232,,INTER-BANK CREDIT,477596839117136 FORD-ANDERSON ,-35099.53000000008,Uncategorised, 
13-Aug-23,92.04,100728232,,TRANSFER DEBIT,54433512623018 CARTER-CURRY ,-35007.49000000008,Financial, 
13-Aug-23,-925.87,100728232,,INTER-BANK CREDIT,109279700779154 PETERSON LLC ,-35933.36000000008,Financial, 
16-Aug-23,-1014.86,100728232,,INTER-BANK CREDIT,Mcdonald PLC,-36948.22000000008,Other Income, 
16-Aug-23,1959.4,100728232,,INTER-BANK CREDIT,530965780185711 LOPEZ INC ,-34988.82000000008,Financial, 
17-Aug-23,-1152.07,100728232,,TRANSFER DEBIT,Lewis Short and Hogan,-36140.89000000008,Other Income, 
18-Aug-23,-581.56,100728232,,AUTOMATIC DRAWING,113300597732307 ROBBINS DUDLEY AND WEISS ,-36722.45000000008,Other Income, 
20-Aug-23,-1074.59,100728232,,INTER-BANK CREDIT,Smith-Hebert,-37797.04000000007,Other Income, 
21-Aug-23,1109.95,100728232,,INTER-BANK CREDIT,908457620953737 JOHNSON HARRIS AND GIBBS ,-36687.09000000008,Other Income, 
21-Aug-23,854.65,100728232,,AUTOMATIC DRAWING,Jones-Gould,-35832.440000000075,Uncategorised, 
23-Aug-23,-709.48,100728232,,TRANSFER DEBIT,495615802104812 HAHN MILLER AND MONTOYA ,-36541.92000000008,Other Income, 
25-Aug-23,419.6,100728232,,AUTOMATIC DRAWING,513585793472567 PAGE PONCE AND LEONARD ,-36122.32000000008,Bills, 
28-Aug-23,172.28,100728232,,INTER-BANK CREDIT,Sheppard-Beasley,-35950.04000000008,Financial, 
31-Aug-23,302.87,100728232,,INTER-BANK CREDIT,560520371225571 ALLEN WOODS AND SMITH ,-35647.17000000008,Financial, 
03-Sep-23,1650.19,100728232,,INTER-BANK CREDIT,285460798327375 POPE MILLER AND SMITH ,-33996.980000000076,Bills, 
06-Sep-23,1602.25,100728232,,INTER-BANK CREDIT,Ramos-Knight,-32394.730000000076,Bills, 
09-Sep-23,576.34,100728232,,INTER-BANK CREDIT,294888137557745 GEORGE-POWELL ,-31818.390000000076,Other Income, 
12-Sep-23,1861.97,100728232,,INTER-BANK CREDIT,549105116027946 ORR-MARQUEZ ,-29956.420000000075,Bills, 
13-Sep-23,1753.31,100728232,,INTER-BANK CREDIT,Dunlap LLC,-28203.110000000073,Other Income, 
15-Sep-23,-1646.09,100728232,,INTER-BANK CREDIT,814709049908408 ROWLAND-MERRITT ,-29849.200000000073,Other Income, 
15-Sep-23,-950.76,100728232,,TRANSFER DEBIT,Anderson-Beck,-30799.960000000072,Uncategorised, 
17-Sep-23,468.88,100728232,,INTER-BANK CREDIT,918266269364642 PHILLIPS-JONES ,-30331.08000000007,Bills, 
18-Sep-23,134.12,100728232,,INTER-BANK CREDIT,315449434614772 BROWN NELSON AND THOMAS ,-30196.960000000072,Uncategorised, 
19-Sep-23,1828.08,100728232,,AUTOMATIC DRAWING,Smith-Stewart,-28368.88000000007,Uncategorised, 
20-Sep-23,1123.58,100728232,,INTER-BANK CREDIT,965220525819648 CHAPMAN MILLER AND NAVARRO ,-27245.30000000007,Financial, 
22-Sep-23,-882.63,100728232,,TRANSFER DEBIT,Cook Lee and Mcdonald,-28127.93000000007,Financial, 
22-Sep-23,-1060.45,100728232,,TRANSFER DEBIT,303975685150498 BOYD-TURNER ,-29188.38000000007,Uncategorised, 
25-Sep-23,1221.82,100728232,,INTER-BANK CREDIT,769791168850484 WILLIAMS-SHAW ,-27966.56000000007,Other Income, 
27-Sep-23,1015.74,100728232,,INTER-BANK CREDIT,469676037684085 ELLISON DOUGLAS AND JOHNSON ,-26950.82000000007,Bills, 
29-Sep-23,-934.35,100728232,,INTER-BANK CREDIT,Peterson PLC,-27885.170000000067,Bills, 
02-Oct-23,-686.28,100728232,,INTER-BANK CREDIT,683487212613109 COOK AND SONS ,-28571.450000000066,Bills, 
05-Oct-23,1381.59,100728232,,AUTOMATIC DRAWING,Wilson Group,-27189.860000000066,Uncategorised, 
07-Oct-23,-1271.86,100728232,,TRANSFER DEBIT,Johns PLC,-28461.720000000067,Other Income, 
07-Oct-23,-1769.74,100728232,,AUTOMATIC DRAWING,689506594777354 BRADLEY ALEXANDER AND WHITE ,-30231.46000000007,Financial, 
09-Oct-23,-532.85,100728232,,TRANSFER DEBIT,608784912664625 WHITAKER JENKINS AND WARNER ,-30764.310000000067,Other Income, 
11-Oct-23,1287.98,100728232,,INTER-BANK CREDIT,813412262388682 PETERSON-SMITH ,-29476.330000000067,Bills, 
12-Oct-23,1540.95,100728232,,INTER-BANK CREDIT,Diaz-Holt,-27935.380000000067,Other Income, 
15-Oct-23,-863.66,100728232,,INTER-BANK CREDIT,866953751503399 WILLIAMS AND SONS ,-28799.040000000066,Other Income, 
17-Oct-23,450.73,100728232,,INTER-BANK CREDIT,108003266928477 LANE AND SONS ,-28348.310000000067,Bills, 
20-Oct-23,1716.02,100728232,,TRANSFER DEBIT,661883062758537 HARRISON COOK AND CALLAHAN ,-26632.290000000066,Financial, 
23-Oct-23,119.05,100728232,,INTER-BANK CREDIT,Ward Taylor and Edwards,-26513.240000000067,Uncategorised, 
26-Oct-23,-1662.92,100728232,,INTER-BANK CREDIT,Smith-Henderson,-28176.16000000007,Other Income, 
28-Oct-23,-1302.04,100728232,,INTER-BANK CREDIT,Smith and Sons,-29478.20000000007,Bills, 
31-Oct-23,-1442.68,100728232,,INTER-BANK CREDIT,180976663361091 VINCENT-PIERCE ,-30920.88000000007,Financial, 
02-Nov-23,1711.22,100728232,,INTER-BANK CREDIT,161829293912236 CLARK AND SONS ,-29209.66000000007,Bills, 
03-Nov-23,-1854.8,100728232,,TRANSFER DEBIT,557386147560082 SCHROEDER LLC ,-31064.46000000007,Other Income, 
04-Nov-23,-580.27,100728232,,INTER-BANK CREDIT,Holt-Hutchinson,-31644.73000000007,Bills, 
07-Nov-23,414.84,100728232,,INTER-BANK CREDIT,196049174758915 RICH LTD ,-31229.89000000007,Other Income, 
08-Nov-23,476.2,100728232,,INTER-BANK CREDIT,490888995074793 GAMBLE CASTILLO AND SMITH ,-30753.690000000068,Uncategorised, 
10-Nov-23,-293.28,100728232,,TRANSFER DEBIT,641738296187602 HALL-UNDERWOOD ,-31046.970000000067,Financial, 
11-Nov-23,-1936.29,100728232,,INTER-BANK CREDIT,Moore Trujillo and Fisher,-32983.26000000007,Bills, 
13-Nov-23,-460.45,100728232,,AUTOMATIC DRAWING,331672840151088 MIRANDA-THOMAS ,-33443.710000000065,Financial, 
13-Nov-23,1580.09,100728232,,INTER-BANK CREDIT,882362820909195 NEAL LTD ,-31863.620000000064,Uncategorised, 
15-Nov-23,1147.83,100728232,,INTER-BANK CREDIT,Calderon Castillo and Randall,-30715.790000000066,Bills, 
16-Nov-23,-1610.64,100728232,,INTER-BANK CREDIT,Henry Graham and Castaneda,-32326.430000000066,Other Income, 
18-Nov-23,1678.41,100728232,,INTER-BANK CREDIT,102608537292242 GONZALES PLC ,-30648.020000000066,Financial, 
21-Nov-23,-246.06,100728232,,INTER-BANK CREDIT,412746559914355 CHAPMAN-BOOTH ,-30894.080000000067,Financial, 
23-Nov-23,1026.3,100728232,,TRANSFER DEBIT,Washington-Walker,-29867.780000000068,Other Income, 
25-Nov-23,1379.27,100728232,,INTER-BANK CREDIT,Scott-Kim,-28488.510000000068,Other Income, 
28-Nov-23,-136.27,100728232,,INTER-BANK CREDIT,Wilkerson-Miller,-28624.780000000068,Financial, 
28-Nov-23,1060.51,100728232,,INTER-BANK CREDIT,326986203774039 VARGAS SHORT AND RICE ,-27564.27000000007,Financial, 
01-Dec-23,-167.18,100728232,,INTER-BANK CREDIT,Santana-Williams,-27731.45000000007,Uncategorised, 
02-Dec-23,-1081.86,100728232,,TRANSFER DEBIT,536160148863003 ZAMORA PETERSEN AND SINGLETON ,-28813.31000000007,Uncategorised, 
03-Dec-23,1507.5,100728232,,INTER-BANK CREDIT,887217326951971 HERNANDEZ PLC ,-27305.81000000007,Other Income, 
05-Dec-23,1040.92,100728232,,AUTOMATIC DRAWING,Jensen Beck and Irwin,-26264.890000000072,Uncategorised, 
06-Dec-23,1623.22,100728232,,INTER-BANK CREDIT,916483971901878 CHAVEZ PLC ,-24641.67000000007,Financial, 
09-Dec-23,1230.43,100728232,,TRANSFER DEBIT,803169428271359 FOX-MEJIA ,-23411.24000000007,Financial, 
09-Dec-23,1419.57,100728232,,TRANSFER DEBIT,Morrison-Jackson,-21991.67000000007,Uncategorised, 
10-Dec-23,-1037.67,100728232,,AUTOMATIC DRAWING,Vazquez and Sons,-23029.34000000007,Other Income, 
13-Dec-23,-475.98,100728232,,INTER-BANK CREDIT,694380393184728 SPENCER-JONES ,-23505.32000000007,Other Income, 
15-Dec-23,-580.35,100728232,,TRANSFER DEBIT,Nelson and Sons,-24085.670000000067,Other Income, 
15-Dec-23,-683.73,100728232,,INTER-BANK CREDIT,Green Bailey and Bryan,-24769.400000000067,Bills, 
18-Dec-23,889.52,100728232,,TRANSFER DEBIT,546769827348254 SWANSON INC ,-23879.880000000067,Uncategorised, 
19-Dec-23,1051.15,100728232,,INTER-BANK CREDIT,639207204215758 HERMAN REID AND PHAM ,-22828.730000000065,Uncategorised, 
20-Dec-23,-1747.25,100728232,,TRANSFER DEBIT,Padilla PLC,-24575.980000000065,Uncategorised, 
22-Dec-23,-1804.9,100728232,,INTER-BANK CREDIT,801131218504988 COOPER-HERNANDEZ ,-26380.880000000067,Financial, 
25-Dec-23,-1885.74,100728232,,TRANSFER DEBIT,Weaver Brown and Brown,-28266.620000000068,Other Income, 
27-Dec-23,-332.33,100728232,,INTER-BANK CREDIT,799312938185888 HERNANDEZ-GRAHAM ,-28598.95000000007,Bills, 
27-Dec-23,-992.15,100728232,,INTER-BANK CREDIT,852939094952491 PAYNE LTD ,-29591.10000000007,Bills, 
29-Dec-23,1397.83,100728232,,INTER-BANK CREDIT,Evans Group,-28193.27000000007,Bills, 
30-Dec-23,1285.37,100728232,,TRANSFER DEBIT,Jackson Hansen and Miller,-26907.90000000007,Bills, 
31-Dec-23,66.57,100728232,,AUTOMATIC DRAWING,169895886393838 HARRISON AND SONS ,-26841.33000000007,Bills, 
03-Jan-24,74.15,100728232,,INTER-BANK CREDIT,543885436796591 STEVENS AND SONS ,-26767.18000000007,Financial, 
03-Jan-24,-937.48,100728232,,INTER-BANK CREDIT,Roberts-Reyes,-27704.66000000007,Uncategorised, 
06-Jan-24,867.2,100728232,,INTER-BANK CREDIT,Knight-Williams,-26837.46000000007,Bills, 
08-Jan-24,-1002.6,100728232,,INTER-BANK CREDIT,881761157244440 NEWMAN WILLIAMS AND HARRIS ,-27840.060000000067,Other Income, 
11-Jan-24,1417.65,100728232,,TRANSFER DEBIT,448579413254218 STEWART DOYLE AND WILLIAMS ,-26422.410000000065,Bills, 
14-Jan-24,-1128.32,100728232,,AUTOMATIC DRAWING,Payne Johnson and Allen,-27550.730000000065,Financial, 
15-Jan-24,1554.35,100728232,,AUTOMATIC DRAWING,881862250071677 BELL CALLAHAN AND SELLERS ,-25996.380000000067,Bills, 
18-Jan-24,977.13,100728232,,INTER-BANK CREDIT,Moran and Sons,-25019.250000000065,Financial, 
19-Jan-24,-1926.34,100728232,,TRANSFER DEBIT,449970297490126 YATES MOORE AND BURTON ,-26945.590000000066,Other Income, 
21-Jan-24,-142.78,100728232,,TRANSFER DEBIT,832390834756782 GREEN OWENS AND SMITH ,-27088.370000000064,Other Income, 
23-Jan-24,-1176.56,100728232,,INTER-BANK CREDIT,Horn Group,-28264.930000000066,Bills, 
26-Jan-24,305.31,100728232,,TRANSFER DEBIT,747930858956879 HALL LLC ,-27959.620000000064,Other Income, 
26-Jan-24,431.21,100728232,,INTER-BANK CREDIT,Henderson Willis and King,-27528.410000000065,Other Income, 
26-Jan-24,127.41,100728232,,AUTOMATIC DRAWING,309089960851155 MOORE INC ,-27401.000000000065,Other Income, 
26-Jan-24,1867.44,100728232,,AUTOMATIC DRAWING,Herman Rowe and Moore,-25533.560000000067,Financial, 
28-Jan-24,1472.42,100728232,,TRANSFER DEBIT,806944446044891 MARTINEZ GROUP ,-24061.140000000065,Uncategorised, 
28-Jan-24,340.46,100728232,,INTER-BANK CREDIT,47163697327793 JACKSON MCCARTY AND CASTANEDA ,-23720.680000000066,Uncategorised, 
31-Jan-24,1048.51,100728232,,INTER-BANK CREDIT,Kelley-Hernandez,-22672.170000000067,Other Income, 
01-Feb-24,-1641.41,100728232,,AUTOMATIC DRAWING,Gonzalez-Case,-24313.580000000067,Financial, 
03-Feb-24,1781.47,100728232,,INTER-BANK CREDIT,Mills Brown and Marshall,-22532.110000000066,Other Income, 
03-Feb-24,1177.05,100728232,,AUTOMATIC DRAWING,315841489089109 JOHNSON-HOWE ,-21355.060000000067,Financial, 
04-Feb-24,552.15,100728232,,INTER-BANK CREDIT,458048115601002 RUSSO GROUP ,-20802.910000000065,Bills, 
06-Feb-24,-943.82,100728232,,INTER-BANK CREDIT,74833220928726 HENSON-DODSON ,-21746.730000000065,Financial, 
08-Feb-24,-1311.34,100728232,,INTER-BANK CREDIT,Mason-Santiago,-23058.070000000065,Bills, 
09-Feb-24,358.92,100728232,,INTER-BANK CREDIT,33776943808372 VELAZQUEZ-STEPHENS ,-22699.150000000067,Other Income, 
09-Feb-24,251.84,100728232,,INTER-BANK CREDIT,Martinez Dominguez and Landry,-22447.310000000067,Uncategorised, 
10-Feb-24,818.86,100728232,,INTER-BANK CREDIT,668383790257710 LOPEZ LTD ,-21628.450000000066,Bills, 
11-Feb-24,-1500.95,100728232,,TRANSFER DEBIT,Luna Brewer and Bell,-23129.400000000067,Uncategorised, 
13-Feb-24,530.21,100728232,,AUTOMATIC DRAWING,Bailey Inc,-22599.190000000068,Uncategorised, 
15-Feb-24,-144.9,100728232,,INTER-BANK CREDIT,20790871682195 STANLEY INC ,-22744.09000000007,Bills, 
16-Feb-24,513.81,100728232,,INTER-BANK CREDIT,524493406266345 BROWN JOSEPH AND HUNT ,-22230.280000000068,Other Income, 
17-Feb-24,1069.38,100728232,,INTER-BANK CREDIT,382534895931421 HENDERSON CLARKE AND RYAN ,-21160.900000000067,Uncategorised, 
17-Feb-24,-1829.31,100728232,,INTER-BANK CREDIT,Wade PLC,-22990.21000000007,Financial, 
17-Feb-24,180.55,100728232,,AUTOMATIC DRAWING,Mahoney Smith and Hopkins,-22809.66000000007,Other Income, 
18-Feb-24,50.58,100728232,,TRANSFER DEBIT,129020218139399 HILL INC ,-22759.080000000067,Bills, 
21-Feb-24,-1995.52,100728232,,INTER-BANK CREDIT,65974858351927 DIAZ-RODRIGUEZ ,-24754.600000000068,Uncategorised, 
21-Feb-24,-1374.88,100728232,,INTER-BANK CREDIT,924767224261054 CORDOVA ATKINSON AND STEVENS ,-26129.48000000007,Bills, 
22-Feb-24,-134.44,100728232,,TRANSFER DEBIT,594081284520238 JOHNSON JENSEN AND GOMEZ ,-26263.920000000067,Uncategorised, 
24-Feb-24,166.23,100728232,,TRANSFER DEBIT,Lee Russell and Gill,-26097.690000000068,Uncategorised, 
25-Feb-24,1803.07,100728232,,AUTOMATIC DRAWING,75447147840020 HOWARD INC ,-24294.620000000068,Uncategorised, 
28-Feb-24,1786.32,100728232,,INTER-BANK CREDIT,Gonzalez-Mitchell,-22508.30000000007,Other Income, 
01-Mar-24,1556.67,100728232,,INTER-BANK CREDIT,Wilson-Pierce,-20951.63000000007,Bills, 
01-Mar-24,513.13,100728232,,TRANSFER DEBIT,Hoover Ingram and Ortiz,-20438.50000000007,Uncategorised, 
02-Mar-24,1875.86,100728232,,AUTOMATIC DRAWING,Stewart-Perry,-18562.64000000007,Bills, 
04-Mar-24,-1624.94,100728232,,INTER-BANK CREDIT,Jenkins-Turner,-20187.580000000067,Other Income, 
05-Mar-24,-165.65,100728232,,INTER-BANK CREDIT,805573523083289 ALLEN AND SONS ,-20353.23000000007,Bills, 
08-Mar-24,-1086.98,100728232,,TRANSFER DEBIT,Smith LLC,-21440.21000000007,Other Income, 
09-Mar-24,1744.04,100728232,,AUTOMATIC DRAWING,White-Case,-19696.170000000067,Other Income, 
12-Mar-24,-845.62,100728232,,INTER-BANK CREDIT,803662969314561 ALLEN-KHAN ,-20541.790000000066,Uncategorised, 
13-Mar-24,-175.64,100728232,,TRANSFER DEBIT,191330296244371 JONES RAY AND ROBERTS ,-20717.430000000066,Financial, 
15-Mar-24,1396.52,100728232,,TRANSFER DEBIT,Duncan-Mendoza,-19320.910000000065,Financial, 
18-Mar-24,-145.37,100728232,,INTER-BANK CREDIT,841624649165135 ORTIZ GROUP ,-19466.280000000064,Uncategorised, 
20-Mar-24,662.42,100728232,,AUTOMATIC DRAWING,Smith Pruitt and Jackson,-18803.860000000066,Bills, 
22-Mar-24,-1648.27,100728232,,TRANSFER DEBIT,Lee Ltd,-20452.130000000067,Financial, 
23-Mar-24,-231.02,100728232,,AUTOMATIC DRAWING,Porter Inc,-20683.150000000067,Uncategorised, 
25-Mar-24,-1577.41,100728232,,AUTOMATIC DRAWING,Pruitt and Sons,-22260.560000000067,Uncategorised, 
26-Mar-24,-827.52,100728232,,TRANSFER DEBIT,975155960798585 GONZALES ANDERSON AND ALLEN ,-23088.080000000067,Uncategorised, 
29-Mar-24,165.63,100728232,,TRANSFER DEBIT,385951686649245 ADAMS GROUP ,-22922.450000000066,Uncategorised, 
31-Mar-24,825.2,100728232,,INTER-BANK CREDIT,Gates Thompson and Anderson,-22097.250000000065,Bills, 
02-Apr-24,-554.24,100728232,,INTER-BANK CREDIT,Bradley LLC,-22651.490000000067,Financial, 
03-Apr-24,-534.92,100728232,,TRANSFER DEBIT,795037398826182 BECK-HAWKINS ,-23186.410000000065,Financial, 
05-Apr-24,1577.58,100728232,,TRANSFER DEBIT,392427938135598 WAGNER PLC ,-21608.830000000067,Other Income, 
07-Apr-24,1803.53,100728232,,INTER-BANK CREDIT,895802547501604 LUCAS PLC ,-19805.30000000007,Financial, 
10-Apr-24,1618.95,100728232,,INTER-BANK CREDIT,693992423002068 CARTER PADILLA AND MCCARTHY ,-18186.350000000068,Uncategorised, 
13-Apr-24,-1441.17,100728232,,AUTOMATIC DRAWING,994080279058434 RIVERA GROUP ,-19627.52000000007,Uncategorised, 
15-Apr-24,-1006.08,100728232,,INTER-BANK CREDIT,284194003469499 PATTERSON LLC ,-20633.60000000007,Financial, 
18-Apr-24,-1288.55,100728232,,INTER-BANK CREDIT,82629993876941 HUGHES PLC ,-21922.15000000007,Other Income, 
18-Apr-24,1231.38,100728232,,INTER-BANK CREDIT,970796314099770 PEREZ-EVANS ,-20690.77000000007,Uncategorised, 
18-Apr-24,-178.56,100728232,,INTER-BANK CREDIT,Perez-Wood,-20869.33000000007,Bills, 
21-Apr-24,-305.0,100728232,,INTER-BANK CREDIT,43246333238771 FISHER CONTRERAS AND EDWARDS ,-21174.33000000007,Bills, 
22-Apr-24,-1983.3,100728232,,INTER-BANK CREDIT,972902411470043 WHITNEY OLSON AND ALLEN ,-23157.63000000007,Bills, 
22-Apr-24,238.83,100728232,,AUTOMATIC DRAWING,992512098206231 DIAZ-WRIGHT ,-22918.80000000007,Financial, 
22-Apr-24,1320.8,100728232,,INTER-BANK CREDIT,Jackson-Johns,-21598.00000000007,Financial, 
25-Apr-24,-1596.31,100728232,,INTER-BANK CREDIT,499162675294362 WAGNER-BARNES ,-23194.31000000007,Bills, 
26-Apr-24,-322.16,100728232,,TRANSFER DEBIT,848442331510847 GONZALEZ-WILLIAMS ,-23516.47000000007,Bills, 
26-Apr-24,-393.43,100728232,,TRANSFER DEBIT,Mcneil-Rogers,-23909.90000000007,Financial, 
26-Apr-24,141.32,100728232,,INTER-BANK CREDIT,242858142931077 NOVAK LLC ,-23768.58000000007,Other Income, 
27-Apr-24,-381.95,100728232,,AUTOMATIC DRAWING,Davis Ltd,-24150.53000000007,Financial, 
27-Apr-24,-1180.5,100728232,,TRANSFER DEBIT,Charles Inc,-25331.03000000007,Uncategorised, 
29-Apr-24,1251.81,100728232,,AUTOMATIC DRAWING,299436069671634 SMITH COLLINS AND MUNOZ ,-24079.22000000007,Uncategorised, 
02-May-24,514.22,100728232,,TRANSFER DEBIT,255027675486873 CONLEY LEE AND ESCOBAR ,-23565.00000000007,Uncategorised, 
04-May-24,1112.53,100728232,,INTER-BANK CREDIT,605115453986928 CAMPBELL-LEWIS ,-22452.47000000007,Uncategorised, 
05-May-24,-1895.61,100728232,,TRANSFER DEBIT,830581636427134 HILL OCHOA AND SCHNEIDER ,-24348.08000000007,Uncategorised, 
07-May-24,1438.88,100728232,,INTER-BANK CREDIT,Rich Inc,-22909.20000000007,Financial, 
07-May-24,380.87,100728232,,TRANSFER DEBIT,Mclaughlin Ltd,-22528.33000000007,Other Income, 
10-May-24,-1626.29,100728232,,AUTOMATIC DRAWING,King-Crawford,-24154.62000000007,Other Income, 
12-May-24,-1777.75,100728232,,INTER-BANK CREDIT,Ryan Ltd,-25932.37000000007,Uncategorised, 
12-May-24,1496.78,100728232,,AUTOMATIC DRAWING,983564571206840 HOWELL-HOLT ,-24435.590000000073,Uncategorised, 
12-May-24,1054.07,100728232,,TRANSFER DEBIT,Farley Ltd,-23381.520000000073,Other Income, 
15-May-24,-729.47,100728232,,TRANSFER DEBIT,Wright Inc,-24110.990000000074,Bills, 
17-May-24,-3.43,100728232,,AUTOMATIC DRAWING,Dodson-Clark,-24114.420000000075,Financial, 
18-May-24,-440.62,100728232,,INTER-BANK CREDIT,Edwards Flores and Simon,-24555.040000000074,Other Income, 
19-May-24,-1155.74,100728232,,INTER-BANK CREDIT,994883891099156 SIMMONS LOWERY AND MADDEN ,-25710.780000000075,Bills, 
19-May-24,926.18,100728232,,INTER-BANK CREDIT,448466056825916 BAILEY LLC ,-24784.600000000075,Bills, 
19-May-24,489.27,100728232,,TRANSFER DEBIT,Smith Williams and Lopez,-24295.330000000075,Bills, 
22-May-24,-1330.31,100728232,,TRANSFER DEBIT,548286130384018 TAYLOR INC ,-25625.640000000076,Other Income, 
22-May-24,-1076.38,100728232,,TRANSFER DEBIT,Bradley-Lewis,-26702.020000000077,Uncategorised, 
24-May-24,1484.99,100728232,,AUTOMATIC DRAWING,311500550405165 CALDERON-LEWIS ,-25217.030000000075,Other Income, 
24-May-24,1311.44,100728232,,INTER-BANK CREDIT,546541314486498 WILSON-HARRISON ,-23905.590000000077,Other Income, 
26-May-24,1665.48,100728232,,AUTOMATIC DRAWING,897306381622096 DUNCAN LLC ,-22240.110000000077,Bills, 
26-May-24,567.2,100728232,,TRANSFER DEBIT,Randall Brown and Smith,-21672.910000000076,Uncategorised, 
27-May-24,-1997.04,100728232,,INTER-BANK CREDIT,Smith LLC,-23669.950000000077,Uncategorised, 
28-May-24,-1743.92,100728232,,INTER-BANK CREDIT,840015143302017 JOHNSON-MANN ,-25413.870000000075,Uncategorised, 
29-May-24,742.6,100728232,,AUTOMATIC DRAWING,635211317384336 TAPIA PARKER AND SCHNEIDER ,-24671.270000000077,Financial, 
01-Jun-24,-1112.21,100728232,,INTER-BANK CREDIT,279889803865128 TOWNSEND KLINE AND GROSS ,-25783.480000000076,Other Income, 
02-Jun-24,-1123.12,100728232,,INTER-BANK CREDIT,414007390423025 ROBERTS AND SONS ,-26906.600000000075,Other Income, 
04-Jun-24,-1177.18,100728232,,INTER-BANK CREDIT,Leon Inc,-28083.780000000075,Bills, 
06-Jun-24,1609.73,100728232,,INTER-BANK CREDIT,191346746862812 EVANS POOLE AND PRICE ,-26474.050000000076,Other Income, 
06-Jun-24,982.43,100728232,,INTER-BANK CREDIT,Bradford Ltd,-25491.620000000075,Other Income, 
09-Jun-24,-898.5,100728232,,TRANSFER DEBIT,Singleton Garcia and Austin,-26390.120000000075,Financial, 
10-Jun-24,1954.1,100728232,,INTER-BANK CREDIT,350718239646138 HILL INC ,-24436.020000000077,Uncategorised, 
12-Jun-24,1978.47,100728232,,AUTOMATIC DRAWING,Waller Group,-22457.550000000076,Other Income, 
12-Jun-24,266.05,100728232,,INTER-BANK CREDIT,Weaver Ltd,-22191.500000000076,Bills, 
13-Jun-24,81.49,100728232,,INTER-BANK CREDIT,22113948002265 LUCERO INC ,-22110.010000000075,Uncategorised, 
16-Jun-24,1631.47,100728232,,AUTOMATIC DRAWING,306127185469652 BLACKBURN-VILLANUEVA ,-20478.540000000074,Other Income, 
18-Jun-24,1106.88,100728232,,TRANSFER DEBIT,Kemp Ltd,-19371.660000000073,Uncategorised, 
21-Jun-24,196.09,100728232,,INTER-BANK CREDIT,Erickson LLC,-19175.570000000072,Bills, 
23-Jun-24,882.87,100728232,,INTER-BANK CREDIT,Jones Ltd,-18292.700000000073,Financial, 
24-Jun-24,669.42,100728232,,AUTOMATIC DRAWING,Williamson-Blevins,-17623.280000000075,Bills, 
25-Jun-24,-508.69,100728232,,INTER-BANK CREDIT,944649076310023 CAMPOS MOODY AND LYNN ,-18131.970000000074,Other Income, 
26-Jun-24,1337.04,100728232,,TRANSFER DEBIT,815539089752672 FREEMAN GROUP ,-16794.930000000073,Financial, 
28-Jun-24,426.33,100728232,,INTER-BANK CREDIT,Paul-Johnson,-16368.600000000073,Other Income, 
29-Jun-24,-1745.43,100728232,,INTER-BANK CREDIT,Hopkins Inc,-18114.03000000007,Bills, 
02-Jul-24,1551.55,100728232,,TRANSFER DEBIT,Brown-Horn,-16562.480000000072,Other Income, 
03-Jul-24,-986.82,100728232,,INTER-BANK CREDIT,Foster Inc,-17549.300000000072,Bills, 
03-Jul-24,-1492.3,100728232,,INTER-BANK CREDIT,433426377777473 STEVENS SMITH AND THOMAS ,-19041.60000000007,Other Income, 
