Date,Amount,Account Number,,Transaction Type,Transaction Details,Balance,Category,Merchant Name
13-Jun-17,-780.21,655927322,,AUTOMATIC DRAWING,78496913675996 NICHOLS-MARTINEZ ,-4765.65,Other Income, 
14-Jun-17,-1230.91,655927322,,AUTOMATIC DRAWING,173213031209492 FORD GALLOWAY AND LOZANO ,-5996.5599999999995,Bills, 
14-Jun-17,1535.72,655927322,,AUTOMATIC DRAWING,Hernandez Ward and Frye,-4460.839999999999,Bills, 
14-Jun-17,-889.17,655927322,,TRANSFER DEBIT,78369417959078 JONES HARPER AND DELGADO ,-5350.009999999999,Financial, 
17-Jun-17,-1446.01,655927322,,AUTOMATIC DRAWING,617143132890934 SANDOVAL AND SONS ,-6796.0199999999995,Financial, 
18-Jun-17,-844.02,655927322,,AUTOMATIC DRAWING,White Davis and Williams,-7640.039999999999,Financial, 
19-Jun-17,-1347.21,655927322,,TRANSFER DEBIT,Thomas-Arnold,-8987.25,Uncategorised, 
20-Jun-17,663.25,655927322,,AUTOMATIC DRAWING,7221938214492 BROWN RITTER AND VALENZUELA ,-8324.0,Other Income, 
23-Jun-17,-1250.0,655927322,,INTER-BANK CREDIT,320316742501249 CISNEROS YODER AND KEMP ,-9574.0,Bills, 
26-Jun-17,1773.46,655927322,,TRANSFER DEBIT,Best-Farmer,-7800.54,Bills, 
28-Jun-17,-1700.8,655927322,,INTER-BANK CREDIT,478053759330963 OLIVER EVANS AND BAKER ,-9501.34,Bills, 
30-Jun-17,-124.68,655927322,,INTER-BANK CREDIT,Velazquez-Greene,-9626.02,Other Income, 
30-Jun-17,6.48,655927322,,AUTOMATIC DRAWING,235035003652497 BAILEY DAVIDSON AND THOMAS ,-9619.54,Other Income, 
02-Jul-17,-1348.46,655927322,,TRANSFER DEBIT,Brooks-Vasquez,-10968.0,Uncategorised, 
03-Jul-17,-441.83,655927322,,INTER-BANK CREDIT,466778608442437 COLEMAN AND SONS ,-11409.83,Other Income, 
03-Jul-17,428.97,655927322,,INTER-BANK CREDIT,Hamilton-Howard,-10980.86,Bills, 
03-Jul-17,834.78,655927322,,INTER-BANK CREDIT,Douglas and Sons,-10146.08,Uncategorised, 
04-Jul-17,188.43,655927322,,INTER-BANK CREDIT,Butler Maddox and Lewis,-9957.65,Financial, 
04-Jul-17,-909.36,655927322,,TRANSFER DEBIT,Merritt-Wiley,-10867.01,Bills, 
04-Jul-17,786.5,655927322,,AUTOMATIC DRAWING,525999589613287 VELEZ-CAMPOS ,-10080.51,Bills, 
06-Jul-17,-1542.56,655927322,,AUTOMATIC DRAWING,754717228140056 GONZALES-SCHULTZ ,-11623.07,Other Income, 
06-Jul-17,915.2,655927322,,INTER-BANK CREDIT,Henderson Harris and Rodriguez,-10707.869999999999,Bills, 
06-Jul-17,1455.63,655927322,,TRANSFER DEBIT,197423727015299 DAUGHERTY CRAIG AND TAYLOR ,-9252.239999999998,Uncategorised, 
06-Jul-17,111.18,655927322,,TRANSFER DEBIT,335511172189705 FLYNN LLC ,-9141.059999999998,Uncategorised, 
08-Jul-17,923.87,655927322,,INTER-BANK CREDIT,188834242984308 STEWART-ROBINSON ,-8217.189999999997,Bills, 
11-Jul-17,-1225.8,655927322,,INTER-BANK CREDIT,Welch-Smith,-9442.989999999996,Financial, 
12-Jul-17,1170.38,655927322,,TRANSFER DEBIT,Solis Martin and Hicks,-8272.609999999997,Financial, 
15-Jul-17,-122.02,655927322,,INTER-BANK CREDIT,572818656779457 REED BROWN AND ALVARADO ,-8394.629999999997,Bills, 
17-Jul-17,-42.8,655927322,,INTER-BANK CREDIT,Marquez PLC,-8437.429999999997,Financial, 
19-Jul-17,184.99,655927322,,TRANSFER DEBIT,Rogers Inc,-8252.439999999997,Financial, 
22-Jul-17,152.87,655927322,,TRANSFER DEBIT,Carrillo PLC,-8099.569999999997,Other Income, 
22-Jul-17,636.89,655927322,,INTER-BANK CREDIT,Mcgrath LLC,-7462.679999999997,Bills, 
23-Jul-17,1931.64,655927322,,AUTOMATIC DRAWING,Thomas-Rodriguez,-5531.039999999996,Uncategorised, 
26-Jul-17,456.57,655927322,,TRANSFER DEBIT,19468578400180 WHITE-LANE ,-5074.469999999997,Uncategorised, 
29-Jul-17,464.25,655927322,,INTER-BANK CREDIT,Harris Peterson and Davis,-4610.219999999997,Bills, 
31-Jul-17,-764.71,655927322,,TRANSFER DEBIT,Brooks Jennings and Mendoza,-5374.929999999997,Bills, 
02-Aug-17,912.52,655927322,,AUTOMATIC DRAWING,876200234083542 CLARK-SMITH ,-4462.409999999996,Uncategorised, 
03-Aug-17,1987.98,655927322,,AUTOMATIC DRAWING,French-Cruz,-2474.429999999996,Bills, 
04-Aug-17,-361.68,655927322,,INTER-BANK CREDIT,Neal Snyder and Powers,-2836.109999999996,Other Income, 
04-Aug-17,-1650.66,655927322,,INTER-BANK CREDIT,558714428296836 LANE GROUP ,-4486.769999999996,Other Income, 
07-Aug-17,-1884.37,655927322,,INTER-BANK CREDIT,350901322929437 FREEMAN-TURNER ,-6371.139999999996,Uncategorised, 
10-Aug-17,-1138.15,655927322,,AUTOMATIC DRAWING,596122892703942 ORTEGA SHELTON AND PORTER ,-7509.289999999995,Uncategorised, 
11-Aug-17,-1949.58,655927322,,INTER-BANK CREDIT,679355813932453 HULL LLC ,-9458.869999999995,Bills, 
14-Aug-17,-1408.16,655927322,,INTER-BANK CREDIT,115643678079712 MURILLO-CHRISTENSEN ,-10867.029999999995,Other Income, 
17-Aug-17,-83.39,655927322,,INTER-BANK CREDIT,549839469607412 KELLY LLC ,-10950.419999999995,Bills, 
17-Aug-17,694.1,655927322,,TRANSFER DEBIT,Kim Ltd,-10256.319999999994,Other Income, 
18-Aug-17,-1915.78,655927322,,TRANSFER DEBIT,881974335837611 BANKS LLC ,-12172.099999999995,Other Income, 
19-Aug-17,139.18,655927322,,TRANSFER DEBIT,367792090883999 DAY LLC ,-12032.919999999995,Financial, 
21-Aug-17,-1624.65,655927322,,INTER-BANK CREDIT,630467368690916 BROCK AND SONS ,-13657.569999999994,Other Income, 
21-Aug-17,-784.74,655927322,,AUTOMATIC DRAWING,601433359839043 ATKINSON ADAMS AND RIVERA ,-14442.309999999994,Bills, 
23-Aug-17,-225.31,655927322,,INTER-BANK CREDIT,Mitchell Blake and Caldwell,-14667.619999999994,Bills, 
26-Aug-17,-1177.23,655927322,,TRANSFER DEBIT,Higgins-Velazquez,-15844.849999999993,Bills, 
27-Aug-17,214.32,655927322,,TRANSFER DEBIT,90306884769191 JACKSON INC ,-15630.529999999993,Bills, 
28-Aug-17,570.63,655927322,,AUTOMATIC DRAWING,Baker-Mercado,-15059.899999999994,Uncategorised, 
28-Aug-17,-582.4,655927322,,AUTOMATIC DRAWING,239289174129263 TAYLOR-ADAMS ,-15642.299999999994,Uncategorised, 
30-Aug-17,-266.43,655927322,,INTER-BANK CREDIT,Robinson Summers and Farley,-15908.729999999994,Bills, 
31-Aug-17,1277.89,655927322,,AUTOMATIC DRAWING,Scott Russell and Carpenter,-14630.839999999995,Other Income, 
02-Sep-17,103.64,655927322,,AUTOMATIC DRAWING,29944668483360 HALL-WARD ,-14527.199999999995,Uncategorised, 
02-Sep-17,796.09,655927322,,AUTOMATIC DRAWING,983639664200370 WALLS LLC ,-13731.109999999995,Bills, 
03-Sep-17,-111.73,655927322,,INTER-BANK CREDIT,Compton Jones and Kaiser,-13842.839999999995,Financial, 
05-Sep-17,-288.86,655927322,,INTER-BANK CREDIT,701699239439927 CHASE-KAISER ,-14131.699999999995,Bills, 
07-Sep-17,1345.51,655927322,,INTER-BANK CREDIT,Rogers Group,-12786.189999999995,Financial, 
08-Sep-17,-259.12,655927322,,TRANSFER DEBIT,Rojas Ltd,-13045.309999999996,Other Income, 
08-Sep-17,1801.72,655927322,,TRANSFER DEBIT,Smith Ltd,-11243.589999999997,Uncategorised, 
11-Sep-17,828.31,655927322,,INTER-BANK CREDIT,Stone-Love,-10415.279999999997,Other Income, 
14-Sep-17,-868.91,655927322,,TRANSFER DEBIT,Peck Deleon and Wilson,-11284.189999999997,Bills, 
16-Sep-17,-278.11,655927322,,TRANSFER DEBIT,531844673700896 CARNEY REYNOLDS AND SIMS ,-11562.299999999997,Financial, 
16-Sep-17,538.11,655927322,,AUTOMATIC DRAWING,464322534053923 HERNANDEZ LTD ,-11024.189999999997,Bills, 
17-Sep-17,-1637.04,655927322,,AUTOMATIC DRAWING,568120998645488 LOPEZ RAMOS AND CASTRO ,-12661.229999999996,Uncategorised, 
18-Sep-17,1840.86,655927322,,TRANSFER DEBIT,Merritt-Smith,-10820.369999999995,Uncategorised, 
19-Sep-17,404.33,655927322,,AUTOMATIC DRAWING,Johnson Kerr and Greer,-10416.039999999995,Other Income, 
22-Sep-17,1395.83,655927322,,INTER-BANK CREDIT,848951480393880 FRANCO GROUP ,-9020.209999999995,Other Income, 
25-Sep-17,34.08,655927322,,INTER-BANK CREDIT,666259644480080 AUSTIN-OLSON ,-8986.129999999996,Uncategorised, 
28-Sep-17,-1548.96,655927322,,INTER-BANK CREDIT,Whitehead Hernandez and Cummings,-10535.089999999997,Other Income, 
01-Oct-17,581.65,655927322,,AUTOMATIC DRAWING,Martinez-Kline,-9953.439999999997,Bills, 
01-Oct-17,189.24,655927322,,AUTOMATIC DRAWING,101209980710398 MURRAY-STOUT ,-9764.199999999997,Financial, 
04-Oct-17,1543.19,655927322,,INTER-BANK CREDIT,Summers Vaughn and Campbell,-8221.009999999997,Uncategorised, 
06-Oct-17,1963.77,655927322,,AUTOMATIC DRAWING,Mullen-Morrison,-6257.239999999996,Other Income, 
07-Oct-17,-1446.15,655927322,,AUTOMATIC DRAWING,Moore Inc,-7703.389999999996,Other Income, 
09-Oct-17,-1314.76,655927322,,INTER-BANK CREDIT,Johnson Golden and Martin,-9018.149999999996,Bills, 
12-Oct-17,-694.66,655927322,,INTER-BANK CREDIT,953742976421638 COOK-GOODWIN ,-9712.809999999996,Financial, 
13-Oct-17,-1027.53,655927322,,INTER-BANK CREDIT,Cox and Sons,-10740.339999999997,Uncategorised, 
15-Oct-17,-1256.86,655927322,,INTER-BANK CREDIT,Walsh Johnson and Bell,-11997.199999999997,Other Income, 
17-Oct-17,-1890.29,655927322,,INTER-BANK CREDIT,Mathis-Oconnor,-13887.489999999998,Other Income, 
17-Oct-17,-1443.24,655927322,,AUTOMATIC DRAWING,Rogers-Johnson,-15330.729999999998,Bills, 
17-Oct-17,970.21,655927322,,TRANSFER DEBIT,Sullivan Robertson and Edwards,-14360.519999999997,Financial, 
19-Oct-17,-1157.97,655927322,,INTER-BANK CREDIT,Adams Mills and Chambers,-15518.489999999996,Other Income, 
22-Oct-17,-54.14,655927322,,AUTOMATIC DRAWING,Leblanc-Brooks,-15572.629999999996,Financial, 
23-Oct-17,-1401.46,655927322,,INTER-BANK CREDIT,Patel PLC,-16974.089999999997,Other Income, 
26-Oct-17,1575.91,655927322,,INTER-BANK CREDIT,Gonzalez Lane and King,-15398.179999999997,Bills, 
26-Oct-17,-672.46,655927322,,INTER-BANK CREDIT,Rice Ltd,-16070.639999999996,Financial, 
29-Oct-17,-97.4,655927322,,INTER-BANK CREDIT,Hull Lynch and Santana,-16168.039999999995,Other Income, 
01-Nov-17,1999.14,655927322,,INTER-BANK CREDIT,228793734581021 ANDERSON-ROY ,-14168.899999999996,Financial, 
04-Nov-17,-1350.09,655927322,,AUTOMATIC DRAWING,Henderson-Clark,-15518.989999999996,Financial, 
04-Nov-17,644.33,655927322,,INTER-BANK CREDIT,Barrera Wilkinson and Simmons,-14874.659999999996,Uncategorised, 
04-Nov-17,-1739.57,655927322,,INTER-BANK CREDIT,Moore-Edwards,-16614.229999999996,Other Income, 
05-Nov-17,217.69,655927322,,INTER-BANK CREDIT,Mercer-Graves,-16396.539999999997,Bills, 
05-Nov-17,1072.96,655927322,,AUTOMATIC DRAWING,Lawson Campbell and Perez,-15323.579999999998,Uncategorised, 
05-Nov-17,-1612.99,655927322,,AUTOMATIC DRAWING,219368153256004 OBRIEN GROUP ,-16936.57,Bills, 
08-Nov-17,1428.33,655927322,,INTER-BANK CREDIT,Mckinney LLC,-15508.24,Bills, 
08-Nov-17,-736.9,655927322,,TRANSFER DEBIT,794027006230136 REYES AND SONS ,-16245.14,Uncategorised, 
09-Nov-17,-1043.83,655927322,,INTER-BANK CREDIT,870433245793004 MITCHELL MAYS AND BROWN ,-17288.97,Bills, 
12-Nov-17,-130.6,655927322,,AUTOMATIC DRAWING,Parsons-Walsh,-17419.57,Financial, 
14-Nov-17,1624.36,655927322,,AUTOMATIC DRAWING,Henry Davis and Taylor,-15795.21,Other Income, 
15-Nov-17,888.64,655927322,,INTER-BANK CREDIT,Cummings Castillo and Barnes,-14906.57,Bills, 
18-Nov-17,1200.64,655927322,,AUTOMATIC DRAWING,354833571173555 HANNA FREDERICK AND LONG ,-13705.93,Uncategorised, 
20-Nov-17,40.34,655927322,,INTER-BANK CREDIT,Lopez Davis and Smith,-13665.59,Bills, 
22-Nov-17,1830.77,655927322,,TRANSFER DEBIT,52179112074174 GEORGE MCKEE AND ADKINS ,-11834.82,Other Income, 
23-Nov-17,-51.71,655927322,,AUTOMATIC DRAWING,83993610912207 MCDOWELL-NGUYEN ,-11886.529999999999,Bills, 
23-Nov-17,94.74,655927322,,INTER-BANK CREDIT,716949350160463 HUGHES ROBERTS AND SPENCER ,-11791.789999999999,Bills, 
26-Nov-17,1707.62,655927322,,INTER-BANK CREDIT,Buchanan Martinez and Lynch,-10084.169999999998,Financial, 
27-Nov-17,-770.75,655927322,,AUTOMATIC DRAWING,Wise Lewis and Roberts,-10854.919999999998,Uncategorised, 
29-Nov-17,-1514.22,655927322,,INTER-BANK CREDIT,Harris Evans and Finley,-12369.139999999998,Financial, 
02-Dec-17,1034.04,655927322,,INTER-BANK CREDIT,Mueller Smith and Vasquez,-11335.099999999999,Financial, 
03-Dec-17,-671.24,655927322,,INTER-BANK CREDIT,121989637855923 CHANEY LTD ,-12006.339999999998,Bills, 
05-Dec-17,-278.23,655927322,,AUTOMATIC DRAWING,253527488385946 ANDERSON KENNEDY AND ROY ,-12284.569999999998,Bills, 
05-Dec-17,-1114.96,655927322,,AUTOMATIC DRAWING,Woods Group,-13399.529999999999,Bills, 
05-Dec-17,1966.49,655927322,,INTER-BANK CREDIT,812816296936426 SIMMONS-WILEY ,-11433.039999999999,Other Income, 
07-Dec-17,97.12,655927322,,INTER-BANK CREDIT,King-Matthews,-11335.919999999998,Other Income, 
10-Dec-17,356.98,655927322,,AUTOMATIC DRAWING,208094913874346 BURNS INC ,-10978.939999999999,Uncategorised, 
10-Dec-17,1956.95,655927322,,INTER-BANK CREDIT,Grant Gordon and Vazquez,-9021.989999999998,Uncategorised, 
13-Dec-17,571.53,655927322,,TRANSFER DEBIT,Garcia-Harvey,-8450.459999999997,Financial, 
13-Dec-17,-730.61,655927322,,AUTOMATIC DRAWING,Reynolds-Horton,-9181.069999999998,Bills, 
16-Dec-17,-481.76,655927322,,INTER-BANK CREDIT,707097164059859 HENDRICKS LTD ,-9662.829999999998,Other Income, 
18-Dec-17,-775.13,655927322,,INTER-BANK CREDIT,Stanley-Woodward,-10437.959999999997,Financial, 
18-Dec-17,1189.97,655927322,,AUTOMATIC DRAWING,Shelton-Fisher,-9247.989999999998,Uncategorised, 
19-Dec-17,775.0,655927322,,AUTOMATIC DRAWING,Obrien-Ferguson,-8472.989999999998,Other Income, 
19-Dec-17,1542.47,655927322,,AUTOMATIC DRAWING,Ford Deleon and Collins,-6930.519999999998,Other Income, 
19-Dec-17,1266.05,655927322,,INTER-BANK CREDIT,Wells Inc,-5664.4699999999975,Other Income, 
19-Dec-17,-1886.97,655927322,,INTER-BANK CREDIT,Henry Kim and Nelson,-7551.439999999998,Other Income, 
21-Dec-17,483.98,655927322,,INTER-BANK CREDIT,835511605768680 THOMPSON JACKSON AND THOMAS ,-7067.459999999997,Other Income, 
22-Dec-17,386.86,655927322,,TRANSFER DEBIT,Roberts-Potter,-6680.599999999998,Other Income, 
22-Dec-17,-551.16,655927322,,INTER-BANK CREDIT,761615254427815 ESTRADA-TANNER ,-7231.7599999999975,Bills, 
23-Dec-17,-1317.73,655927322,,TRANSFER DEBIT,Davis Mathis and Rodriguez,-8549.489999999998,Financial, 
23-Dec-17,1993.1,655927322,,INTER-BANK CREDIT,Robinson Gonzalez and Johnson,-6556.389999999998,Bills, 
24-Dec-17,-863.87,655927322,,INTER-BANK CREDIT,745938446252078 MILLER SCHMITT AND FIGUEROA ,-7420.2599999999975,Bills, 
27-Dec-17,-543.86,655927322,,INTER-BANK CREDIT,698085059785221 STOKES PLC ,-7964.119999999997,Other Income, 
27-Dec-17,-894.74,655927322,,INTER-BANK CREDIT,375832586733364 WOODS-TURNER ,-8858.859999999997,Uncategorised, 
28-Dec-17,334.29,655927322,,AUTOMATIC DRAWING,Clay Haley and Evans,-8524.569999999996,Other Income, 
28-Dec-17,1483.94,655927322,,AUTOMATIC DRAWING,Bennett-Baxter,-7040.629999999996,Uncategorised, 
29-Dec-17,1107.26,655927322,,TRANSFER DEBIT,Smith Henderson and Knight,-5933.369999999995,Other Income, 
01-Jan-18,-305.39,655927322,,AUTOMATIC DRAWING,904305512366853 KING AND SONS ,-6238.759999999996,Bills, 
03-Jan-18,-1161.36,655927322,,INTER-BANK CREDIT,Warner Thornton and Clark,-7400.119999999995,Uncategorised, 
05-Jan-18,-1047.43,655927322,,TRANSFER DEBIT,410314425531415 WAGNER PRICE AND HENDERSON ,-8447.549999999996,Bills, 
08-Jan-18,-363.24,655927322,,AUTOMATIC DRAWING,546998584212424 ANDRADE-PATTERSON ,-8810.789999999995,Financial, 
09-Jan-18,-1767.12,655927322,,TRANSFER DEBIT,Bridges-Ward,-10577.909999999996,Uncategorised, 
10-Jan-18,1321.92,655927322,,AUTOMATIC DRAWING,197520608409198 MARTINEZ-CARLSON ,-9255.989999999996,Other Income, 
13-Jan-18,194.77,655927322,,INTER-BANK CREDIT,Davis-Griffin,-9061.219999999996,Other Income, 
14-Jan-18,1499.75,655927322,,AUTOMATIC DRAWING,Foster-Gonzalez,-7561.469999999996,Uncategorised, 
17-Jan-18,583.78,655927322,,INTER-BANK CREDIT,Kane and Sons,-6977.689999999996,Financial, 
18-Jan-18,1945.19,655927322,,TRANSFER DEBIT,Hunter-Caldwell,-5032.499999999996,Financial, 
19-Jan-18,-1521.53,655927322,,AUTOMATIC DRAWING,446946140963114 RICHARDSON GROUP ,-6554.029999999996,Financial, 
21-Jan-18,665.57,655927322,,TRANSFER DEBIT,450214528727114 HAYDEN-WOLF ,-5888.459999999996,Financial, 
24-Jan-18,739.95,655927322,,TRANSFER DEBIT,Miles-Dalton,-5148.509999999997,Other Income, 
26-Jan-18,175.91,655927322,,INTER-BANK CREDIT,Henderson Smith and Mcbride,-4972.599999999997,Financial, 
29-Jan-18,-1339.24,655927322,,AUTOMATIC DRAWING,Hamilton-Reynolds,-6311.8399999999965,Financial, 
29-Jan-18,1803.06,655927322,,AUTOMATIC DRAWING,Willis Jimenez and Chambers,-4508.779999999997,Financial, 
30-Jan-18,-1022.52,655927322,,TRANSFER DEBIT,Martinez Bell and Carlson,-5531.299999999997,Uncategorised, 
30-Jan-18,-18.54,655927322,,AUTOMATIC DRAWING,147971173111608 BIRD HAWKINS AND NOBLE ,-5549.839999999997,Uncategorised, 
01-Feb-18,-1587.21,655927322,,AUTOMATIC DRAWING,Best-Collins,-7137.049999999997,Other Income, 
02-Feb-18,723.4,655927322,,INTER-BANK CREDIT,874922301978431 WILLIS PORTER AND SWEENEY ,-6413.649999999998,Financial, 
02-Feb-18,-107.9,655927322,,TRANSFER DEBIT,690654013244805 FUENTES TORRES AND COLEMAN ,-6521.549999999997,Bills, 
02-Feb-18,1197.43,655927322,,INTER-BANK CREDIT,Spence Group,-5324.119999999997,Bills, 
04-Feb-18,-1567.66,655927322,,AUTOMATIC DRAWING,Green Brown and Smith,-6891.779999999997,Uncategorised, 
05-Feb-18,1335.27,655927322,,AUTOMATIC DRAWING,Hensley and Sons,-5556.509999999997,Other Income, 
05-Feb-18,-1391.0,655927322,,AUTOMATIC DRAWING,Jackson PLC,-6947.509999999997,Bills, 
08-Feb-18,-999.95,655927322,,TRANSFER DEBIT,220514108037340 BERRY ELLIS AND CHRISTENSEN ,-7947.459999999996,Financial, 
09-Feb-18,-649.55,655927322,,INTER-BANK CREDIT,Bernard Johnson and King,-8597.009999999997,Uncategorised, 
12-Feb-18,331.8,655927322,,AUTOMATIC DRAWING,Flores-Arnold,-8265.209999999997,Bills, 
15-Feb-18,274.76,655927322,,INTER-BANK CREDIT,Brooks-Mason,-7990.449999999997,Financial, 
15-Feb-18,-1223.78,655927322,,INTER-BANK CREDIT,513701654149503 RIDDLE INC ,-9214.229999999998,Financial, 
18-Feb-18,-89.94,655927322,,AUTOMATIC DRAWING,Stone-Little,-9304.169999999998,Uncategorised, 
20-Feb-18,-173.94,655927322,,INTER-BANK CREDIT,Hancock Snyder and Leonard,-9478.109999999999,Financial, 
23-Feb-18,316.93,655927322,,AUTOMATIC DRAWING,725765092234118 POWELL-ARMSTRONG ,-9161.179999999998,Other Income, 
24-Feb-18,-1941.03,655927322,,TRANSFER DEBIT,366906311568765 GRAHAM-SMITH ,-11102.21,Bills, 
25-Feb-18,-158.52,655927322,,INTER-BANK CREDIT,81524794208887 CHAVEZ INC ,-11260.73,Financial, 
26-Feb-18,615.14,655927322,,AUTOMATIC DRAWING,365509861819683 ROBINSON JACKSON AND JIMENEZ ,-10645.59,Financial, 
28-Feb-18,-429.99,655927322,,INTER-BANK CREDIT,Jones Inc,-11075.58,Bills, 
03-Mar-18,-544.66,655927322,,INTER-BANK CREDIT,Thompson PLC,-11620.24,Other Income, 
03-Mar-18,-742.09,655927322,,INTER-BANK CREDIT,Carter LLC,-12362.33,Uncategorised, 
04-Mar-18,1741.24,655927322,,INTER-BANK CREDIT,Meyer-Wells,-10621.09,Bills, 
06-Mar-18,-1628.46,655927322,,INTER-BANK CREDIT,952271324282096 CARTER-NICHOLS ,-12249.55,Other Income, 
06-Mar-18,1842.66,655927322,,AUTOMATIC DRAWING,Perkins LLC,-10406.89,Bills, 
08-Mar-18,1200.96,655927322,,TRANSFER DEBIT,Glass Fletcher and Dunn,-9205.93,Other Income, 
09-Mar-18,-423.34,655927322,,TRANSFER DEBIT,980423837195838 KING HARTMAN AND JUAREZ ,-9629.27,Bills, 
10-Mar-18,401.76,655927322,,INTER-BANK CREDIT,435658800129904 HAWKINS GROUP ,-9227.51,Financial, 
10-Mar-18,1923.04,655927322,,AUTOMATIC DRAWING,Estes LLC,-7304.47,Other Income, 
10-Mar-18,1286.82,655927322,,INTER-BANK CREDIT,Lopez-Boyd,-6017.650000000001,Bills, 
13-Mar-18,-1161.06,655927322,,INTER-BANK CREDIT,514914581155740 STRICKLAND ROGERS AND WARD ,-7178.710000000001,Bills, 
16-Mar-18,566.09,655927322,,AUTOMATIC DRAWING,Stewart and Sons,-6612.620000000001,Financial, 
16-Mar-18,-1789.62,655927322,,INTER-BANK CREDIT,West and Sons,-8402.240000000002,Other Income, 
17-Mar-18,197.62,655927322,,INTER-BANK CREDIT,806334069007584 MCDONALD AND SONS ,-8204.62,Other Income, 
17-Mar-18,266.63,655927322,,TRANSFER DEBIT,898449762801025 COX CHANDLER AND ROBINSON ,-7937.990000000001,Financial, 
19-Mar-18,-645.98,655927322,,TRANSFER DEBIT,803623004026997 BARNES GROUP ,-8583.970000000001,Financial, 
22-Mar-18,953.19,655927322,,INTER-BANK CREDIT,869070828260415 LAMBERT PLC ,-7630.780000000001,Uncategorised, 
23-Mar-18,1833.38,655927322,,TRANSFER DEBIT,419705683363838 GRANT MOORE AND ROBERTS ,-5797.400000000001,Uncategorised, 
24-Mar-18,361.79,655927322,,INTER-BANK CREDIT,Flores-Kim,-5435.610000000001,Other Income, 
27-Mar-18,377.39,655927322,,AUTOMATIC DRAWING,Byrd PLC,-5058.22,Uncategorised, 
29-Mar-18,1552.55,655927322,,AUTOMATIC DRAWING,Williams LLC,-3505.67,Other Income, 
30-Mar-18,-423.71,655927322,,AUTOMATIC DRAWING,37973822381437 ANDERSON RODRIGUEZ AND ONEAL ,-3929.38,Financial, 
02-Apr-18,1392.02,655927322,,INTER-BANK CREDIT,17805123469528 HODGE-RODGERS ,-2537.36,Uncategorised, 
02-Apr-18,-1385.19,655927322,,AUTOMATIC DRAWING,177785627602469 GARCIA-STONE ,-3922.55,Other Income, 
04-Apr-18,852.5,655927322,,TRANSFER DEBIT,Turner and Sons,-3070.05,Financial, 
04-Apr-18,-378.59,655927322,,TRANSFER DEBIT,Munoz and Sons,-3448.6400000000003,Financial, 
05-Apr-18,-345.43,655927322,,AUTOMATIC DRAWING,587715714611420 WILLIAMS INC ,-3794.07,Financial, 
05-Apr-18,285.01,655927322,,INTER-BANK CREDIT,Buckley Group,-3509.0600000000004,Bills, 
06-Apr-18,1001.17,655927322,,INTER-BANK CREDIT,219529761624259 MITCHELL-PRICE ,-2507.8900000000003,Bills, 
08-Apr-18,-363.31,655927322,,TRANSFER DEBIT,Morgan Ltd,-2871.2000000000003,Uncategorised, 
08-Apr-18,-1248.36,655927322,,AUTOMATIC DRAWING,986502911929453 SMITH LTD ,-4119.56,Other Income, 
08-Apr-18,834.54,655927322,,TRANSFER DEBIT,Newton-Smith,-3285.0200000000004,Uncategorised, 
09-Apr-18,1522.74,655927322,,INTER-BANK CREDIT,Burton Warren and Johnson,-1762.2800000000004,Other Income, 
10-Apr-18,-435.49,655927322,,AUTOMATIC DRAWING,860059013647644 MURPHY LTD ,-2197.7700000000004,Financial, 
10-Apr-18,1037.69,655927322,,INTER-BANK CREDIT,Baker-Goodwin,-1160.0800000000004,Uncategorised, 
10-Apr-18,1188.18,655927322,,INTER-BANK CREDIT,90487173426166 HAYNES PLC ,28.09999999999968,Bills, 
13-Apr-18,622.47,655927322,,AUTOMATIC DRAWING,Hodges-Woodard,650.5699999999997,Uncategorised, 
14-Apr-18,-1212.87,655927322,,TRANSFER DEBIT,Guzman Moreno and Thomas,-562.3000000000002,Other Income, 
17-Apr-18,-788.22,655927322,,INTER-BANK CREDIT,Alvarez-Lee,-1350.5200000000002,Other Income, 
20-Apr-18,-1538.65,655927322,,AUTOMATIC DRAWING,264814360375915 WALKER LLC ,-2889.17,Financial, 
23-Apr-18,1951.28,655927322,,INTER-BANK CREDIT,Hansen Group,-937.8900000000001,Bills, 
25-Apr-18,1278.79,655927322,,INTER-BANK CREDIT,942027571249731 BROWN-MILLER ,340.89999999999986,Bills, 
25-Apr-18,1195.48,655927322,,TRANSFER DEBIT,Flowers LLC,1536.3799999999999,Bills, 
27-Apr-18,-22.73,655927322,,INTER-BANK CREDIT,883550409229806 WALTER INC ,1513.6499999999999,Other Income, 
29-Apr-18,-49.74,655927322,,INTER-BANK CREDIT,295035832553695 COBB-MOODY ,1463.9099999999999,Bills, 
02-May-18,-1972.97,655927322,,INTER-BANK CREDIT,823236393407966 LARSON INC ,-509.0600000000002,Other Income, 
05-May-18,1725.14,655927322,,INTER-BANK CREDIT,Hopkins Douglas and Brown,1216.08,Bills, 
08-May-18,-1605.15,655927322,,INTER-BANK CREDIT,312218733189139 MERRITT HUFFMAN AND VAZQUEZ ,-389.07000000000016,Other Income, 
11-May-18,-1250.3,655927322,,AUTOMATIC DRAWING,Kaiser Roach and Johnson,-1639.3700000000001,Other Income, 
13-May-18,526.58,655927322,,TRANSFER DEBIT,171733991997676 MARTIN INC ,-1112.79,Other Income, 
16-May-18,-895.01,655927322,,AUTOMATIC DRAWING,146465247342802 KRAMER AND SONS ,-2007.8,Bills, 
17-May-18,-1880.79,655927322,,INTER-BANK CREDIT,493921685677476 JIMENEZ INC ,-3888.59,Other Income, 
19-May-18,-1242.58,655927322,,AUTOMATIC DRAWING,310460279070919 SMITH-CHRISTENSEN ,-5131.17,Bills, 
20-May-18,-404.17,655927322,,AUTOMATIC DRAWING,Durham Gibson and Sullivan,-5535.34,Other Income, 
21-May-18,-1362.26,655927322,,AUTOMATIC DRAWING,Morgan-Hale,-6897.6,Uncategorised, 
21-May-18,1095.53,655927322,,AUTOMATIC DRAWING,Cruz Singleton and Colon,-5802.070000000001,Uncategorised, 
21-May-18,1266.39,655927322,,AUTOMATIC DRAWING,Valenzuela Stewart and Prince,-4535.68,Other Income, 
23-May-18,1768.51,655927322,,INTER-BANK CREDIT,Strong-Cook,-2767.17,Financial, 
25-May-18,-1017.56,655927322,,TRANSFER DEBIT,Rice-Huynh,-3784.73,Bills, 
26-May-18,-936.9,655927322,,INTER-BANK CREDIT,937565051803484 WELLS-ENGLISH ,-4721.63,Financial, 
29-May-18,-1507.07,655927322,,INTER-BANK CREDIT,Vargas Ltd,-6228.7,Other Income, 
01-Jun-18,17.04,655927322,,TRANSFER DEBIT,Miller Williams and Campos,-6211.66,Bills, 
02-Jun-18,-423.31,655927322,,INTER-BANK CREDIT,600429508689488 JOHNSON-CHRISTENSEN ,-6634.97,Financial, 
05-Jun-18,-80.25,655927322,,INTER-BANK CREDIT,702895823285005 BROWN LTD ,-6715.22,Financial, 
05-Jun-18,-1336.09,655927322,,INTER-BANK CREDIT,Carter Hernandez and Austin,-8051.31,Other Income, 
06-Jun-18,-558.84,655927322,,TRANSFER DEBIT,Berg-Gutierrez,-8610.15,Financial, 
06-Jun-18,1313.1,655927322,,INTER-BANK CREDIT,Koch Mckinney and Jackson,-7297.049999999999,Financial, 
09-Jun-18,1342.85,655927322,,INTER-BANK CREDIT,180194675229803 REYNOLDS-WILSON ,-5954.199999999999,Financial, 
12-Jun-18,-1079.99,655927322,,INTER-BANK CREDIT,Wright Hicks and Mccoy,-7034.189999999999,Financial, 
12-Jun-18,266.41,655927322,,TRANSFER DEBIT,Reese-Santana,-6767.779999999999,Uncategorised, 
15-Jun-18,951.27,655927322,,INTER-BANK CREDIT,Perez-Green,-5816.509999999998,Bills, 
18-Jun-18,-1035.68,655927322,,AUTOMATIC DRAWING,Mooney Stewart and Taylor,-6852.189999999999,Bills, 
18-Jun-18,-133.7,655927322,,TRANSFER DEBIT,Diaz Guzman and Peters,-6985.8899999999985,Bills, 
18-Jun-18,757.54,655927322,,TRANSFER DEBIT,Newman-Washington,-6228.3499999999985,Financial, 
19-Jun-18,-332.19,655927322,,AUTOMATIC DRAWING,Donaldson LLC,-6560.539999999998,Financial, 
22-Jun-18,637.89,655927322,,INTER-BANK CREDIT,499511927376473 MILLER-GARCIA ,-5922.649999999998,Uncategorised, 
24-Jun-18,1288.21,655927322,,TRANSFER DEBIT,Little-Thomas,-4634.439999999998,Bills, 
25-Jun-18,980.11,655927322,,INTER-BANK CREDIT,190846058884917 SANFORD LTD ,-3654.3299999999977,Uncategorised, 
27-Jun-18,-1660.33,655927322,,TRANSFER DEBIT,829733556382920 JOHNSON-GLASS ,-5314.659999999998,Financial, 
30-Jun-18,-1302.79,655927322,,AUTOMATIC DRAWING,622005605661930 CONLEY-WILEY ,-6617.449999999998,Uncategorised, 
30-Jun-18,1229.25,655927322,,INTER-BANK CREDIT,349317797956840 WHITE WONG AND VELEZ ,-5388.199999999998,Financial, 
30-Jun-18,1413.58,655927322,,INTER-BANK CREDIT,527999017143996 MITCHELL ALLEN AND STANLEY ,-3974.619999999998,Financial, 
03-Jul-18,-995.48,655927322,,TRANSFER DEBIT,Ward Group,-4970.0999999999985,Uncategorised, 
05-Jul-18,-443.36,655927322,,INTER-BANK CREDIT,Jones-Scott,-5413.459999999998,Bills, 
05-Jul-18,349.56,655927322,,TRANSFER DEBIT,Washington Bell and Gibbs,-5063.899999999998,Financial, 
05-Jul-18,-915.43,655927322,,TRANSFER DEBIT,Clark Gonzalez and Gonzales,-5979.329999999998,Uncategorised, 
07-Jul-18,-1662.21,655927322,,TRANSFER DEBIT,321264873841536 BERRY-LEE ,-7641.539999999998,Financial, 
10-Jul-18,1728.5,655927322,,TRANSFER DEBIT,28834664479177 COBB BARTLETT AND MILLER ,-5913.039999999998,Uncategorised, 
10-Jul-18,-1950.4,655927322,,AUTOMATIC DRAWING,907473940646546 JONES AND SONS ,-7863.439999999999,Bills, 
12-Jul-18,951.85,655927322,,AUTOMATIC DRAWING,Robinson-Campos,-6911.589999999998,Other Income, 
12-Jul-18,-1522.26,655927322,,INTER-BANK CREDIT,Heath and Sons,-8433.849999999999,Bills, 
15-Jul-18,-1583.14,655927322,,TRANSFER DEBIT,414530049352795 EDWARDS LEE AND WIGGINS ,-10016.989999999998,Other Income, 
17-Jul-18,1134.22,655927322,,AUTOMATIC DRAWING,Lambert Williams and Neal,-8882.769999999999,Financial, 
18-Jul-18,1597.98,655927322,,AUTOMATIC DRAWING,492288864886790 CARTER AND SONS ,-7284.789999999999,Financial, 
18-Jul-18,-1737.28,655927322,,AUTOMATIC DRAWING,757955070293317 MCPHERSON GROUP ,-9022.07,Financial, 
19-Jul-18,-571.13,655927322,,AUTOMATIC DRAWING,795327833384928 LEE-COOPER ,-9593.199999999999,Other Income, 
19-Jul-18,-1805.72,655927322,,TRANSFER DEBIT,Silva Zhang and Eaton,-11398.919999999998,Financial, 
22-Jul-18,-1298.34,655927322,,INTER-BANK CREDIT,Davis PLC,-12697.259999999998,Bills, 
24-Jul-18,1376.57,655927322,,AUTOMATIC DRAWING,Stokes Group,-11320.689999999999,Uncategorised, 
24-Jul-18,-188.15,655927322,,AUTOMATIC DRAWING,Wagner LLC,-11508.839999999998,Uncategorised, 
27-Jul-18,1801.69,655927322,,INTER-BANK CREDIT,160188096472159 ALLEN ROBERTS AND CASTRO ,-9707.149999999998,Financial, 
27-Jul-18,5.39,655927322,,TRANSFER DEBIT,817936687228639 MCCOY AND SONS ,-9701.759999999998,Uncategorised, 
28-Jul-18,599.88,655927322,,TRANSFER DEBIT,164003313410964 BELL-ANDREWS ,-9101.88,Other Income, 
30-Jul-18,-511.73,655927322,,AUTOMATIC DRAWING,318148829659212 COOPER-HILL ,-9613.609999999999,Other Income, 
31-Jul-18,-1794.76,655927322,,INTER-BANK CREDIT,Cordova Vaughn and Berry,-11408.369999999999,Other Income, 
02-Aug-18,498.58,655927322,,INTER-BANK CREDIT,Shepard Bennett and Dixon,-10909.789999999999,Financial, 
02-Aug-18,-1752.82,655927322,,TRANSFER DEBIT,814676202583294 CRUZ AND SONS ,-12662.609999999999,Other Income, 
05-Aug-18,-651.08,655927322,,INTER-BANK CREDIT,100287233984538 PONCE PLC ,-13313.689999999999,Bills, 
07-Aug-18,1304.66,655927322,,TRANSFER DEBIT,41495081125732 HAMPTON GROUP ,-12009.029999999999,Uncategorised, 
07-Aug-18,-918.02,655927322,,INTER-BANK CREDIT,181683643065811 HANNA GROUP ,-12927.05,Other Income, 
08-Aug-18,-1340.43,655927322,,AUTOMATIC DRAWING,Lucas Group,-14267.48,Bills, 
11-Aug-18,901.48,655927322,,TRANSFER DEBIT,Nichols Inc,-13366.0,Financial, 
13-Aug-18,-1134.74,655927322,,INTER-BANK CREDIT,25737786595632 JACKSON LEE AND MASON ,-14500.74,Bills, 
14-Aug-18,1569.11,655927322,,INTER-BANK CREDIT,Clarke-Brown,-12931.63,Bills, 
16-Aug-18,-1258.09,655927322,,TRANSFER DEBIT,Foley Parker and Scott,-14189.72,Other Income, 
18-Aug-18,1221.67,655927322,,TRANSFER DEBIT,Carter-Murphy,-12968.05,Other Income, 
21-Aug-18,1835.74,655927322,,AUTOMATIC DRAWING,359740626444519 GRAY FREDERICK AND RICHARDSON ,-11132.31,Financial, 
21-Aug-18,-1571.33,655927322,,INTER-BANK CREDIT,539261369937994 AVILA PEREZ AND COLEMAN ,-12703.64,Bills, 
24-Aug-18,-1737.53,655927322,,INTER-BANK CREDIT,790605274161689 HARVEY LLC ,-14441.17,Financial, 
24-Aug-18,18.3,655927322,,AUTOMATIC DRAWING,72044568708384 SMITH JOHNSON AND WILSON ,-14422.87,Uncategorised, 
25-Aug-18,1244.18,655927322,,TRANSFER DEBIT,632314740761731 GRANT GROUP ,-13178.69,Uncategorised, 
26-Aug-18,-1615.23,655927322,,AUTOMATIC DRAWING,13768188674006 JONES-CLARK ,-14793.92,Financial, 
28-Aug-18,1418.3,655927322,,INTER-BANK CREDIT,Sandoval Boone and Myers,-13375.62,Uncategorised, 
30-Aug-18,1981.42,655927322,,INTER-BANK CREDIT,399259447629927 WILLIAMS-WALKER ,-11394.2,Uncategorised, 
30-Aug-18,-463.37,655927322,,TRANSFER DEBIT,Stanley Cain and Bell,-11857.570000000002,Bills, 
02-Sep-18,-1057.33,655927322,,TRANSFER DEBIT,488872557206140 WOODS-SHAW ,-12914.900000000001,Bills, 
04-Sep-18,302.48,655927322,,INTER-BANK CREDIT,Fernandez Forbes and Moss,-12612.420000000002,Bills, 
06-Sep-18,1083.66,655927322,,INTER-BANK CREDIT,Cuevas-Alexander,-11528.760000000002,Uncategorised, 
09-Sep-18,-882.17,655927322,,AUTOMATIC DRAWING,Medina PLC,-12410.930000000002,Other Income, 
12-Sep-18,1961.45,655927322,,INTER-BANK CREDIT,822401836627192 LEE AND SONS ,-10449.480000000001,Bills, 
15-Sep-18,1421.6,655927322,,TRANSFER DEBIT,59143144748963 WHITE-BECKER ,-9027.880000000001,Financial, 
17-Sep-18,-940.15,655927322,,AUTOMATIC DRAWING,Taylor Greer and Daniels,-9968.03,Bills, 
18-Sep-18,1185.81,655927322,,INTER-BANK CREDIT,Moore LLC,-8782.220000000001,Uncategorised, 
21-Sep-18,1546.06,655927322,,INTER-BANK CREDIT,770045715357459 PRATT WATKINS AND GRIFFITH ,-7236.160000000002,Financial, 
24-Sep-18,-414.21,655927322,,AUTOMATIC DRAWING,629595414872049 MOORE RODRIGUEZ AND GOMEZ ,-7650.370000000002,Bills, 
24-Sep-18,443.19,655927322,,AUTOMATIC DRAWING,Kelley LLC,-7207.180000000002,Financial, 
24-Sep-18,1810.97,655927322,,TRANSFER DEBIT,Thomas-Smith,-5396.210000000002,Financial, 
27-Sep-18,1930.47,655927322,,TRANSFER DEBIT,571623239852070 MACIAS ANDERSON AND REYNOLDS ,-3465.7400000000016,Bills, 
27-Sep-18,-565.41,655927322,,INTER-BANK CREDIT,Berry Group,-4031.1500000000015,Financial, 
28-Sep-18,-1377.84,655927322,,TRANSFER DEBIT,120623365321271 HAMILTON-LUCAS ,-5408.990000000002,Bills, 
28-Sep-18,-1611.01,655927322,,INTER-BANK CREDIT,433782411422645 HURST PLC ,-7020.000000000002,Other Income, 
28-Sep-18,-1566.53,655927322,,INTER-BANK CREDIT,704731920952145 SCHWARTZ AND SONS ,-8586.530000000002,Uncategorised, 
28-Sep-18,420.37,655927322,,INTER-BANK CREDIT,967409990547396 THOMPSON-CURTIS ,-8166.160000000003,Financial, 
30-Sep-18,1847.89,655927322,,INTER-BANK CREDIT,James-Frye,-6318.270000000002,Other Income, 
03-Oct-18,-1942.79,655927322,,INTER-BANK CREDIT,183560382187996 DAVIS LTD ,-8261.060000000001,Uncategorised, 
03-Oct-18,440.22,655927322,,INTER-BANK CREDIT,Moon-Owens,-7820.840000000001,Bills, 
06-Oct-18,1580.88,655927322,,INTER-BANK CREDIT,Sherman-Campbell,-6239.960000000001,Uncategorised, 
09-Oct-18,-1309.39,655927322,,INTER-BANK CREDIT,913131216367495 HOLDER-MARTINEZ ,-7549.350000000001,Bills, 
09-Oct-18,-1669.21,655927322,,INTER-BANK CREDIT,679272118032731 GOODMAN-CHEN ,-9218.560000000001,Uncategorised, 
10-Oct-18,1229.2,655927322,,INTER-BANK CREDIT,325719036402541 VARGAS LTD ,-7989.3600000000015,Bills, 
11-Oct-18,1847.25,655927322,,TRANSFER DEBIT,67343400905258 FISCHER-MANN ,-6142.1100000000015,Other Income, 
12-Oct-18,-1273.23,655927322,,INTER-BANK CREDIT,White Sharp and Watkins,-7415.340000000002,Bills, 
14-Oct-18,-1627.41,655927322,,INTER-BANK CREDIT,906206502982681 LEWIS PLC ,-9042.750000000002,Financial, 
14-Oct-18,1829.77,655927322,,TRANSFER DEBIT,Gutierrez Haynes and Hall,-7212.980000000001,Bills, 
16-Oct-18,-781.33,655927322,,INTER-BANK CREDIT,620428729929407 GARRETT GROUP ,-7994.310000000001,Financial, 
16-Oct-18,1212.73,655927322,,INTER-BANK CREDIT,686429977112782 MORALES BROOKS AND HANNA ,-6781.580000000002,Bills, 
16-Oct-18,-1372.64,655927322,,TRANSFER DEBIT,938802365573616 HOLT-SMITH ,-8154.220000000002,Bills, 
16-Oct-18,-4.45,655927322,,AUTOMATIC DRAWING,413404198322012 MATA-CERVANTES ,-8158.670000000002,Uncategorised, 
18-Oct-18,1825.12,655927322,,AUTOMATIC DRAWING,Deleon-Clark,-6333.550000000002,Financial, 
18-Oct-18,-381.87,655927322,,INTER-BANK CREDIT,Cox-Frye,-6715.420000000002,Uncategorised, 
19-Oct-18,515.87,655927322,,AUTOMATIC DRAWING,Adams-Williams,-6199.550000000002,Bills, 
21-Oct-18,-1708.53,655927322,,AUTOMATIC DRAWING,Hines Ltd,-7908.080000000002,Financial, 
23-Oct-18,436.48,655927322,,TRANSFER DEBIT,Fox-Johnson,-7471.600000000002,Financial, 
24-Oct-18,81.76,655927322,,AUTOMATIC DRAWING,Brock Reyes and Floyd,-7389.840000000002,Bills, 
27-Oct-18,840.77,655927322,,INTER-BANK CREDIT,Marquez Fields and Terrell,-6549.0700000000015,Other Income, 
27-Oct-18,-868.93,655927322,,AUTOMATIC DRAWING,Robinson LLC,-7418.000000000002,Bills, 
27-Oct-18,-1861.58,655927322,,INTER-BANK CREDIT,Martin Conner and Warner,-9279.580000000002,Financial, 
29-Oct-18,-1687.72,655927322,,AUTOMATIC DRAWING,Gonzalez Friedman and Harris,-10967.300000000001,Financial, 
31-Oct-18,892.17,655927322,,AUTOMATIC DRAWING,Miller LLC,-10075.130000000001,Financial, 
01-Nov-18,-55.24,655927322,,INTER-BANK CREDIT,792370927582788 BOONE LLC ,-10130.37,Financial, 
01-Nov-18,1885.16,655927322,,INTER-BANK CREDIT,Boyd-Cunningham,-8245.210000000001,Uncategorised, 
01-Nov-18,1549.91,655927322,,INTER-BANK CREDIT,Bailey Monroe and Allen,-6695.300000000001,Financial, 
01-Nov-18,1795.19,655927322,,INTER-BANK CREDIT,White-Smith,-4900.110000000001,Bills, 
04-Nov-18,-1501.47,655927322,,AUTOMATIC DRAWING,15286123534985 BROWN TREVINO AND COHEN ,-6401.580000000001,Bills, 
06-Nov-18,723.89,655927322,,INTER-BANK CREDIT,637581692832662 BARAJAS GROUP ,-5677.6900000000005,Financial, 
08-Nov-18,-905.15,655927322,,INTER-BANK CREDIT,Murphy-Kelly,-6582.84,Financial, 
10-Nov-18,-1305.78,655927322,,AUTOMATIC DRAWING,641064381535236 MARTIN LLC ,-7888.62,Other Income, 
10-Nov-18,-251.07,655927322,,INTER-BANK CREDIT,Mcgrath Beck and Parrish,-8139.69,Uncategorised, 
10-Nov-18,-772.47,655927322,,INTER-BANK CREDIT,White-Schultz,-8912.16,Other Income, 
11-Nov-18,-907.11,655927322,,AUTOMATIC DRAWING,Lutz-Robinson,-9819.27,Uncategorised, 
14-Nov-18,1319.83,655927322,,INTER-BANK CREDIT,394996882867115 SOTO-WRIGHT ,-8499.44,Uncategorised, 
17-Nov-18,-1082.61,655927322,,INTER-BANK CREDIT,Smith-Hanson,-9582.050000000001,Uncategorised, 
18-Nov-18,-277.48,655927322,,INTER-BANK CREDIT,563816254057502 JAMES AND SONS ,-9859.53,Other Income, 
19-Nov-18,-116.33,655927322,,INTER-BANK CREDIT,453971349733338 HICKMAN LTD ,-9975.86,Uncategorised, 
19-Nov-18,-171.62,655927322,,TRANSFER DEBIT,208220199945190 PRINCE INC ,-10147.480000000001,Financial, 
19-Nov-18,598.46,655927322,,INTER-BANK CREDIT,Proctor PLC,-9549.02,Other Income, 
21-Nov-18,321.43,655927322,,INTER-BANK CREDIT,Brown Ashley and Norris,-9227.59,Other Income, 
21-Nov-18,-1250.25,655927322,,INTER-BANK CREDIT,Weber Group,-10477.84,Bills, 
22-Nov-18,-732.76,655927322,,INTER-BANK CREDIT,Johnston PLC,-11210.6,Uncategorised, 
23-Nov-18,-15.08,655927322,,TRANSFER DEBIT,Williams-Ball,-11225.68,Uncategorised, 
23-Nov-18,1435.38,655927322,,TRANSFER DEBIT,Romero Martin and Adams,-9790.3,Other Income, 
25-Nov-18,436.18,655927322,,INTER-BANK CREDIT,Spencer-Banks,-9354.119999999999,Uncategorised, 
26-Nov-18,-772.71,655927322,,AUTOMATIC DRAWING,Petersen Davis and Hess,-10126.829999999998,Bills, 
29-Nov-18,-310.99,655927322,,INTER-BANK CREDIT,Wells Bentley and Shaffer,-10437.819999999998,Other Income, 
02-Dec-18,546.15,655927322,,INTER-BANK CREDIT,441334802485688 BUTLER AND SONS ,-9891.669999999998,Uncategorised, 
02-Dec-18,473.46,655927322,,TRANSFER DEBIT,457869817048972 LEE WHITE AND WILLIAMS ,-9418.21,Other Income, 
02-Dec-18,124.25,655927322,,AUTOMATIC DRAWING,Bailey-Martin,-9293.96,Uncategorised, 
05-Dec-18,-1965.86,655927322,,AUTOMATIC DRAWING,763385352085048 SCOTT MCKINNEY AND SWANSON ,-11259.82,Financial, 
06-Dec-18,-1697.53,655927322,,INTER-BANK CREDIT,17576965274814 LAWSON INC ,-12957.35,Bills, 
07-Dec-18,383.99,655927322,,INTER-BANK CREDIT,210500634405936 ROBINSON BAUER AND JOHNSON ,-12573.36,Bills, 
10-Dec-18,-1029.29,655927322,,INTER-BANK CREDIT,14372077561232 GONZALES INC ,-13602.650000000001,Other Income, 
13-Dec-18,1209.72,655927322,,INTER-BANK CREDIT,Carpenter Cole and Miller,-12392.930000000002,Uncategorised, 
15-Dec-18,-271.88,655927322,,TRANSFER DEBIT,Keller PLC,-12664.810000000001,Bills, 
17-Dec-18,33.87,655927322,,INTER-BANK CREDIT,Diaz-Dennis,-12630.94,Other Income, 
19-Dec-18,277.73,655927322,,INTER-BANK CREDIT,Myers Booker and Walsh,-12353.210000000001,Other Income, 
21-Dec-18,-1721.14,655927322,,INTER-BANK CREDIT,Patterson King and Hoover,-14074.35,Uncategorised, 
21-Dec-18,462.42,655927322,,INTER-BANK CREDIT,320655677581837 HENSLEY-MCKAY ,-13611.93,Financial, 
21-Dec-18,1027.98,655927322,,AUTOMATIC DRAWING,548876814600341 HODGES LTD ,-12583.95,Uncategorised, 
23-Dec-18,465.8,655927322,,AUTOMATIC DRAWING,Nelson Robinson and Watkins,-12118.150000000001,Other Income, 
25-Dec-18,-620.66,655927322,,INTER-BANK CREDIT,408239089911138 MILLER PHILLIPS AND JOHNSTON ,-12738.810000000001,Bills, 
27-Dec-18,1028.51,655927322,,AUTOMATIC DRAWING,Garcia LLC,-11710.300000000001,Uncategorised, 
27-Dec-18,-1991.17,655927322,,AUTOMATIC DRAWING,861360226520240 MENDOZA INC ,-13701.470000000001,Financial, 
27-Dec-18,-1446.92,655927322,,TRANSFER DEBIT,736692240578922 FARRELL GROUP ,-15148.390000000001,Uncategorised, 
29-Dec-18,-1234.41,655927322,,INTER-BANK CREDIT,Hall Mcdowell and Ware,-16382.800000000001,Uncategorised, 
29-Dec-18,1373.8,655927322,,TRANSFER DEBIT,Bradford Spencer and Solomon,-15009.000000000002,Other Income, 
30-Dec-18,-1203.27,655927322,,AUTOMATIC DRAWING,484197139905179 MCDOWELL ALLEN AND CROSS ,-16212.270000000002,Other Income, 
30-Dec-18,-1839.23,655927322,,INTER-BANK CREDIT,760737415423858 HOWARD-CHAN ,-18051.500000000004,Other Income, 
30-Dec-18,-1849.88,655927322,,INTER-BANK CREDIT,Johnson Gomez and Neal,-19901.380000000005,Bills, 
01-Jan-19,949.03,655927322,,INTER-BANK CREDIT,Sims-Sweeney,-18952.350000000006,Other Income, 
02-Jan-19,1622.47,655927322,,TRANSFER DEBIT,828701420386171 WILLIAMS COLLINS AND SMITH ,-17329.880000000005,Other Income, 
04-Jan-19,1646.37,655927322,,AUTOMATIC DRAWING,Rodriguez LLC,-15683.510000000006,Bills, 
04-Jan-19,-672.44,655927322,,INTER-BANK CREDIT,736314112315491 ALVAREZ-RODRIGUEZ ,-16355.950000000006,Other Income, 
07-Jan-19,1973.38,655927322,,TRANSFER DEBIT,Johnson Harper and Greene,-14382.570000000007,Uncategorised, 
09-Jan-19,-830.73,655927322,,AUTOMATIC DRAWING,761855153054528 PALMER-BARTLETT ,-15213.300000000007,Other Income, 
12-Jan-19,1752.53,655927322,,AUTOMATIC DRAWING,Kennedy Lee and Newton,-13460.770000000006,Uncategorised, 
14-Jan-19,1359.61,655927322,,TRANSFER DEBIT,357931564877854 LOPEZ MCDANIEL AND GARRISON ,-12101.160000000005,Other Income, 
17-Jan-19,-361.36,655927322,,AUTOMATIC DRAWING,887937719173612 JENKINS MOORE AND NEAL ,-12462.520000000006,Financial, 
18-Jan-19,1257.0,655927322,,AUTOMATIC DRAWING,148237251684508 CRAWFORD MARTIN AND CHAPMAN ,-11205.520000000006,Bills, 
18-Jan-19,-186.98,655927322,,TRANSFER DEBIT,596781497240904 HOLLAND-BELL ,-11392.500000000005,Bills, 
21-Jan-19,1900.11,655927322,,TRANSFER DEBIT,463875942910662 PRESTON-SINGLETON ,-9492.390000000005,Financial, 
21-Jan-19,-1939.04,655927322,,AUTOMATIC DRAWING,Chen Pitts and Dodson,-11431.430000000004,Uncategorised, 
23-Jan-19,-1666.5,655927322,,INTER-BANK CREDIT,849344822777108 WHITE-ONEAL ,-13097.930000000004,Other Income, 
25-Jan-19,-315.66,655927322,,TRANSFER DEBIT,Carlson Young and Evans,-13413.590000000004,Bills, 
25-Jan-19,-932.98,655927322,,AUTOMATIC DRAWING,463160711155678 DAVIS-ZHANG ,-14346.570000000003,Other Income, 
25-Jan-19,1745.06,655927322,,INTER-BANK CREDIT,197167583430577 RILEY MALDONADO AND WILSON ,-12601.510000000004,Uncategorised, 
28-Jan-19,-513.71,655927322,,INTER-BANK CREDIT,Valentine Smith and Gray,-13115.220000000005,Uncategorised, 
30-Jan-19,-1037.34,655927322,,TRANSFER DEBIT,115052080543336 LUNA ROBERTS AND WILLIAMS ,-14152.560000000005,Financial, 
30-Jan-19,1858.93,655927322,,AUTOMATIC DRAWING,Arnold Inc,-12293.630000000005,Other Income, 
31-Jan-19,57.91,655927322,,AUTOMATIC DRAWING,Martinez Williams and Evans,-12235.720000000005,Uncategorised, 
03-Feb-19,-1520.37,655927322,,TRANSFER DEBIT,153049950201229 HILL SNYDER AND AGUILAR ,-13756.090000000004,Uncategorised, 
05-Feb-19,763.06,655927322,,INTER-BANK CREDIT,243937309973384 GARRETT-WILLIAMS ,-12993.030000000004,Other Income, 
06-Feb-19,1091.78,655927322,,AUTOMATIC DRAWING,34903360037672 WILLIAMS MENDOZA AND JONES ,-11901.250000000004,Bills, 
07-Feb-19,-1291.07,655927322,,INTER-BANK CREDIT,Flores Ltd,-13192.320000000003,Uncategorised, 
10-Feb-19,1649.98,655927322,,AUTOMATIC DRAWING,371120595356617 HOLT BOYER AND BURNS ,-11542.340000000004,Uncategorised, 
10-Feb-19,421.46,655927322,,INTER-BANK CREDIT,385604985991335 HARVEY PLC ,-11120.880000000005,Bills, 
13-Feb-19,427.9,655927322,,TRANSFER DEBIT,Mclaughlin Moore and Nunez,-10692.980000000005,Uncategorised, 
15-Feb-19,-645.73,655927322,,AUTOMATIC DRAWING,Davis-Thomas,-11338.710000000005,Financial, 
16-Feb-19,-501.25,655927322,,INTER-BANK CREDIT,Daniels-Burnett,-11839.960000000005,Financial, 
18-Feb-19,-772.26,655927322,,INTER-BANK CREDIT,598160902067544 HOOPER MENDOZA AND MARTINEZ ,-12612.220000000005,Other Income, 
20-Feb-19,-509.31,655927322,,INTER-BANK CREDIT,600153552967397 RUSSELL-RICHMOND ,-13121.530000000004,Uncategorised, 
21-Feb-19,1723.3,655927322,,AUTOMATIC DRAWING,Smith-Adkins,-11398.230000000005,Other Income, 
21-Feb-19,368.34,655927322,,TRANSFER DEBIT,Johnson Inc,-11029.890000000005,Other Income, 
22-Feb-19,-161.89,655927322,,INTER-BANK CREDIT,543615772601896 AYALA KELLER AND GARCIA ,-11191.780000000004,Uncategorised, 
23-Feb-19,1907.35,655927322,,TRANSFER DEBIT,Murray Mitchell and Warren,-9284.430000000004,Other Income, 
25-Feb-19,78.71,655927322,,INTER-BANK CREDIT,808360581681456 WAGNER AND SONS ,-9205.720000000005,Bills, 
25-Feb-19,-1184.61,655927322,,INTER-BANK CREDIT,Perez LLC,-10390.330000000005,Financial, 
27-Feb-19,-1981.59,655927322,,INTER-BANK CREDIT,Parker and Sons,-12371.920000000006,Other Income, 
28-Feb-19,-1112.46,655927322,,INTER-BANK CREDIT,Hayes-Nelson,-13484.380000000005,Uncategorised, 
01-Mar-19,640.23,655927322,,INTER-BANK CREDIT,896990925481143 CHANDLER TURNER AND WRIGHT ,-12844.150000000005,Other Income, 
04-Mar-19,1292.7,655927322,,AUTOMATIC DRAWING,590537420653211 ALLEN GROUP ,-11551.450000000004,Bills, 
06-Mar-19,-1407.91,655927322,,INTER-BANK CREDIT,122232073545241 ROSS-JOHNSON ,-12959.360000000004,Other Income, 
08-Mar-19,-271.7,655927322,,TRANSFER DEBIT,405004715292985 COOPER GROUP ,-13231.060000000005,Other Income, 
11-Mar-19,-1746.18,655927322,,TRANSFER DEBIT,716468360154351 SULLIVAN GROUP ,-14977.240000000005,Bills, 
13-Mar-19,1201.75,655927322,,INTER-BANK CREDIT,Petersen Ltd,-13775.490000000005,Uncategorised, 
16-Mar-19,-523.25,655927322,,INTER-BANK CREDIT,Jones Hernandez and Rivera,-14298.740000000005,Other Income, 
17-Mar-19,-1545.16,655927322,,INTER-BANK CREDIT,634985455933717 RICHARDSON-KHAN ,-15843.900000000005,Bills, 
20-Mar-19,952.07,655927322,,AUTOMATIC DRAWING,289386140763580 HALL PLC ,-14891.830000000005,Uncategorised, 
21-Mar-19,-1405.72,655927322,,INTER-BANK CREDIT,Harrison PLC,-16297.550000000005,Financial, 
21-Mar-19,1973.97,655927322,,TRANSFER DEBIT,814219112141156 YOUNG-FERGUSON ,-14323.580000000005,Bills, 
24-Mar-19,-1602.48,655927322,,TRANSFER DEBIT,261751789330699 BARRY REYES AND RAMIREZ ,-15926.060000000005,Financial, 
25-Mar-19,-1024.0,655927322,,AUTOMATIC DRAWING,Peterson Browning and Ramirez,-16950.060000000005,Bills, 
28-Mar-19,-1621.64,655927322,,INTER-BANK CREDIT,Hernandez Rodriguez and Bell,-18571.700000000004,Other Income, 
28-Mar-19,-656.32,655927322,,AUTOMATIC DRAWING,George PLC,-19228.020000000004,Uncategorised, 
31-Mar-19,946.92,655927322,,AUTOMATIC DRAWING,Booker Erickson and Brock,-18281.100000000006,Uncategorised, 
31-Mar-19,545.83,655927322,,TRANSFER DEBIT,Campbell-Price,-17735.270000000004,Other Income, 
02-Apr-19,885.61,655927322,,INTER-BANK CREDIT,376315035796308 WU GROUP ,-16849.660000000003,Bills, 
03-Apr-19,1007.65,655927322,,INTER-BANK CREDIT,Ortega-Sanchez,-15842.010000000004,Uncategorised, 
03-Apr-19,263.08,655927322,,INTER-BANK CREDIT,528372860973404 IRWIN-ELLIS ,-15578.930000000004,Financial, 
06-Apr-19,417.76,655927322,,TRANSFER DEBIT,Thompson PLC,-15161.170000000004,Other Income, 
07-Apr-19,-86.97,655927322,,INTER-BANK CREDIT,Johnson-Powell,-15248.140000000003,Financial, 
10-Apr-19,806.39,655927322,,INTER-BANK CREDIT,537120279433556 SULLIVAN JOHNSON AND GOULD ,-14441.750000000004,Uncategorised, 
11-Apr-19,1804.91,655927322,,INTER-BANK CREDIT,Harrison Inc,-12636.840000000004,Uncategorised, 
13-Apr-19,-556.8,655927322,,TRANSFER DEBIT,781860444378753 NICHOLS AND SONS ,-13193.640000000003,Uncategorised, 
16-Apr-19,1328.26,655927322,,AUTOMATIC DRAWING,Smith Shields and Morris,-11865.380000000003,Uncategorised, 
19-Apr-19,593.16,655927322,,INTER-BANK CREDIT,Lucas Ltd,-11272.220000000003,Uncategorised, 
20-Apr-19,-561.26,655927322,,TRANSFER DEBIT,373170023059962 YODER LLC ,-11833.480000000003,Bills, 
22-Apr-19,1177.24,655927322,,INTER-BANK CREDIT,61895369534944 SUMMERS INC ,-10656.240000000003,Other Income, 
25-Apr-19,-1826.27,655927322,,INTER-BANK CREDIT,145844123214421 BAKER-HURLEY ,-12482.510000000004,Other Income, 
27-Apr-19,-1881.01,655927322,,INTER-BANK CREDIT,474367112745633 KAISER MARTINEZ AND WILSON ,-14363.520000000004,Bills, 
28-Apr-19,-979.56,655927322,,INTER-BANK CREDIT,Tucker Valencia and Martinez,-15343.080000000004,Other Income, 
29-Apr-19,-1275.73,655927322,,AUTOMATIC DRAWING,688449500595180 HERNANDEZ GROUP ,-16618.810000000005,Financial, 
30-Apr-19,1497.67,655927322,,TRANSFER DEBIT,625534417134208 SOTO-OBRIEN ,-15121.140000000005,Financial, 
03-May-19,1385.56,655927322,,TRANSFER DEBIT,Warren Reyes and Scott,-13735.580000000005,Financial, 
03-May-19,226.47,655927322,,INTER-BANK CREDIT,Figueroa Inc,-13509.110000000006,Other Income, 
04-May-19,469.01,655927322,,AUTOMATIC DRAWING,Liu-Martinez,-13040.100000000006,Financial, 
04-May-19,-1380.62,655927322,,INTER-BANK CREDIT,567443721550044 PATTON-WERNER ,-14420.720000000005,Uncategorised, 
07-May-19,1130.82,655927322,,AUTOMATIC DRAWING,Mendez-Richard,-13289.900000000005,Financial, 
09-May-19,1055.47,655927322,,TRANSFER DEBIT,Hernandez LLC,-12234.430000000006,Uncategorised, 
12-May-19,-1305.34,655927322,,AUTOMATIC DRAWING,Jones Ramirez and Cantu,-13539.770000000006,Uncategorised, 
13-May-19,876.44,655927322,,INTER-BANK CREDIT,460261047173231 TRAN-GUERRERO ,-12663.330000000005,Bills, 
13-May-19,-1034.82,655927322,,INTER-BANK CREDIT,Hughes LLC,-13698.150000000005,Uncategorised, 
13-May-19,-731.48,655927322,,TRANSFER DEBIT,Evans LLC,-14429.630000000005,Financial, 
13-May-19,98.88,655927322,,TRANSFER DEBIT,Johnson Ltd,-14330.750000000005,Uncategorised, 
13-May-19,-1765.73,655927322,,INTER-BANK CREDIT,Obrien Brown and Logan,-16096.480000000005,Uncategorised, 
15-May-19,-1272.8,655927322,,AUTOMATIC DRAWING,Allen Hall and Moore,-17369.280000000006,Other Income, 
18-May-19,-1146.39,655927322,,INTER-BANK CREDIT,Lopez Adams and Glenn,-18515.670000000006,Bills, 
20-May-19,-786.79,655927322,,AUTOMATIC DRAWING,Sparks and Sons,-19302.460000000006,Uncategorised, 
20-May-19,1399.52,655927322,,TRANSFER DEBIT,Elliott-Shaw,-17902.940000000006,Financial, 
20-May-19,-594.48,655927322,,TRANSFER DEBIT,Singh-Acosta,-18497.420000000006,Financial, 
23-May-19,986.93,655927322,,INTER-BANK CREDIT,Chen LLC,-17510.490000000005,Other Income, 
24-May-19,1818.3,655927322,,TRANSFER DEBIT,861784334930240 HUNTER HALL AND RICE ,-15692.190000000006,Financial, 
26-May-19,-33.63,655927322,,TRANSFER DEBIT,Salinas LLC,-15725.820000000005,Uncategorised, 
27-May-19,-1760.44,655927322,,INTER-BANK CREDIT,Lane Jordan and Forbes,-17486.260000000006,Financial, 
30-May-19,1443.37,655927322,,TRANSFER DEBIT,640502775198343 RAMOS-BARNES ,-16042.890000000007,Financial, 
31-May-19,1751.07,655927322,,INTER-BANK CREDIT,Taylor-Henderson,-14291.820000000007,Other Income, 
01-Jun-19,533.66,655927322,,TRANSFER DEBIT,969736590491089 WILLIAMS PHILLIPS AND LEON ,-13758.160000000007,Bills, 
02-Jun-19,-1298.33,655927322,,INTER-BANK CREDIT,900728576031055 JONES HERNANDEZ AND MEADOWS ,-15056.490000000007,Bills, 
03-Jun-19,232.74,655927322,,AUTOMATIC DRAWING,Conner Decker and Mooney,-14823.750000000007,Bills, 
04-Jun-19,-951.95,655927322,,INTER-BANK CREDIT,383349032478770 COLEMAN MURRAY AND HERRING ,-15775.700000000008,Other Income, 
05-Jun-19,208.99,655927322,,TRANSFER DEBIT,Williams-Hamilton,-15566.710000000008,Other Income, 
06-Jun-19,1672.93,655927322,,INTER-BANK CREDIT,943177646822269 LANE OLSON AND STANLEY ,-13893.780000000008,Uncategorised, 
06-Jun-19,1513.82,655927322,,AUTOMATIC DRAWING,Ramos-Lopez,-12379.960000000008,Financial, 
06-Jun-19,-711.96,655927322,,AUTOMATIC DRAWING,655563833522958 ALLEN-FLORES ,-13091.92000000001,Other Income, 
08-Jun-19,548.56,655927322,,TRANSFER DEBIT,Garcia Farmer and Liu,-12543.36000000001,Other Income, 
08-Jun-19,-1687.11,655927322,,AUTOMATIC DRAWING,Greene-Kelley,-14230.47000000001,Bills, 
08-Jun-19,143.48,655927322,,INTER-BANK CREDIT,958766021544427 MALDONADO JOSEPH AND WEBSTER ,-14086.99000000001,Financial, 
08-Jun-19,-1252.58,655927322,,INTER-BANK CREDIT,Williams-Skinner,-15339.57000000001,Financial, 
09-Jun-19,-1328.59,655927322,,INTER-BANK CREDIT,463180934979597 ARELLANO WRIGHT AND CLAYTON ,-16668.16000000001,Financial, 
11-Jun-19,471.37,655927322,,AUTOMATIC DRAWING,938568701324112 BALL-AUSTIN ,-16196.79000000001,Bills, 
13-Jun-19,894.23,655927322,,INTER-BANK CREDIT,Oneill Jones and Silva,-15302.56000000001,Other Income, 
16-Jun-19,1238.14,655927322,,TRANSFER DEBIT,Garcia Johnson and Wright,-14064.420000000011,Bills, 
17-Jun-19,690.75,655927322,,AUTOMATIC DRAWING,437033930901960 CHASE INC ,-13373.670000000011,Other Income, 
18-Jun-19,1036.95,655927322,,INTER-BANK CREDIT,Collins Arnold and Jones,-12336.72000000001,Bills, 
20-Jun-19,291.76,655927322,,INTER-BANK CREDIT,Harrison-Butler,-12044.96000000001,Uncategorised, 
22-Jun-19,-359.82,655927322,,AUTOMATIC DRAWING,Hines-Martinez,-12404.78000000001,Bills, 
24-Jun-19,-1115.28,655927322,,INTER-BANK CREDIT,Craig Riley and Hall,-13520.06000000001,Other Income, 
24-Jun-19,-1429.29,655927322,,INTER-BANK CREDIT,595276474396213 SANDERS GROUP ,-14949.35000000001,Bills, 
25-Jun-19,-1634.24,655927322,,AUTOMATIC DRAWING,Miller Saunders and Holmes,-16583.59000000001,Other Income, 
25-Jun-19,-1330.21,655927322,,INTER-BANK CREDIT,601921450825304 WATTS-STEWART ,-17913.80000000001,Other Income, 
26-Jun-19,1099.36,655927322,,INTER-BANK CREDIT,Horton-Buckley,-16814.44000000001,Other Income, 
28-Jun-19,-593.01,655927322,,INTER-BANK CREDIT,519412152397917 MALONE-BAKER ,-17407.450000000008,Uncategorised, 
01-Jul-19,618.64,655927322,,TRANSFER DEBIT,698978385303435 GUTIERREZ AND SONS ,-16788.81000000001,Other Income, 
02-Jul-19,196.87,655927322,,INTER-BANK CREDIT,232817670209805 GONZALEZ-ATKINSON ,-16591.94000000001,Bills, 
02-Jul-19,821.68,655927322,,AUTOMATIC DRAWING,Payne Williams and Warren,-15770.26000000001,Other Income, 
02-Jul-19,381.64,655927322,,INTER-BANK CREDIT,607899502409412 HILL MORRIS AND LAWRENCE ,-15388.62000000001,Bills, 
04-Jul-19,1265.74,655927322,,AUTOMATIC DRAWING,374551778787224 ABBOTT CAMPBELL AND GUTIERREZ ,-14122.88000000001,Other Income, 
05-Jul-19,-1295.87,655927322,,INTER-BANK CREDIT,557452891922908 WATTS-FOSTER ,-15418.750000000011,Other Income, 
06-Jul-19,-581.95,655927322,,INTER-BANK CREDIT,78747376059062 HALL-SHANNON ,-16000.700000000012,Bills, 
06-Jul-19,-1622.44,655927322,,INTER-BANK CREDIT,Larsen-Meyer,-17623.14000000001,Bills, 
09-Jul-19,1205.74,655927322,,INTER-BANK CREDIT,Miller and Sons,-16417.40000000001,Other Income, 
12-Jul-19,1440.49,655927322,,INTER-BANK CREDIT,646193542719707 LEE PLC ,-14976.910000000009,Other Income, 
13-Jul-19,1091.17,655927322,,AUTOMATIC DRAWING,Ruiz Miller and Mathews,-13885.740000000009,Other Income, 
13-Jul-19,-1450.32,655927322,,INTER-BANK CREDIT,Jennings-Jones,-15336.060000000009,Financial, 
16-Jul-19,151.63,655927322,,INTER-BANK CREDIT,Lee Inc,-15184.43000000001,Uncategorised, 
16-Jul-19,-1960.82,655927322,,TRANSFER DEBIT,King-Mccarthy,-17145.25000000001,Bills, 
17-Jul-19,-1056.06,655927322,,AUTOMATIC DRAWING,Jackson Ltd,-18201.310000000012,Uncategorised, 
20-Jul-19,-815.19,655927322,,TRANSFER DEBIT,991553495677499 BROWN FAULKNER AND HOPKINS ,-19016.50000000001,Bills, 
21-Jul-19,580.64,655927322,,AUTOMATIC DRAWING,41055514112795 FULLER AND SONS ,-18435.86000000001,Uncategorised, 
23-Jul-19,85.42,655927322,,AUTOMATIC DRAWING,Davis-Page,-18350.440000000013,Bills, 
25-Jul-19,-224.7,655927322,,INTER-BANK CREDIT,143696971497506 MORRIS-COLLINS ,-18575.140000000014,Uncategorised, 
26-Jul-19,-791.84,655927322,,INTER-BANK CREDIT,490709133179342 SMITH PLC ,-19366.980000000014,Financial, 
27-Jul-19,164.15,655927322,,AUTOMATIC DRAWING,Griffith PLC,-19202.830000000013,Bills, 
29-Jul-19,-1040.01,655927322,,INTER-BANK CREDIT,639202188868881 FERNANDEZ GATES AND LITTLE ,-20242.84000000001,Bills, 
30-Jul-19,1611.99,655927322,,TRANSFER DEBIT,Green Thomas and Kim,-18630.85000000001,Bills, 
31-Jul-19,75.01,655927322,,AUTOMATIC DRAWING,212220798603241 MORTON GROUP ,-18555.84000000001,Financial, 
02-Aug-19,-1805.62,655927322,,TRANSFER DEBIT,Hill Young and Mccoy,-20361.46000000001,Financial, 
02-Aug-19,1531.02,655927322,,INTER-BANK CREDIT,Hall Mooney and Wilson,-18830.44000000001,Financial, 
03-Aug-19,797.92,655927322,,AUTOMATIC DRAWING,587636664244245 ALEXANDER LTD ,-18032.52000000001,Financial, 
05-Aug-19,1536.89,655927322,,AUTOMATIC DRAWING,98375271575756 CHRISTIAN GROUP ,-16495.630000000012,Uncategorised, 
08-Aug-19,815.19,655927322,,AUTOMATIC DRAWING,967068280189195 GOODMAN-HUNT ,-15680.440000000011,Uncategorised, 
11-Aug-19,-963.99,655927322,,INTER-BANK CREDIT,718887228181050 MULLINS-MORAN ,-16644.43000000001,Other Income, 
