Date,Amount,Account Number,,Transaction Type,Transaction Details,Balance,Category,Merchant Name
28-Oct-15,80.15,564039237,,INTER-BANK CREDIT,824495581519093 HARPER MONTOYA AND WILLIAMS ,1281.0500000000002,Uncategorised, 
31-Oct-15,-115.93,564039237,,TRANSFER DEBIT,Miranda-Jennings,1165.1200000000001,Financial, 
01-Nov-15,1133.62,564039237,,AUTOMATIC DRAWING,Gallagher King and Johnson,2298.74,Bills, 
04-Nov-15,1170.87,564039237,,TRANSFER DEBIT,480871224418417 KANE LLC ,3469.6099999999997,Bills, 
06-Nov-15,1278.95,564039237,,AUTOMATIC DRAWING,Johnson-Carlson,4748.5599999999995,Financial, 
06-Nov-15,-1782.89,564039237,,TRANSFER DEBIT,Jenkins Salazar and Moore,2965.669999999999,Other Income, 
09-Nov-15,-36.0,564039237,,INTER-BANK CREDIT,653284505671425 HORTON INC ,2929.669999999999,Financial, 
10-Nov-15,-1400.46,564039237,,INTER-BANK CREDIT,Gonzalez-Day,1529.2099999999991,Other Income, 
12-Nov-15,-1906.96,564039237,,INTER-BANK CREDIT,725163041937968 LANG HARMON AND LEE ,-377.7500000000009,Financial, 
13-Nov-15,1026.9,564039237,,INTER-BANK CREDIT,656171057421479 MARTIN-JOYCE ,649.1499999999992,Other Income, 
15-Nov-15,1039.18,564039237,,TRANSFER DEBIT,815839085165282 JACOBS CARR AND MOORE ,1688.3299999999992,Other Income, 
17-Nov-15,-631.92,564039237,,TRANSFER DEBIT,689743654011768 SMITH GROUP ,1056.4099999999994,Bills, 
17-Nov-15,315.54,564039237,,INTER-BANK CREDIT,384038495582287 LIU-FROST ,1371.9499999999994,Financial, 
19-Nov-15,-1199.7,564039237,,AUTOMATIC DRAWING,703229522102529 KNIGHT WRIGHT AND AUSTIN ,172.24999999999932,Other Income, 
21-Nov-15,-901.9,564039237,,TRANSFER DEBIT,Cox-Smith,-729.6500000000007,Bills, 
23-Nov-15,-146.09,564039237,,AUTOMATIC DRAWING,Jimenez-Guzman,-875.7400000000007,Other Income, 
24-Nov-15,-1419.13,564039237,,INTER-BANK CREDIT,Cameron Leach and Bell,-2294.870000000001,Other Income, 
25-Nov-15,-1309.38,564039237,,TRANSFER DEBIT,Watson Inc,-3604.250000000001,Bills, 
25-Nov-15,-438.95,564039237,,INTER-BANK CREDIT,Jacobs PLC,-4043.2000000000007,Uncategorised, 
28-Nov-15,-707.14,564039237,,TRANSFER DEBIT,Lara LLC,-4750.340000000001,Bills, 
01-Dec-15,-1276.55,564039237,,AUTOMATIC DRAWING,Allen Hoffman and Burns,-6026.890000000001,Uncategorised, 
01-Dec-15,-1341.76,564039237,,INTER-BANK CREDIT,134630493013994 PROCTOR INC ,-7368.6500000000015,Bills, 
04-Dec-15,-364.15,564039237,,AUTOMATIC DRAWING,Gallagher-Berg,-7732.800000000001,Uncategorised, 
05-Dec-15,-936.32,564039237,,INTER-BANK CREDIT,Hamilton-Gonzalez,-8669.12,Financial, 
08-Dec-15,-1729.58,564039237,,TRANSFER DEBIT,984575611500362 BARTLETT FLYNN AND MULLINS ,-10398.7,Bills, 
08-Dec-15,-584.34,564039237,,AUTOMATIC DRAWING,Weber-Stanley,-10983.04,Uncategorised, 
11-Dec-15,619.44,564039237,,TRANSFER DEBIT,113148726548272 ALLEN GROUP ,-10363.6,Uncategorised, 
14-Dec-15,1867.43,564039237,,INTER-BANK CREDIT,842818481280028 BUSH GROUP ,-8496.17,Financial, 
14-Dec-15,839.07,564039237,,INTER-BANK CREDIT,Anderson Bright and Doyle,-7657.1,Financial, 
14-Dec-15,-1396.18,564039237,,TRANSFER DEBIT,662777344272948 ROBERTS WRIGHT AND BOWEN ,-9053.28,Other Income, 
16-Dec-15,174.39,564039237,,TRANSFER DEBIT,56408930504962 FREEMAN PLC ,-8878.890000000001,Bills, 
19-Dec-15,201.13,564039237,,INTER-BANK CREDIT,552598071141050 DAVIS MASON AND LIU ,-8677.760000000002,Uncategorised, 
21-Dec-15,287.53,564039237,,TRANSFER DEBIT,Reed Group,-8390.230000000001,Financial, 
23-Dec-15,-1204.23,564039237,,AUTOMATIC DRAWING,470392819633184 CARSON-RAMIREZ ,-9594.460000000001,Financial, 
23-Dec-15,92.0,564039237,,TRANSFER DEBIT,Torres Group,-9502.460000000001,Financial, 
23-Dec-15,1007.2,564039237,,TRANSFER DEBIT,991850341981545 MANN LTD ,-8495.26,Financial, 
23-Dec-15,-274.84,564039237,,INTER-BANK CREDIT,Spence Wilson and Boyd,-8770.1,Bills, 
24-Dec-15,1820.36,564039237,,INTER-BANK CREDIT,Harrington-Perez,-6949.740000000001,Financial, 
27-Dec-15,400.64,564039237,,INTER-BANK CREDIT,150633769648956 HALL LLC ,-6549.1,Financial, 
29-Dec-15,542.61,564039237,,TRANSFER DEBIT,Hahn Ltd,-6006.490000000001,Uncategorised, 
30-Dec-15,1054.7,564039237,,INTER-BANK CREDIT,Harris Lopez and Peterson,-4951.790000000001,Bills, 
30-Dec-15,1376.16,564039237,,AUTOMATIC DRAWING,451940423468299 AGUILAR GROUP ,-3575.630000000001,Bills, 
02-Jan-16,1011.9,564039237,,INTER-BANK CREDIT,Russell-Flynn,-2563.730000000001,Bills, 
04-Jan-16,1073.73,564039237,,TRANSFER DEBIT,Phillips Group,-1490.000000000001,Uncategorised, 
05-Jan-16,-863.74,564039237,,TRANSFER DEBIT,Smith Inc,-2353.7400000000007,Other Income, 
08-Jan-16,626.02,564039237,,AUTOMATIC DRAWING,Matthews-Burke,-1727.7200000000007,Other Income, 
11-Jan-16,386.81,564039237,,TRANSFER DEBIT,362169170696713 HILL INC ,-1340.9100000000008,Other Income, 
13-Jan-16,1881.43,564039237,,INTER-BANK CREDIT,733540690984270 ANDERSON-LEWIS ,540.5199999999993,Financial, 
14-Jan-16,-1321.15,564039237,,AUTOMATIC DRAWING,Huerta-Fuller,-780.6300000000008,Financial, 
14-Jan-16,678.13,564039237,,TRANSFER DEBIT,White PLC,-102.5000000000008,Other Income, 
16-Jan-16,211.6,564039237,,AUTOMATIC DRAWING,Bell-Figueroa,109.0999999999992,Financial, 
16-Jan-16,-1207.69,564039237,,TRANSFER DEBIT,849541015519131 LOVE GROUP ,-1098.5900000000008,Financial, 
16-Jan-16,-1399.69,564039237,,AUTOMATIC DRAWING,446400191362379 NELSON-MILLER ,-2498.2800000000007,Financial, 
17-Jan-16,-1635.58,564039237,,INTER-BANK CREDIT,Garcia Moran and Avery,-4133.860000000001,Bills, 
17-Jan-16,534.74,564039237,,TRANSFER DEBIT,679537340792542 YOUNG-CHARLES ,-3599.120000000001,Uncategorised, 
18-Jan-16,1111.04,564039237,,TRANSFER DEBIT,335648073916326 BOWMAN REED AND RODRIGUEZ ,-2488.080000000001,Uncategorised, 
21-Jan-16,1777.33,564039237,,TRANSFER DEBIT,803471415818118 FAULKNER LTD ,-710.7500000000009,Financial, 
22-Jan-16,-654.6,564039237,,INTER-BANK CREDIT,Owens Ltd,-1365.3500000000008,Other Income, 
22-Jan-16,-1869.08,564039237,,AUTOMATIC DRAWING,Carter-Gray,-3234.4300000000007,Bills, 
25-Jan-16,-365.47,564039237,,INTER-BANK CREDIT,Simmons-Harrison,-3599.9000000000005,Financial, 
25-Jan-16,-1768.57,564039237,,TRANSFER DEBIT,Bowman Lopez and Cooper,-5368.47,Uncategorised, 
28-Jan-16,1711.62,564039237,,INTER-BANK CREDIT,552442028072990 JONES INC ,-3656.8500000000004,Bills, 
29-Jan-16,29.19,564039237,,INTER-BANK CREDIT,Hoffman-Johnson,-3627.6600000000003,Uncategorised, 
29-Jan-16,1683.51,564039237,,TRANSFER DEBIT,Haynes-Hill,-1944.1500000000003,Financial, 
31-Jan-16,-1234.97,564039237,,TRANSFER DEBIT,77400410093849 MARTIN INC ,-3179.1200000000003,Financial, 
03-Feb-16,-1074.72,564039237,,INTER-BANK CREDIT,Johnson Pierce and Harper,-4253.84,Bills, 
03-Feb-16,-1314.94,564039237,,TRANSFER DEBIT,162406559387992 NELSON-CHAN ,-5568.780000000001,Other Income, 
04-Feb-16,1770.4,564039237,,TRANSFER DEBIT,585373065846230 JACOBSON INC ,-3798.3800000000006,Other Income, 
05-Feb-16,-56.45,564039237,,INTER-BANK CREDIT,Wiggins and Sons,-3854.8300000000004,Bills, 
05-Feb-16,1674.87,564039237,,INTER-BANK CREDIT,Walker Jefferson and Moore,-2179.9600000000005,Uncategorised, 
06-Feb-16,-150.56,564039237,,INTER-BANK CREDIT,623053095363082 WATSON LEWIS AND BAKER ,-2330.5200000000004,Financial, 
07-Feb-16,-989.67,564039237,,TRANSFER DEBIT,Bryan Ltd,-3320.1900000000005,Financial, 
09-Feb-16,-1121.81,564039237,,AUTOMATIC DRAWING,149381058819624 JONES-GRIFFITH ,-4442.0,Bills, 
09-Feb-16,1463.8,564039237,,INTER-BANK CREDIT,889965794657468 BEST FRAZIER AND MANN ,-2978.2,Other Income, 
10-Feb-16,-1261.3,564039237,,INTER-BANK CREDIT,540415295858801 SCHMITT SIMPSON AND GREEN ,-4239.5,Other Income, 
10-Feb-16,839.48,564039237,,TRANSFER DEBIT,98688025053647 MOYER-CLARKE ,-3400.02,Other Income, 
10-Feb-16,1346.99,564039237,,AUTOMATIC DRAWING,Bradley Group,-2053.0299999999997,Uncategorised, 
13-Feb-16,549.18,564039237,,INTER-BANK CREDIT,Lowe LLC,-1503.85,Uncategorised, 
15-Feb-16,-1736.87,564039237,,AUTOMATIC DRAWING,639966658716693 MARSHALL-SMITH ,-3240.72,Bills, 
16-Feb-16,-1244.68,564039237,,INTER-BANK CREDIT,Trujillo LLC,-4485.4,Financial, 
18-Feb-16,1045.43,564039237,,AUTOMATIC DRAWING,486863526038641 LIN-LANDRY ,-3439.9699999999993,Uncategorised, 
19-Feb-16,1481.35,564039237,,INTER-BANK CREDIT,309160258817486 WATERS LTD ,-1958.6199999999994,Uncategorised, 
21-Feb-16,-900.94,564039237,,INTER-BANK CREDIT,Hayes Group,-2859.5599999999995,Bills, 
22-Feb-16,-618.58,564039237,,TRANSFER DEBIT,Valencia Group,-3478.1399999999994,Financial, 
24-Feb-16,-1988.67,564039237,,AUTOMATIC DRAWING,571545480936276 TUCKER PLC ,-5466.8099999999995,Financial, 
25-Feb-16,-1669.81,564039237,,INTER-BANK CREDIT,838613251776931 WALSH MEDINA AND HAAS ,-7136.619999999999,Financial, 
28-Feb-16,365.9,564039237,,INTER-BANK CREDIT,711851685047493 SALAZAR-PIERCE ,-6770.719999999999,Bills, 
28-Feb-16,-1969.35,564039237,,AUTOMATIC DRAWING,7615475549068 WRIGHT-FREEMAN ,-8740.07,Bills, 
28-Feb-16,1400.2,564039237,,INTER-BANK CREDIT,Mcdowell-Peterson,-7339.87,Bills, 
29-Feb-16,458.12,564039237,,AUTOMATIC DRAWING,Williams-Mendez,-6881.75,Bills, 
01-Mar-16,877.06,564039237,,INTER-BANK CREDIT,Le and Sons,-6004.6900000000005,Financial, 
01-Mar-16,-303.97,564039237,,AUTOMATIC DRAWING,668100797760454 PIERCE-BASS ,-6308.660000000001,Uncategorised, 
02-Mar-16,-1924.33,564039237,,INTER-BANK CREDIT,Martinez-Wise,-8232.990000000002,Bills, 
02-Mar-16,-989.1,564039237,,INTER-BANK CREDIT,422937696182515 LUCAS FIGUEROA AND STANLEY ,-9222.090000000002,Uncategorised, 
05-Mar-16,-979.29,564039237,,TRANSFER DEBIT,584221868390282 FORD ALLEN AND PENNINGTON ,-10201.380000000001,Other Income, 
05-Mar-16,-222.17,564039237,,INTER-BANK CREDIT,Rogers and Sons,-10423.550000000001,Bills, 
07-Mar-16,631.14,564039237,,INTER-BANK CREDIT,Martin-Rosales,-9792.410000000002,Bills, 
09-Mar-16,-927.32,564039237,,AUTOMATIC DRAWING,677413392285043 WILSON-DAVIS ,-10719.730000000001,Uncategorised, 
10-Mar-16,-276.89,564039237,,AUTOMATIC DRAWING,334820513015674 STEWART INC ,-10996.62,Other Income, 
12-Mar-16,1664.78,564039237,,AUTOMATIC DRAWING,187705133579045 CANTU-BARNETT ,-9331.84,Other Income, 
13-Mar-16,-1087.6,564039237,,TRANSFER DEBIT,Johns Ltd,-10419.44,Bills, 
14-Mar-16,84.96,564039237,,INTER-BANK CREDIT,Mills-Reese,-10334.480000000001,Financial, 
14-Mar-16,1716.04,564039237,,TRANSFER DEBIT,Guzman-Gilmore,-8618.440000000002,Uncategorised, 
16-Mar-16,-458.88,564039237,,INTER-BANK CREDIT,207745576930884 PRICE CANNON AND DAY ,-9077.320000000002,Financial, 
19-Mar-16,-492.79,564039237,,AUTOMATIC DRAWING,Dougherty Esparza and Williams,-9570.110000000002,Uncategorised, 
21-Mar-16,503.78,564039237,,AUTOMATIC DRAWING,139268016433874 PRICE INC ,-9066.330000000002,Uncategorised, 
24-Mar-16,1425.74,564039237,,INTER-BANK CREDIT,Jackson Inc,-7640.590000000002,Other Income, 
27-Mar-16,1721.75,564039237,,INTER-BANK CREDIT,Harris Jones and Davis,-5918.840000000002,Financial, 
29-Mar-16,-119.42,564039237,,INTER-BANK CREDIT,631295917382763 SPENCE WILLIAMS AND WALKER ,-6038.260000000002,Uncategorised, 
31-Mar-16,685.86,564039237,,INTER-BANK CREDIT,Cook Torres and Thompson,-5352.400000000002,Uncategorised, 
31-Mar-16,-1353.08,564039237,,INTER-BANK CREDIT,644036306102043 JAMES ROSS AND TURNER ,-6705.480000000002,Uncategorised, 
01-Apr-16,-790.88,564039237,,TRANSFER DEBIT,Haley Group,-7496.360000000002,Other Income, 
03-Apr-16,1152.86,564039237,,AUTOMATIC DRAWING,405477697535939 RUSSELL MICHAEL AND THOMPSON ,-6343.500000000003,Other Income, 
03-Apr-16,-298.71,564039237,,INTER-BANK CREDIT,928210548513531 BLANCHARD GROUP ,-6642.210000000003,Bills, 
03-Apr-16,-1450.04,564039237,,AUTOMATIC DRAWING,713969579503397 BARRETT WATKINS AND MCKINNEY ,-8092.250000000003,Uncategorised, 
03-Apr-16,-1115.41,564039237,,INTER-BANK CREDIT,Boyle Group,-9207.660000000003,Uncategorised, 
05-Apr-16,-1953.42,564039237,,TRANSFER DEBIT,Delgado-Potter,-11161.080000000004,Financial, 
07-Apr-16,665.3,564039237,,AUTOMATIC DRAWING,Dominguez Ltd,-10495.780000000004,Bills, 
10-Apr-16,-1351.65,564039237,,AUTOMATIC DRAWING,29371324404302 MILLER AND SONS ,-11847.430000000004,Financial, 
12-Apr-16,-1438.03,564039237,,TRANSFER DEBIT,Williams Group,-13285.460000000005,Uncategorised, 
14-Apr-16,458.58,564039237,,INTER-BANK CREDIT,Moore Mercer and Rangel,-12826.880000000005,Other Income, 
16-Apr-16,202.96,564039237,,TRANSFER DEBIT,174699903855358 LEVY INC ,-12623.920000000006,Other Income, 
19-Apr-16,1163.92,564039237,,TRANSFER DEBIT,458307251850622 GARDNER-WILLIAMS ,-11460.000000000005,Uncategorised, 
20-Apr-16,1953.25,564039237,,TRANSFER DEBIT,Romero-Henderson,-9506.750000000005,Uncategorised, 
20-Apr-16,870.64,564039237,,AUTOMATIC DRAWING,625691535768602 JOHNSON RITTER AND JOHNSON ,-8636.110000000006,Uncategorised, 
23-Apr-16,-871.55,564039237,,INTER-BANK CREDIT,Figueroa-Tate,-9507.660000000005,Financial, 
24-Apr-16,1441.9,564039237,,TRANSFER DEBIT,Montgomery Davis and Duke,-8065.760000000006,Bills, 
24-Apr-16,-976.21,564039237,,AUTOMATIC DRAWING,766374098459724 CASTILLO-NEWMAN ,-9041.970000000005,Uncategorised, 
26-Apr-16,316.62,564039237,,INTER-BANK CREDIT,991120965294328 JAMES-PERRY ,-8725.350000000004,Bills, 
27-Apr-16,-202.51,564039237,,AUTOMATIC DRAWING,497110228726370 KAISER DECKER AND CLARK ,-8927.860000000004,Bills, 
29-Apr-16,1689.73,564039237,,TRANSFER DEBIT,Daniel Acosta and Gill,-7238.130000000005,Bills, 
30-Apr-16,1903.58,564039237,,AUTOMATIC DRAWING,573885258724314 THOMPSON FLORES AND CAMPOS ,-5334.550000000005,Other Income, 
02-May-16,-554.67,564039237,,INTER-BANK CREDIT,Mcmillan-Jacobson,-5889.220000000005,Uncategorised, 
02-May-16,1260.3,564039237,,AUTOMATIC DRAWING,Brown Miller and Miles,-4628.920000000005,Uncategorised, 
04-May-16,-1184.6,564039237,,AUTOMATIC DRAWING,467739294118305 JONES GROUP ,-5813.520000000004,Uncategorised, 
07-May-16,-1935.38,564039237,,INTER-BANK CREDIT,976498401272166 SILVA INC ,-7748.900000000004,Bills, 
10-May-16,-1699.12,564039237,,TRANSFER DEBIT,778321044396594 PALMER LLC ,-9448.020000000004,Other Income, 
11-May-16,-327.98,564039237,,AUTOMATIC DRAWING,92361306996047 GARNER-FLETCHER ,-9776.000000000004,Bills, 
13-May-16,-429.85,564039237,,TRANSFER DEBIT,Peterson Group,-10205.850000000004,Financial, 
15-May-16,-1058.39,564039237,,TRANSFER DEBIT,981052547990443 ANDREWS-REID ,-11264.240000000003,Other Income, 
15-May-16,-391.64,564039237,,INTER-BANK CREDIT,Maldonado PLC,-11655.880000000003,Uncategorised, 
18-May-16,650.24,564039237,,AUTOMATIC DRAWING,Murphy Ltd,-11005.640000000003,Uncategorised, 
18-May-16,82.01,564039237,,TRANSFER DEBIT,573484434637831 RAMOS LTD ,-10923.630000000003,Uncategorised, 
20-May-16,-1894.16,564039237,,INTER-BANK CREDIT,983801548495285 JOHNSON PLC ,-12817.790000000003,Financial, 
22-May-16,-264.19,564039237,,AUTOMATIC DRAWING,Ross Group,-13081.980000000003,Financial, 
22-May-16,848.95,564039237,,INTER-BANK CREDIT,909111230633827 GOODMAN-BARRETT ,-12233.030000000002,Other Income, 
24-May-16,-1849.28,564039237,,INTER-BANK CREDIT,Raymond and Sons,-14082.310000000003,Uncategorised, 
27-May-16,-395.33,564039237,,AUTOMATIC DRAWING,856156209327756 THOMAS LLC ,-14477.640000000003,Financial, 
30-May-16,-1190.14,564039237,,INTER-BANK CREDIT,672131532318687 SMITH-MILLER ,-15667.780000000002,Financial, 
01-Jun-16,-23.74,564039237,,AUTOMATIC DRAWING,Cochran-Lynn,-15691.520000000002,Financial, 
01-Jun-16,1742.31,564039237,,TRANSFER DEBIT,Miller Olson and Gonzalez,-13949.210000000003,Other Income, 
04-Jun-16,1077.32,564039237,,INTER-BANK CREDIT,531866705175672 GIBSON-KELLEY ,-12871.890000000003,Other Income, 
06-Jun-16,1864.89,564039237,,TRANSFER DEBIT,Cain-Ross,-11007.000000000004,Bills, 
08-Jun-16,-753.6,564039237,,TRANSFER DEBIT,Wilson Inc,-11760.600000000004,Uncategorised, 
09-Jun-16,1591.62,564039237,,AUTOMATIC DRAWING,Kline Gamble and Allen,-10168.980000000003,Financial, 
09-Jun-16,1327.56,564039237,,INTER-BANK CREDIT,454183898439322 WRIGHT-BOWMAN ,-8841.420000000004,Other Income, 
09-Jun-16,-1960.47,564039237,,INTER-BANK CREDIT,Ford Clark and Moore,-10801.890000000003,Uncategorised, 
09-Jun-16,1217.47,564039237,,INTER-BANK CREDIT,840738726292137 HUANG PLC ,-9584.420000000004,Uncategorised, 
11-Jun-16,-1314.42,564039237,,TRANSFER DEBIT,238454319204849 SHAH JARVIS AND NEWMAN ,-10898.840000000004,Bills, 
12-Jun-16,1525.13,564039237,,INTER-BANK CREDIT,Barker-Harvey,-9373.710000000003,Uncategorised, 
13-Jun-16,1345.99,564039237,,INTER-BANK CREDIT,194704120863534 VARGAS-TORRES ,-8027.720000000003,Bills, 
13-Jun-16,-187.32,564039237,,INTER-BANK CREDIT,Pineda Inc,-8215.040000000003,Other Income, 
14-Jun-16,-1614.42,564039237,,INTER-BANK CREDIT,413111780159649 MOORE PLC ,-9829.460000000003,Uncategorised, 
14-Jun-16,-1889.89,564039237,,INTER-BANK CREDIT,Arnold Cummings and Young,-11719.350000000002,Bills, 
16-Jun-16,1701.55,564039237,,INTER-BANK CREDIT,120923554318260 WALKER INC ,-10017.800000000003,Financial, 
17-Jun-16,140.92,564039237,,INTER-BANK CREDIT,Barker Neal and Peters,-9876.880000000003,Financial, 
18-Jun-16,-1414.0,564039237,,AUTOMATIC DRAWING,415582463413231 WILSON MCDANIEL AND GIBSON ,-11290.880000000003,Financial, 
21-Jun-16,27.27,564039237,,INTER-BANK CREDIT,Alexander Hicks and Bolton,-11263.610000000002,Other Income, 
21-Jun-16,1187.77,564039237,,AUTOMATIC DRAWING,15891868913331 HALL LOPEZ AND KING ,-10075.840000000002,Other Income, 
23-Jun-16,-1234.91,564039237,,AUTOMATIC DRAWING,Riley Ltd,-11310.750000000002,Bills, 
25-Jun-16,-1785.77,564039237,,INTER-BANK CREDIT,38662468404035 JOHNSON-BROWN ,-13096.520000000002,Other Income, 
27-Jun-16,1347.75,564039237,,TRANSFER DEBIT,80175695479608 CARNEY-JOHNSON ,-11748.770000000002,Bills, 
30-Jun-16,269.55,564039237,,TRANSFER DEBIT,253176919236029 NGUYEN-JOHNSON ,-11479.220000000003,Financial, 
02-Jul-16,-1318.89,564039237,,INTER-BANK CREDIT,200044539971245 PAUL-FRANKLIN ,-12798.110000000002,Uncategorised, 
05-Jul-16,535.73,564039237,,TRANSFER DEBIT,Peters-Baker,-12262.380000000003,Bills, 
06-Jul-16,1842.9,564039237,,TRANSFER DEBIT,Phillips Inc,-10419.480000000003,Uncategorised, 
07-Jul-16,1100.24,564039237,,TRANSFER DEBIT,Moore-Solomon,-9319.240000000003,Financial, 
08-Jul-16,-1684.9,564039237,,AUTOMATIC DRAWING,Santiago-Taylor,-11004.140000000003,Uncategorised, 
08-Jul-16,369.41,564039237,,TRANSFER DEBIT,151555989365475 CARDENAS YOUNG AND LUTZ ,-10634.730000000003,Financial, 
10-Jul-16,189.57,564039237,,AUTOMATIC DRAWING,Lyons Group,-10445.160000000003,Bills, 
13-Jul-16,-991.67,564039237,,INTER-BANK CREDIT,David-Singh,-11436.830000000004,Uncategorised, 
13-Jul-16,-1515.77,564039237,,INTER-BANK CREDIT,156898434009147 FERGUSON SMITH AND KELLER ,-12952.600000000004,Other Income, 
14-Jul-16,82.97,564039237,,INTER-BANK CREDIT,Smith Klein and Holmes,-12869.630000000005,Other Income, 
14-Jul-16,1519.53,564039237,,INTER-BANK CREDIT,296047306710561 KRUEGER PLC ,-11350.100000000004,Other Income, 
16-Jul-16,578.17,564039237,,AUTOMATIC DRAWING,776075407411762 RIVERA ARCHER AND POWELL ,-10771.930000000004,Uncategorised, 
19-Jul-16,104.87,564039237,,INTER-BANK CREDIT,Smith LLC,-10667.060000000003,Bills, 
22-Jul-16,1789.72,564039237,,INTER-BANK CREDIT,Atkinson LLC,-8877.340000000004,Bills, 
25-Jul-16,1971.26,564039237,,INTER-BANK CREDIT,Hanson Ltd,-6906.080000000004,Financial, 
28-Jul-16,84.87,564039237,,INTER-BANK CREDIT,606367569152574 HARRELL HOWELL AND WHITE ,-6821.210000000004,Uncategorised, 
28-Jul-16,-632.22,564039237,,INTER-BANK CREDIT,600027555195029 YOUNG ELLIS AND BRYANT ,-7453.430000000004,Bills, 
28-Jul-16,1424.1,564039237,,AUTOMATIC DRAWING,Mcdaniel Ltd,-6029.330000000004,Other Income, 
28-Jul-16,61.62,564039237,,AUTOMATIC DRAWING,Anderson-Ellis,-5967.710000000004,Other Income, 
31-Jul-16,-67.45,564039237,,INTER-BANK CREDIT,Gonzalez-Howard,-6035.1600000000035,Other Income, 
31-Jul-16,334.97,564039237,,AUTOMATIC DRAWING,Jones Group,-5700.190000000003,Uncategorised, 
01-Aug-16,1162.65,564039237,,INTER-BANK CREDIT,Reese-Charles,-4537.540000000003,Financial, 
04-Aug-16,1999.94,564039237,,INTER-BANK CREDIT,413557522642650 JOHNSON AND SONS ,-2537.6000000000026,Bills, 
05-Aug-16,433.85,564039237,,INTER-BANK CREDIT,930800080071193 ODONNELL BRYANT AND BAKER ,-2103.7500000000027,Other Income, 
06-Aug-16,-63.37,564039237,,TRANSFER DEBIT,622749831679078 SHAFFER-VEGA ,-2167.1200000000026,Uncategorised, 
09-Aug-16,-909.96,564039237,,INTER-BANK CREDIT,439711497694898 TAYLOR CARROLL AND MORRISON ,-3077.0800000000027,Bills, 
09-Aug-16,186.67,564039237,,TRANSFER DEBIT,Johnson Ellis and Anderson,-2890.4100000000026,Financial, 
12-Aug-16,1578.16,564039237,,AUTOMATIC DRAWING,Perry Ltd,-1312.2500000000025,Bills, 
13-Aug-16,-45.63,564039237,,AUTOMATIC DRAWING,Kim Stewart and Roberts,-1357.8800000000026,Bills, 
14-Aug-16,-1896.22,564039237,,AUTOMATIC DRAWING,Mccall Ltd,-3254.1000000000026,Uncategorised, 
14-Aug-16,-772.4,564039237,,INTER-BANK CREDIT,134622726808838 SWEENEY MARTINEZ AND KEMP ,-4026.5000000000027,Uncategorised, 
15-Aug-16,1292.96,564039237,,INTER-BANK CREDIT,Lopez-Ruiz,-2733.5400000000027,Uncategorised, 
17-Aug-16,1335.28,564039237,,INTER-BANK CREDIT,Harris Johnson and Snyder,-1398.2600000000027,Bills, 
18-Aug-16,-208.56,564039237,,INTER-BANK CREDIT,977578282388069 WEST PLC ,-1606.8200000000027,Financial, 
18-Aug-16,-439.36,564039237,,INTER-BANK CREDIT,623239944223390 GREEN JOHNSON AND SMITH ,-2046.1800000000026,Uncategorised, 
20-Aug-16,1350.3,564039237,,AUTOMATIC DRAWING,Roberts-Smith,-695.8800000000026,Other Income, 
20-Aug-16,32.53,564039237,,INTER-BANK CREDIT,190872007856327 BOYD-GUTIERREZ ,-663.3500000000026,Financial, 
22-Aug-16,-1358.93,564039237,,AUTOMATIC DRAWING,678006800962978 MURRAY LTD ,-2022.2800000000027,Financial, 
25-Aug-16,-1611.04,564039237,,TRANSFER DEBIT,Faulkner Henderson and Myers,-3633.3200000000024,Other Income, 
25-Aug-16,-97.03,564039237,,INTER-BANK CREDIT,Hopkins Wong and Allen,-3730.3500000000026,Financial, 
26-Aug-16,-354.77,564039237,,INTER-BANK CREDIT,533465610346293 GARDNER PLC ,-4085.1200000000026,Other Income, 
29-Aug-16,1101.05,564039237,,TRANSFER DEBIT,Wilson and Sons,-2984.0700000000024,Other Income, 
29-Aug-16,-1332.55,564039237,,INTER-BANK CREDIT,Taylor Brown and Collins,-4316.620000000003,Financial, 
01-Sep-16,99.8,564039237,,INTER-BANK CREDIT,59875248105541 GRAVES LTD ,-4216.820000000002,Financial, 
02-Sep-16,-515.27,564039237,,TRANSFER DEBIT,Chambers Moore and Mosley,-4732.090000000002,Other Income, 
05-Sep-16,1505.28,564039237,,AUTOMATIC DRAWING,Morgan LLC,-3226.810000000002,Other Income, 
06-Sep-16,265.43,564039237,,INTER-BANK CREDIT,346106130719253 SANCHEZ SKINNER AND ZIMMERMAN ,-2961.3800000000024,Uncategorised, 
06-Sep-16,-1867.24,564039237,,TRANSFER DEBIT,612972276270503 ESTRADA-ROLLINS ,-4828.620000000003,Bills, 
07-Sep-16,1740.51,564039237,,AUTOMATIC DRAWING,Bowman Inc,-3088.1100000000024,Uncategorised, 
07-Sep-16,-1362.12,564039237,,INTER-BANK CREDIT,Molina Lewis and Miller,-4450.230000000002,Other Income, 
10-Sep-16,805.01,564039237,,INTER-BANK CREDIT,Duran-Evans,-3645.220000000002,Financial, 
10-Sep-16,-852.61,564039237,,AUTOMATIC DRAWING,823064337498430 ESCOBAR CHEN AND GARCIA ,-4497.830000000002,Bills, 
10-Sep-16,1249.45,564039237,,TRANSFER DEBIT,896658851932502 HOWARD-FITZGERALD ,-3248.380000000002,Other Income, 
11-Sep-16,-1971.15,564039237,,INTER-BANK CREDIT,945770237788328 HARDY BROWN AND PENA ,-5219.5300000000025,Financial, 
13-Sep-16,121.37,564039237,,INTER-BANK CREDIT,Bolton Beard and Butler,-5098.160000000003,Other Income, 
13-Sep-16,-231.3,564039237,,TRANSFER DEBIT,Sanders Inc,-5329.460000000003,Bills, 
13-Sep-16,323.39,564039237,,INTER-BANK CREDIT,Thompson-Anthony,-5006.070000000002,Financial, 
14-Sep-16,1057.68,564039237,,INTER-BANK CREDIT,739213611924000 OLIVER LLC ,-3948.390000000002,Uncategorised, 
14-Sep-16,1051.33,564039237,,AUTOMATIC DRAWING,Cameron-Collier,-2897.060000000002,Bills, 
14-Sep-16,1837.33,564039237,,INTER-BANK CREDIT,Hoffman Hoffman and Caldwell,-1059.7300000000023,Bills, 
15-Sep-16,1314.27,564039237,,INTER-BANK CREDIT,Williams Ltd,254.5399999999977,Financial, 
16-Sep-16,-390.05,564039237,,AUTOMATIC DRAWING,Flowers and Sons,-135.51000000000232,Uncategorised, 
16-Sep-16,-1521.42,564039237,,INTER-BANK CREDIT,847066664480267 BROWN BISHOP AND LOPEZ ,-1656.9300000000023,Bills, 
19-Sep-16,1250.18,564039237,,INTER-BANK CREDIT,Humphrey Gonzales and Collins,-406.7500000000023,Financial, 
21-Sep-16,1142.1,564039237,,AUTOMATIC DRAWING,Mcdaniel Camacho and Pierce,735.3499999999976,Financial, 
23-Sep-16,49.1,564039237,,TRANSFER DEBIT,Vaughn Ltd,784.4499999999977,Bills, 
25-Sep-16,-1495.02,564039237,,TRANSFER DEBIT,Williams LLC,-710.5700000000023,Financial, 
27-Sep-16,-417.06,564039237,,AUTOMATIC DRAWING,403680353277175 CHAPMAN INC ,-1127.6300000000024,Bills, 
30-Sep-16,-1111.53,564039237,,INTER-BANK CREDIT,Burke-Murray,-2239.1600000000026,Bills, 
03-Oct-16,1456.47,564039237,,AUTOMATIC DRAWING,Gibbs PLC,-782.6900000000026,Other Income, 
05-Oct-16,321.48,564039237,,INTER-BANK CREDIT,Ramirez LLC,-461.21000000000254,Bills, 
05-Oct-16,-1857.07,564039237,,TRANSFER DEBIT,169380801008148 JOHNSON INC ,-2318.2800000000025,Bills, 
06-Oct-16,232.78,564039237,,TRANSFER DEBIT,Solis-Weaver,-2085.5000000000023,Financial, 
08-Oct-16,554.05,564039237,,INTER-BANK CREDIT,King Hoffman and Butler,-1531.4500000000023,Uncategorised, 
09-Oct-16,957.21,564039237,,AUTOMATIC DRAWING,Dyer LLC,-574.2400000000023,Bills, 
11-Oct-16,-507.8,564039237,,INTER-BANK CREDIT,Coleman Hurley and Thomas,-1082.0400000000022,Financial, 
11-Oct-16,-287.16,564039237,,INTER-BANK CREDIT,610476794669087 SULLIVAN RAYMOND AND CLARK ,-1369.2000000000023,Bills, 
14-Oct-16,-746.25,564039237,,AUTOMATIC DRAWING,69821917881988 BROWN KING AND JOHNSON ,-2115.4500000000025,Uncategorised, 
16-Oct-16,-581.26,564039237,,AUTOMATIC DRAWING,Lopez-Campos,-2696.7100000000028,Financial, 
19-Oct-16,299.0,564039237,,TRANSFER DEBIT,927333529734762 MARTINEZ-COCHRAN ,-2397.7100000000028,Financial, 
20-Oct-16,124.73,564039237,,INTER-BANK CREDIT,247963852306184 REYES-HERNANDEZ ,-2272.9800000000027,Bills, 
23-Oct-16,-564.12,564039237,,TRANSFER DEBIT,Mitchell Thompson and Jackson,-2837.1000000000026,Uncategorised, 
24-Oct-16,-688.68,564039237,,INTER-BANK CREDIT,Thomas LLC,-3525.7800000000025,Other Income, 
26-Oct-16,-1768.63,564039237,,TRANSFER DEBIT,Palmer Thompson and Michael,-5294.410000000003,Bills, 
29-Oct-16,1643.19,564039237,,INTER-BANK CREDIT,999429656347096 MILLER-ROGERS ,-3651.2200000000025,Other Income, 
01-Nov-16,-1216.82,564039237,,AUTOMATIC DRAWING,130875108119778 PIERCE LTD ,-4868.040000000003,Uncategorised, 
04-Nov-16,-439.45,564039237,,INTER-BANK CREDIT,Dougherty Griffin and Palmer,-5307.4900000000025,Bills, 
07-Nov-16,834.61,564039237,,TRANSFER DEBIT,114151775962565 HARRIS AND SONS ,-4472.880000000003,Uncategorised, 
10-Nov-16,-1158.88,564039237,,INTER-BANK CREDIT,Morgan-Cook,-5631.760000000003,Other Income, 
11-Nov-16,228.23,564039237,,TRANSFER DEBIT,988175279645564 JOHNSTON GARDNER AND EVANS ,-5403.530000000003,Uncategorised, 
13-Nov-16,398.75,564039237,,INTER-BANK CREDIT,790801820811439 HANSEN-ROBERTSON ,-5004.780000000003,Uncategorised, 
13-Nov-16,1750.66,564039237,,INTER-BANK CREDIT,Kelly Santana and Brooks,-3254.1200000000035,Bills, 
14-Nov-16,-321.07,564039237,,INTER-BANK CREDIT,375061602538044 PRICE LLC ,-3575.1900000000037,Other Income, 
15-Nov-16,1208.44,564039237,,INTER-BANK CREDIT,196825241614225 AVILA LLC ,-2366.7500000000036,Other Income, 
16-Nov-16,1501.01,564039237,,AUTOMATIC DRAWING,Salas Group,-865.7400000000036,Bills, 
18-Nov-16,-769.54,564039237,,INTER-BANK CREDIT,110122631487773 FULLER AND SONS ,-1635.2800000000036,Uncategorised, 
21-Nov-16,232.3,564039237,,INTER-BANK CREDIT,Andrade-Hogan,-1402.9800000000037,Financial, 
21-Nov-16,-1121.61,564039237,,INTER-BANK CREDIT,727547142654326 LEBLANC AND SONS ,-2524.590000000004,Bills, 
24-Nov-16,-948.93,564039237,,AUTOMATIC DRAWING,9574312111758 NORRIS NORMAN AND CANNON ,-3473.5200000000036,Bills, 
25-Nov-16,830.07,564039237,,INTER-BANK CREDIT,294710597538337 POTTER GROUP ,-2643.4500000000035,Financial, 
27-Nov-16,1303.39,564039237,,INTER-BANK CREDIT,Sharp Ltd,-1340.0600000000034,Other Income, 
28-Nov-16,-1024.12,564039237,,INTER-BANK CREDIT,Wood Jimenez and Hobbs,-2364.180000000003,Other Income, 
01-Dec-16,-692.21,564039237,,AUTOMATIC DRAWING,Dean LLC,-3056.390000000003,Financial, 
02-Dec-16,895.79,564039237,,AUTOMATIC DRAWING,324698473634240 ANDERSON TORRES AND CANTU ,-2160.600000000003,Other Income, 
05-Dec-16,1088.13,564039237,,INTER-BANK CREDIT,Patel Group,-1072.470000000003,Financial, 
05-Dec-16,879.58,564039237,,AUTOMATIC DRAWING,Brown Bennett and Bennett,-192.89000000000294,Uncategorised, 
08-Dec-16,-1347.93,564039237,,INTER-BANK CREDIT,585998563001619 HOWARD RICHARDSON AND BARR ,-1540.820000000003,Bills, 
10-Dec-16,-141.92,564039237,,TRANSFER DEBIT,636170123210369 WILLIAMS INC ,-1682.740000000003,Bills, 
10-Dec-16,894.62,564039237,,TRANSFER DEBIT,961951840854522 RICE ACOSTA AND WHEELER ,-788.120000000003,Bills, 
12-Dec-16,-1969.34,564039237,,TRANSFER DEBIT,Russell Dean and Silva,-2757.4600000000028,Financial, 
15-Dec-16,-695.84,564039237,,INTER-BANK CREDIT,523959884015447 JENSEN GROUP ,-3453.300000000003,Financial, 
15-Dec-16,-1461.98,564039237,,AUTOMATIC DRAWING,663184852737188 BOOTH GROUP ,-4915.2800000000025,Uncategorised, 
18-Dec-16,216.69,564039237,,INTER-BANK CREDIT,827269081692582 ORTEGA LTD ,-4698.590000000003,Bills, 
21-Dec-16,690.73,564039237,,INTER-BANK CREDIT,948854440865882 CLARK-BARNETT ,-4007.860000000003,Other Income, 
24-Dec-16,-144.67,564039237,,INTER-BANK CREDIT,488299271470395 KOCH GROUP ,-4152.5300000000025,Other Income, 
25-Dec-16,-136.89,564039237,,INTER-BANK CREDIT,Perry Ltd,-4289.420000000003,Other Income, 
25-Dec-16,-1509.51,564039237,,AUTOMATIC DRAWING,Martin-Taylor,-5798.930000000003,Uncategorised, 
28-Dec-16,-588.97,564039237,,TRANSFER DEBIT,Hale Inc,-6387.900000000003,Bills, 
31-Dec-16,356.53,564039237,,TRANSFER DEBIT,698622043030138 BRYANT-HEATH ,-6031.3700000000035,Financial, 
02-Jan-17,697.77,564039237,,INTER-BANK CREDIT,Johnson-Duarte,-5333.600000000004,Bills, 
03-Jan-17,-1730.18,564039237,,INTER-BANK CREDIT,Grant-White,-7063.780000000004,Bills, 
05-Jan-17,1795.31,564039237,,AUTOMATIC DRAWING,Martin Duarte and Deleon,-5268.470000000005,Bills, 
06-Jan-17,1008.91,564039237,,INTER-BANK CREDIT,Jackson Inc,-4259.560000000005,Financial, 
06-Jan-17,1009.19,564039237,,INTER-BANK CREDIT,725096121789568 PRICE LTD ,-3250.370000000005,Uncategorised, 
09-Jan-17,590.37,564039237,,AUTOMATIC DRAWING,944886601433911 MANNING-CLARKE ,-2660.000000000005,Financial, 
10-Jan-17,-363.0,564039237,,INTER-BANK CREDIT,Gonzales-Harris,-3023.000000000005,Other Income, 
10-Jan-17,1382.6,564039237,,INTER-BANK CREDIT,270075867356233 PERRY INC ,-1640.400000000005,Bills, 
11-Jan-17,1361.58,564039237,,AUTOMATIC DRAWING,Bright PLC,-278.82000000000517,Bills, 
14-Jan-17,1068.5,564039237,,INTER-BANK CREDIT,574108521733273 WARREN-HALL ,789.6799999999948,Uncategorised, 
14-Jan-17,223.44,564039237,,INTER-BANK CREDIT,Martin-Martinez,1013.1199999999949,Bills, 
17-Jan-17,59.86,564039237,,INTER-BANK CREDIT,Vasquez Spencer and Ramirez,1072.9799999999948,Other Income, 
17-Jan-17,1886.39,564039237,,AUTOMATIC DRAWING,430911860790683 HENDERSON GROUP ,2959.369999999995,Uncategorised, 
18-Jan-17,-328.74,564039237,,INTER-BANK CREDIT,629258607525594 LEACH LTD ,2630.6299999999947,Financial, 
20-Jan-17,-1707.2,564039237,,INTER-BANK CREDIT,964958729633797 BARAJAS CHANG AND DAVIS ,923.4299999999946,Other Income, 
23-Jan-17,-1487.18,564039237,,INTER-BANK CREDIT,Martinez-James,-563.7500000000055,Financial, 
23-Jan-17,-939.69,564039237,,AUTOMATIC DRAWING,920880864254735 STOKES AND SONS ,-1503.4400000000055,Bills, 
23-Jan-17,-1459.02,564039237,,INTER-BANK CREDIT,188982872998282 WILLIAMS LLC ,-2962.4600000000055,Financial, 
23-Jan-17,155.77,564039237,,INTER-BANK CREDIT,Garcia Ltd,-2806.6900000000055,Uncategorised, 
25-Jan-17,675.43,564039237,,TRANSFER DEBIT,1089466727896 TAYLOR-JONES ,-2131.2600000000057,Other Income, 
25-Jan-17,1501.03,564039237,,TRANSFER DEBIT,Moore PLC,-630.2300000000057,Uncategorised, 
26-Jan-17,474.45,564039237,,INTER-BANK CREDIT,Sanchez PLC,-155.7800000000057,Uncategorised, 
27-Jan-17,1692.28,564039237,,AUTOMATIC DRAWING,631022030795349 KIRBY PLC ,1536.4999999999943,Bills, 
28-Jan-17,623.92,564039237,,AUTOMATIC DRAWING,Peck PLC,2160.419999999994,Other Income, 
29-Jan-17,1271.24,564039237,,INTER-BANK CREDIT,Watson and Sons,3431.6599999999944,Other Income, 
01-Feb-17,-883.78,564039237,,TRANSFER DEBIT,Davis Rodriguez and Monroe,2547.8799999999947,Other Income, 
01-Feb-17,-464.0,564039237,,TRANSFER DEBIT,223613180905976 FLOWERS INC ,2083.8799999999947,Financial, 
04-Feb-17,402.57,564039237,,INTER-BANK CREDIT,219748795187413 BARRON PLC ,2486.449999999995,Uncategorised, 
04-Feb-17,-1824.04,564039237,,TRANSFER DEBIT,944402857715626 BELL JONES AND SMITH ,662.4099999999949,Financial, 
04-Feb-17,1030.95,564039237,,INTER-BANK CREDIT,876365715494990 RIVERA-MILLS ,1693.359999999995,Other Income, 
07-Feb-17,37.96,564039237,,INTER-BANK CREDIT,51570021788865 ONEAL-GIBSON ,1731.319999999995,Uncategorised, 
10-Feb-17,572.49,564039237,,INTER-BANK CREDIT,279951669921782 SNYDER HAYNES AND GROSS ,2303.809999999995,Uncategorised, 
11-Feb-17,118.02,564039237,,INTER-BANK CREDIT,Griffin PLC,2421.829999999995,Financial, 
13-Feb-17,-366.91,564039237,,INTER-BANK CREDIT,Gutierrez Group,2054.919999999995,Other Income, 
15-Feb-17,0.72,564039237,,INTER-BANK CREDIT,Kim-Adams,2055.639999999995,Other Income, 
17-Feb-17,-1707.92,564039237,,AUTOMATIC DRAWING,315137481630757 RODRIGUEZ LEE AND MORGAN ,347.7199999999948,Other Income, 
20-Feb-17,1727.51,564039237,,INTER-BANK CREDIT,307078022412789 ROSE-THORNTON ,2075.229999999995,Other Income, 
21-Feb-17,416.26,564039237,,INTER-BANK CREDIT,Franklin Group,2491.4899999999952,Uncategorised, 
21-Feb-17,-961.71,564039237,,INTER-BANK CREDIT,Hughes-Baird,1529.7799999999952,Uncategorised, 
22-Feb-17,805.54,564039237,,AUTOMATIC DRAWING,881505425581695 ROBBINS-PITTS ,2335.319999999995,Other Income, 
23-Feb-17,1642.19,564039237,,INTER-BANK CREDIT,750413652943416 JONES-HUMPHREY ,3977.509999999995,Financial, 
24-Feb-17,103.17,564039237,,INTER-BANK CREDIT,Conrad-Colon,4080.6799999999953,Bills, 
25-Feb-17,-1557.08,564039237,,AUTOMATIC DRAWING,473037924077153 WILLIAMS MURPHY AND MURRAY ,2523.5999999999954,Uncategorised, 
25-Feb-17,975.14,564039237,,INTER-BANK CREDIT,Collins Kirby and Wheeler,3498.7399999999952,Other Income, 
28-Feb-17,847.93,564039237,,AUTOMATIC DRAWING,818952653346697 MARTINEZ HOOVER AND THOMPSON ,4346.6699999999955,Other Income, 
02-Mar-17,1000.37,564039237,,AUTOMATIC DRAWING,925907290297481 MITCHELL LTD ,5347.039999999995,Uncategorised, 
02-Mar-17,-821.53,564039237,,TRANSFER DEBIT,Butler Inc,4525.509999999996,Uncategorised, 
02-Mar-17,46.24,564039237,,TRANSFER DEBIT,961206944324256 LITTLE INC ,4571.749999999995,Other Income, 
03-Mar-17,399.34,564039237,,INTER-BANK CREDIT,907150416027553 MCCLAIN ALLEN AND WALKER ,4971.089999999996,Uncategorised, 
03-Mar-17,-1766.71,564039237,,AUTOMATIC DRAWING,967212261497614 CHANDLER-WHITE ,3204.3799999999956,Uncategorised, 
03-Mar-17,1907.65,564039237,,AUTOMATIC DRAWING,850991233971531 GRAHAM PLC ,5112.029999999995,Financial, 
04-Mar-17,638.87,564039237,,INTER-BANK CREDIT,Miles PLC,5750.899999999995,Other Income, 
07-Mar-17,567.73,564039237,,AUTOMATIC DRAWING,748994548362778 WRIGHT-KLINE ,6318.629999999996,Bills, 
09-Mar-17,34.79,564039237,,AUTOMATIC DRAWING,76181889719668 BAILEY KEMP AND MORTON ,6353.4199999999955,Uncategorised, 
11-Mar-17,-257.28,564039237,,INTER-BANK CREDIT,Nixon Bryan and Willis,6096.139999999996,Bills, 
14-Mar-17,-1366.24,564039237,,AUTOMATIC DRAWING,Taylor and Sons,4729.899999999996,Other Income, 
15-Mar-17,1260.95,564039237,,TRANSFER DEBIT,Beasley Ltd,5990.849999999996,Bills, 
16-Mar-17,-867.8,564039237,,INTER-BANK CREDIT,Ramsey-Jackson,5123.049999999996,Other Income, 
18-Mar-17,698.89,564039237,,AUTOMATIC DRAWING,160443014555215 GRIFFIN-LEONARD ,5821.939999999996,Financial, 
18-Mar-17,1566.76,564039237,,INTER-BANK CREDIT,Rodriguez Group,7388.699999999996,Bills, 
21-Mar-17,-1969.05,564039237,,INTER-BANK CREDIT,547196410980207 BROWN TURNER AND JONES ,5419.649999999996,Uncategorised, 
22-Mar-17,532.63,564039237,,TRANSFER DEBIT,Hudson-Floyd,5952.279999999996,Uncategorised, 
22-Mar-17,-1897.27,564039237,,TRANSFER DEBIT,110116268452258 BRIGHT-ANDERSON ,4055.009999999996,Other Income, 
24-Mar-17,556.87,564039237,,INTER-BANK CREDIT,532059289575267 MULLINS GROUP ,4611.8799999999965,Financial, 
25-Mar-17,348.71,564039237,,TRANSFER DEBIT,957901373609841 MYERS CHANDLER AND SNYDER ,4960.5899999999965,Uncategorised, 
25-Mar-17,630.48,564039237,,AUTOMATIC DRAWING,462536023549232 SLOAN AND SONS ,5591.069999999996,Other Income, 
28-Mar-17,-1809.04,564039237,,TRANSFER DEBIT,Hernandez-Glover,3782.029999999996,Uncategorised, 
31-Mar-17,1726.6,564039237,,INTER-BANK CREDIT,75113432744691 SIMS CONTRERAS AND WILLIAMSON ,5508.629999999996,Financial, 
03-Apr-17,1434.42,564039237,,TRANSFER DEBIT,657942095184370 COMBS CASE AND BUCK ,6943.049999999996,Bills, 
06-Apr-17,-889.16,564039237,,AUTOMATIC DRAWING,Roth LLC,6053.889999999996,Uncategorised, 
06-Apr-17,1817.79,564039237,,AUTOMATIC DRAWING,Silva-Floyd,7871.679999999996,Uncategorised, 
07-Apr-17,1303.28,564039237,,TRANSFER DEBIT,234613250526809 MAHONEY SALAZAR AND MENDOZA ,9174.959999999995,Bills, 
09-Apr-17,1968.66,564039237,,AUTOMATIC DRAWING,Smith-Dominguez,11143.619999999995,Uncategorised, 
11-Apr-17,1764.41,564039237,,TRANSFER DEBIT,485825061565216 WOODS-HERNANDEZ ,12908.029999999995,Bills, 
14-Apr-17,-790.76,564039237,,INTER-BANK CREDIT,148440709744829 DAVIS-DIXON ,12117.269999999995,Bills, 
15-Apr-17,-1559.79,564039237,,INTER-BANK CREDIT,Baker Long and Lopez,10557.479999999996,Uncategorised, 
16-Apr-17,662.97,564039237,,AUTOMATIC DRAWING,677434304019280 JACKSON-ALI ,11220.449999999995,Uncategorised, 
17-Apr-17,299.21,564039237,,AUTOMATIC DRAWING,886624336534705 FORBES HERNANDEZ AND ALLEN ,11519.659999999994,Financial, 
17-Apr-17,1151.27,564039237,,AUTOMATIC DRAWING,Mason Dunn and Silva,12670.929999999995,Uncategorised, 
20-Apr-17,-1825.87,564039237,,INTER-BANK CREDIT,410646777942790 WRIGHT GROUP ,10845.059999999994,Financial, 
22-Apr-17,-1041.3,564039237,,AUTOMATIC DRAWING,640905924973013 JORDAN COOKE AND MARTIN ,9803.759999999995,Bills, 
22-Apr-17,1133.45,564039237,,INTER-BANK CREDIT,492989811179996 MARSHALL LLC ,10937.209999999995,Bills, 
25-Apr-17,-377.28,564039237,,INTER-BANK CREDIT,Terry-Hahn,10559.929999999995,Other Income, 
26-Apr-17,-1250.16,564039237,,INTER-BANK CREDIT,490340574662586 BERG-RIDDLE ,9309.769999999995,Uncategorised, 
26-Apr-17,1011.45,564039237,,INTER-BANK CREDIT,Weber Mclean and Thompson,10321.219999999996,Financial, 
29-Apr-17,892.01,564039237,,INTER-BANK CREDIT,748228107521642 ADAMS HAWKINS AND JOHNSON ,11213.229999999996,Other Income, 
30-Apr-17,681.8,564039237,,INTER-BANK CREDIT,285055297403735 HILL-KELLY ,11895.029999999995,Uncategorised, 
03-May-17,-51.91,564039237,,INTER-BANK CREDIT,758400216320055 WILLIAMS ROBBINS AND CLARK ,11843.119999999995,Uncategorised, 
05-May-17,1441.69,564039237,,INTER-BANK CREDIT,183573373209399 PATTERSON PLC ,13284.809999999996,Other Income, 
06-May-17,-1156.28,564039237,,INTER-BANK CREDIT,139931824114967 AUSTIN BOYER AND MEDINA ,12128.529999999995,Bills, 
09-May-17,220.4,564039237,,INTER-BANK CREDIT,Barton-Gutierrez,12348.929999999995,Bills, 
10-May-17,1076.06,564039237,,INTER-BANK CREDIT,Miller and Sons,13424.989999999994,Other Income, 
13-May-17,-1927.14,564039237,,TRANSFER DEBIT,50857961437737 HOBBS ALVAREZ AND MORRISON ,11497.849999999995,Financial, 
16-May-17,368.73,564039237,,INTER-BANK CREDIT,602487703454884 HERNANDEZ-PEREZ ,11866.579999999994,Bills, 
17-May-17,191.53,564039237,,AUTOMATIC DRAWING,Stephens-Blackburn,12058.109999999995,Bills, 
19-May-17,1133.26,564039237,,AUTOMATIC DRAWING,Stewart Group,13191.369999999995,Bills, 
21-May-17,1817.09,564039237,,INTER-BANK CREDIT,Guerrero PLC,15008.459999999995,Financial, 
24-May-17,-1847.84,564039237,,INTER-BANK CREDIT,42022865662056 MATTHEWS GROUP ,13160.619999999995,Other Income, 
27-May-17,1357.49,564039237,,INTER-BANK CREDIT,Aguilar-Mcgee,14518.109999999995,Uncategorised, 
28-May-17,537.85,564039237,,TRANSFER DEBIT,857192680739320 RIOS TORRES AND YATES ,15055.959999999995,Bills, 
30-May-17,-1573.69,564039237,,INTER-BANK CREDIT,Smith-Newton,13482.269999999995,Bills, 
31-May-17,925.1,564039237,,INTER-BANK CREDIT,Norris Group,14407.369999999995,Financial, 
01-Jun-17,984.04,564039237,,AUTOMATIC DRAWING,515921820030640 PARSONS FOLEY AND MILLS ,15391.409999999996,Uncategorised, 
04-Jun-17,-647.02,564039237,,INTER-BANK CREDIT,Bennett Group,14744.389999999996,Financial, 
07-Jun-17,1927.52,564039237,,INTER-BANK CREDIT,618127245899637 ALVARADO THOMAS AND CHAPMAN ,16671.909999999996,Bills, 
09-Jun-17,346.61,564039237,,AUTOMATIC DRAWING,Carter and Sons,17018.519999999997,Bills, 
09-Jun-17,145.26,564039237,,INTER-BANK CREDIT,645469958040634 MCDOWELL GOODWIN AND LEWIS ,17163.779999999995,Bills, 
09-Jun-17,-1814.02,564039237,,AUTOMATIC DRAWING,971243725128703 LYNN AND SONS ,15349.759999999995,Financial, 
12-Jun-17,140.11,564039237,,TRANSFER DEBIT,135029090325302 GONZALES GROUP ,15489.869999999995,Other Income, 
15-Jun-17,975.56,564039237,,INTER-BANK CREDIT,390067732472574 CONLEY-FERGUSON ,16465.429999999997,Other Income, 
18-Jun-17,1315.64,564039237,,TRANSFER DEBIT,83743681189183 DIAZ KELLY AND RICHARDSON ,17781.069999999996,Other Income, 
18-Jun-17,285.32,564039237,,INTER-BANK CREDIT,167753027707365 MILLER CHRISTENSEN AND SHELTON ,18066.389999999996,Bills, 
20-Jun-17,-532.62,564039237,,AUTOMATIC DRAWING,Fuller Group,17533.769999999997,Other Income, 
22-Jun-17,-1265.2,564039237,,AUTOMATIC DRAWING,266000894600419 CARROLL LTD ,16268.569999999996,Other Income, 
24-Jun-17,1168.0,564039237,,INTER-BANK CREDIT,170586144438508 WOODS GROUP ,17436.569999999996,Financial, 
24-Jun-17,-1617.25,564039237,,INTER-BANK CREDIT,600781416284567 SOLIS-BARNES ,15819.319999999996,Financial, 
27-Jun-17,631.93,564039237,,AUTOMATIC DRAWING,53756896182809 CHAVEZ MORALES AND JOHNSON ,16451.249999999996,Other Income, 
28-Jun-17,-310.06,564039237,,TRANSFER DEBIT,Miller Hardy and Walker,16141.189999999997,Uncategorised, 
30-Jun-17,998.43,564039237,,INTER-BANK CREDIT,Jacobson Shannon and Hicks,17139.619999999995,Other Income, 
01-Jul-17,-35.61,564039237,,TRANSFER DEBIT,Williams LLC,17104.009999999995,Uncategorised, 
01-Jul-17,-966.47,564039237,,INTER-BANK CREDIT,Wright Inc,16137.539999999995,Bills, 
03-Jul-17,-494.2,564039237,,TRANSFER DEBIT,Pace Ltd,15643.339999999995,Bills, 
06-Jul-17,-179.66,564039237,,TRANSFER DEBIT,318980954762148 SMITH FERGUSON AND HOFFMAN ,15463.679999999995,Uncategorised, 
08-Jul-17,-597.43,564039237,,TRANSFER DEBIT,147763937581665 WALTERS GROUP ,14866.249999999995,Bills, 
10-Jul-17,815.31,564039237,,INTER-BANK CREDIT,Stewart and Sons,15681.559999999994,Financial, 
13-Jul-17,1412.38,564039237,,AUTOMATIC DRAWING,972421778351094 DIAZ-ROMAN ,17093.939999999995,Financial, 
13-Jul-17,-1925.08,564039237,,TRANSFER DEBIT,Brown Ltd,15168.859999999995,Uncategorised, 
16-Jul-17,-1963.99,564039237,,INTER-BANK CREDIT,103288057715810 EDWARDS INC ,13204.869999999995,Financial, 
18-Jul-17,-656.23,564039237,,INTER-BANK CREDIT,900124583287109 BECK PLC ,12548.639999999996,Other Income, 
18-Jul-17,-1075.99,564039237,,INTER-BANK CREDIT,Vasquez-Williams,11472.649999999996,Financial, 
18-Jul-17,1338.88,564039237,,INTER-BANK CREDIT,Brown LLC,12811.529999999995,Other Income, 
20-Jul-17,-1053.44,564039237,,TRANSFER DEBIT,Green Chapman and Patterson,11758.089999999995,Uncategorised, 
20-Jul-17,998.72,564039237,,INTER-BANK CREDIT,Green Richards and Anderson,12756.809999999994,Uncategorised, 
20-Jul-17,-1008.34,564039237,,AUTOMATIC DRAWING,665939849885267 WARREN CRUZ AND NELSON ,11748.469999999994,Uncategorised, 
22-Jul-17,-79.83,564039237,,TRANSFER DEBIT,Cooper Group,11668.639999999994,Other Income, 
24-Jul-17,1952.12,564039237,,INTER-BANK CREDIT,13487228228019 ELLIOTT WILLIAMS AND BARR ,13620.759999999995,Uncategorised, 
26-Jul-17,1547.31,564039237,,INTER-BANK CREDIT,40733813771171 MARTIN PLC ,15168.069999999994,Bills, 
26-Jul-17,-1504.01,564039237,,TRANSFER DEBIT,139192767722631 THOMPSON-PARSONS ,13664.059999999994,Uncategorised, 
28-Jul-17,1329.7,564039237,,INTER-BANK CREDIT,Clay and Sons,14993.759999999995,Financial, 
28-Jul-17,1812.91,564039237,,INTER-BANK CREDIT,Walker Fox and Buck,16806.669999999995,Bills, 
29-Jul-17,1495.97,564039237,,AUTOMATIC DRAWING,Bishop-Gibson,18302.639999999996,Financial, 
01-Aug-17,-1192.34,564039237,,TRANSFER DEBIT,Barnett Mercer and Daniels,17110.299999999996,Financial, 
04-Aug-17,-769.01,564039237,,TRANSFER DEBIT,Beltran Kelley and Johnson,16341.289999999995,Other Income, 
06-Aug-17,1574.16,564039237,,INTER-BANK CREDIT,Reed Group,17915.449999999997,Uncategorised, 
08-Aug-17,-507.81,564039237,,AUTOMATIC DRAWING,Scott Coleman and Cooper,17407.639999999996,Bills, 
10-Aug-17,-53.36,564039237,,INTER-BANK CREDIT,146697133040767 JENKINS JACKSON AND NGUYEN ,17354.279999999995,Other Income, 
13-Aug-17,817.43,564039237,,INTER-BANK CREDIT,Short-Rodgers,18171.709999999995,Other Income, 
16-Aug-17,-462.8,564039237,,AUTOMATIC DRAWING,Stevens and Sons,17708.909999999996,Financial, 
19-Aug-17,-1180.96,564039237,,INTER-BANK CREDIT,292492556298801 CANTU INC ,16527.949999999997,Uncategorised, 
20-Aug-17,618.4,564039237,,AUTOMATIC DRAWING,879541150733993 CANNON-MARTIN ,17146.35,Other Income, 
23-Aug-17,-1110.99,564039237,,INTER-BANK CREDIT,Ray-Kim,16035.359999999999,Uncategorised, 
23-Aug-17,585.89,564039237,,AUTOMATIC DRAWING,64680868811185 BELL CASTILLO AND RAMSEY ,16621.25,Uncategorised, 
26-Aug-17,-1226.37,564039237,,TRANSFER DEBIT,296291991598167 BLAIR-SMITH ,15394.880000000001,Bills, 
29-Aug-17,513.98,564039237,,INTER-BANK CREDIT,718185496427223 MILLER AND SONS ,15908.86,Uncategorised, 
30-Aug-17,168.6,564039237,,AUTOMATIC DRAWING,250294171633103 GARCIA GROUP ,16077.460000000001,Financial, 
01-Sep-17,-1411.59,564039237,,INTER-BANK CREDIT,951337072633351 CLARK CARPENTER AND CRAWFORD ,14665.87,Bills, 
03-Sep-17,1248.73,564039237,,AUTOMATIC DRAWING,Avery LLC,15914.6,Bills, 
05-Sep-17,380.41,564039237,,INTER-BANK CREDIT,244025977280969 JONES PARKER AND WRIGHT ,16295.01,Financial, 
08-Sep-17,-1402.02,564039237,,INTER-BANK CREDIT,392954548454281 WHITE TAYLOR AND WILLIAMS ,14892.99,Uncategorised, 
09-Sep-17,-1313.24,564039237,,INTER-BANK CREDIT,Bennett-Hodges,13579.75,Uncategorised, 
12-Sep-17,1099.0,564039237,,AUTOMATIC DRAWING,Ramos Wilson and Macdonald,14678.75,Other Income, 
15-Sep-17,-318.25,564039237,,INTER-BANK CREDIT,Guzman-Stevens,14360.5,Other Income, 
17-Sep-17,857.98,564039237,,INTER-BANK CREDIT,25471111026586 ADAMS LTD ,15218.48,Financial, 
17-Sep-17,-1122.26,564039237,,AUTOMATIC DRAWING,396377966100140 SCOTT LTD ,14096.22,Other Income, 
18-Sep-17,-644.86,564039237,,INTER-BANK CREDIT,Blevins Ltd,13451.359999999999,Bills, 
19-Sep-17,762.51,564039237,,AUTOMATIC DRAWING,Simon Rodriguez and Cordova,14213.869999999999,Bills, 
19-Sep-17,308.11,564039237,,TRANSFER DEBIT,235603661475725 LAWRENCE MURPHY AND HURLEY ,14521.98,Uncategorised, 
22-Sep-17,-556.37,564039237,,TRANSFER DEBIT,Rogers Ltd,13965.609999999999,Bills, 
24-Sep-17,11.94,564039237,,INTER-BANK CREDIT,494995453616463 MARTINEZ BROOKS AND GRIMES ,13977.55,Other Income, 
24-Sep-17,1613.23,564039237,,INTER-BANK CREDIT,710981634164617 HIGGINS-LUNA ,15590.779999999999,Other Income, 
25-Sep-17,-71.67,564039237,,TRANSFER DEBIT,962924331822773 MILES-HARRIS ,15519.109999999999,Bills, 
28-Sep-17,11.57,564039237,,INTER-BANK CREDIT,Reyes Nixon and Ramos,15530.679999999998,Uncategorised, 
28-Sep-17,-755.34,564039237,,TRANSFER DEBIT,Harrell PLC,14775.339999999998,Other Income, 
29-Sep-17,-483.14,564039237,,INTER-BANK CREDIT,Mitchell-May,14292.199999999999,Uncategorised, 
02-Oct-17,1311.38,564039237,,AUTOMATIC DRAWING,984650977144952 MILLER LTD ,15603.579999999998,Financial, 
04-Oct-17,-1913.68,564039237,,AUTOMATIC DRAWING,683099290271963 PARSONS AND SONS ,13689.899999999998,Uncategorised, 
04-Oct-17,-1531.0,564039237,,TRANSFER DEBIT,133806260114114 STONE LLC ,12158.899999999998,Other Income, 
07-Oct-17,230.21,564039237,,INTER-BANK CREDIT,Rose-Ryan,12389.109999999997,Bills, 
10-Oct-17,1045.24,564039237,,AUTOMATIC DRAWING,Mcgee LLC,13434.349999999997,Other Income, 
11-Oct-17,613.12,564039237,,INTER-BANK CREDIT,806080775700645 MACDONALD-KELLEY ,14047.469999999998,Bills, 
12-Oct-17,452.27,564039237,,TRANSFER DEBIT,201879975748440 ROGERS-WHITEHEAD ,14499.739999999998,Other Income, 
14-Oct-17,141.71,564039237,,TRANSFER DEBIT,759568765178418 PAUL LLC ,14641.449999999997,Financial, 
15-Oct-17,-464.68,564039237,,INTER-BANK CREDIT,255514504939346 CASE DANIEL AND BENNETT ,14176.769999999997,Uncategorised, 
17-Oct-17,-622.31,564039237,,INTER-BANK CREDIT,Adams Schultz and Lopez,13554.459999999997,Financial, 
17-Oct-17,-1300.96,564039237,,INTER-BANK CREDIT,Thompson Bowman and Oliver,12253.499999999996,Uncategorised, 
18-Oct-17,-1315.44,564039237,,INTER-BANK CREDIT,Paul PLC,10938.059999999996,Other Income, 
19-Oct-17,41.25,564039237,,INTER-BANK CREDIT,Long Chandler and Torres,10979.309999999996,Other Income, 
22-Oct-17,-1913.84,564039237,,INTER-BANK CREDIT,Johnson-Meyer,9065.469999999996,Bills, 
23-Oct-17,-388.86,564039237,,INTER-BANK CREDIT,348576342638698 WEBER GOLDEN AND ALVAREZ ,8676.609999999995,Financial, 
26-Oct-17,-1011.3,564039237,,INTER-BANK CREDIT,Jones Mccullough and Hawkins,7665.309999999995,Uncategorised, 
29-Oct-17,-955.73,564039237,,INTER-BANK CREDIT,985380329236480 VASQUEZ LUNA AND GREER ,6709.5799999999945,Other Income, 
30-Oct-17,-1844.98,564039237,,TRANSFER DEBIT,Cook Martinez and Paul,4864.599999999995,Uncategorised, 
01-Nov-17,-1000.03,564039237,,TRANSFER DEBIT,539244547225359 PALMER BROCK AND EVANS ,3864.569999999995,Financial, 
02-Nov-17,1500.58,564039237,,INTER-BANK CREDIT,560393599670545 WEST AND SONS ,5365.149999999995,Financial, 
04-Nov-17,-73.31,564039237,,AUTOMATIC DRAWING,Johnston Esparza and Williams,5291.839999999995,Bills, 
05-Nov-17,-793.72,564039237,,TRANSFER DEBIT,Aguilar-Reed,4498.119999999994,Other Income, 
05-Nov-17,-1695.22,564039237,,INTER-BANK CREDIT,Foley-Knight,2802.899999999994,Other Income, 
05-Nov-17,-625.97,564039237,,TRANSFER DEBIT,Jackson-Montgomery,2176.929999999994,Bills, 
06-Nov-17,-1680.42,564039237,,INTER-BANK CREDIT,Smith Group,496.50999999999385,Bills, 
06-Nov-17,-1316.74,564039237,,INTER-BANK CREDIT,Jackson Morales and Mcbride,-820.2300000000062,Bills, 
07-Nov-17,1060.15,564039237,,INTER-BANK CREDIT,Sandoval-Skinner,239.91999999999393,Bills, 
08-Nov-17,1546.79,564039237,,TRANSFER DEBIT,908508681286680 MYERS AND SONS ,1786.709999999994,Other Income, 
09-Nov-17,-884.21,564039237,,AUTOMATIC DRAWING,265663767325306 FLORES-BARRERA ,902.4999999999939,Uncategorised, 
09-Nov-17,1101.83,564039237,,AUTOMATIC DRAWING,Jackson Group,2004.3299999999938,Financial, 
09-Nov-17,-1585.32,564039237,,TRANSFER DEBIT,Allen Ltd,419.00999999999385,Uncategorised, 
09-Nov-17,-1555.25,564039237,,TRANSFER DEBIT,23642381552444 CARROLL MILLER AND WHITAKER ,-1136.2400000000061,Bills, 
10-Nov-17,-940.16,564039237,,INTER-BANK CREDIT,841183530473186 JOHNSON AND SONS ,-2076.400000000006,Bills, 
10-Nov-17,589.28,564039237,,INTER-BANK CREDIT,86472110758958 KENNEDY MITCHELL AND MURRAY ,-1487.120000000006,Other Income, 
11-Nov-17,-94.49,564039237,,INTER-BANK CREDIT,130072219938121 MOORE AND SONS ,-1581.610000000006,Uncategorised, 
12-Nov-17,1540.57,564039237,,AUTOMATIC DRAWING,817181755139228 HARRISON BENSON AND DANIELS ,-41.0400000000061,Bills, 
14-Nov-17,1496.68,564039237,,TRANSFER DEBIT,331516450300953 WOODARD FERNANDEZ AND MILES ,1455.639999999994,Uncategorised, 
15-Nov-17,970.04,564039237,,TRANSFER DEBIT,Cooper Inc,2425.679999999994,Other Income, 
15-Nov-17,-811.48,564039237,,AUTOMATIC DRAWING,Suarez Jones and Atkins,1614.199999999994,Other Income, 
16-Nov-17,-898.82,564039237,,INTER-BANK CREDIT,718890016251084 HUTCHINSON GIBSON AND FUENTES ,715.3799999999939,Bills, 
16-Nov-17,1122.17,564039237,,TRANSFER DEBIT,Chen Thomas and Robinson,1837.5499999999938,Uncategorised, 
17-Nov-17,1885.13,564039237,,INTER-BANK CREDIT,331032849846074 JACKSON WHITEHEAD AND BARNES ,3722.679999999994,Bills, 
17-Nov-17,-1316.87,564039237,,INTER-BANK CREDIT,193496031467315 MARTIN LANG AND MURPHY ,2405.809999999994,Bills, 
17-Nov-17,-833.98,564039237,,TRANSFER DEBIT,260186683398889 DIXON AND SONS ,1571.829999999994,Uncategorised, 
18-Nov-17,692.27,564039237,,AUTOMATIC DRAWING,Bowman Ltd,2264.099999999994,Bills, 
20-Nov-17,1144.3,564039237,,TRANSFER DEBIT,Herman Diaz and Byrd,3408.399999999994,Uncategorised, 
20-Nov-17,-252.96,564039237,,TRANSFER DEBIT,Boyd-Graham,3155.439999999994,Bills, 
21-Nov-17,316.83,564039237,,AUTOMATIC DRAWING,75132162043218 LEVINE INC ,3472.269999999994,Uncategorised, 
24-Nov-17,-203.43,564039237,,INTER-BANK CREDIT,544978779993605 PACHECO-GIBSON ,3268.8399999999942,Financial, 
27-Nov-17,464.72,564039237,,TRANSFER DEBIT,Ball Payne and Turner,3733.559999999994,Bills, 
28-Nov-17,1049.48,564039237,,TRANSFER DEBIT,908739149465195 NIXON-FRENCH ,4783.039999999994,Other Income, 
29-Nov-17,1005.66,564039237,,INTER-BANK CREDIT,Cochran-Owens,5788.699999999993,Uncategorised, 
02-Dec-17,163.11,564039237,,INTER-BANK CREDIT,437845190392912 TRAN KLINE AND BALLARD ,5951.809999999993,Uncategorised, 
04-Dec-17,812.79,564039237,,INTER-BANK CREDIT,Baker Williams and Garcia,6764.599999999993,Other Income, 
04-Dec-17,1802.17,564039237,,INTER-BANK CREDIT,Walker-Alvarez,8566.769999999993,Bills, 
06-Dec-17,1758.73,564039237,,AUTOMATIC DRAWING,Clark and Sons,10325.499999999993,Financial, 
09-Dec-17,-1418.09,564039237,,INTER-BANK CREDIT,Medina-Sanchez,8907.409999999993,Bills, 
12-Dec-17,-1959.28,564039237,,INTER-BANK CREDIT,Harrison and Sons,6948.129999999993,Financial, 
13-Dec-17,48.71,564039237,,AUTOMATIC DRAWING,99099307990351 PITTS GROUP ,6996.839999999993,Uncategorised, 
14-Dec-17,1542.68,564039237,,AUTOMATIC DRAWING,Harvey-Hill,8539.519999999993,Financial, 
17-Dec-17,440.86,564039237,,INTER-BANK CREDIT,Harris Johnson and Booth,8980.379999999994,Financial, 
17-Dec-17,-1454.24,564039237,,INTER-BANK CREDIT,Freeman-George,7526.139999999994,Financial, 
17-Dec-17,-1145.91,564039237,,AUTOMATIC DRAWING,310569653349282 MATHEWS GROUP ,6380.229999999994,Financial, 
19-Dec-17,1968.61,564039237,,AUTOMATIC DRAWING,576810480784850 COPELAND AND SONS ,8348.839999999995,Bills, 
20-Dec-17,1704.41,564039237,,INTER-BANK CREDIT,256346202402872 JACOBS MORGAN AND FERGUSON ,10053.249999999995,Financial, 
23-Dec-17,-1652.3,564039237,,INTER-BANK CREDIT,Edwards-Graham,8400.949999999995,Bills, 
24-Dec-17,-508.25,564039237,,TRANSFER DEBIT,Sawyer LLC,7892.699999999995,Other Income, 
25-Dec-17,-569.78,564039237,,AUTOMATIC DRAWING,901003110096708 FISHER JORDAN AND FORD ,7322.9199999999955,Financial, 
28-Dec-17,-1123.33,564039237,,AUTOMATIC DRAWING,484546151245954 JARVIS KELLY AND MATHEWS ,6199.589999999996,Bills, 
30-Dec-17,983.3,564039237,,AUTOMATIC DRAWING,Lewis PLC,7182.889999999996,Other Income, 
02-Jan-18,-1121.25,564039237,,AUTOMATIC DRAWING,743057888226313 NGUYEN-WEAVER ,6061.639999999996,Other Income, 
04-Jan-18,-669.89,564039237,,TRANSFER DEBIT,529891983153890 SALAZAR CONTRERAS AND COWAN ,5391.749999999995,Other Income, 
07-Jan-18,-738.33,564039237,,AUTOMATIC DRAWING,595628881076741 HORTON GROUP ,4653.4199999999955,Bills, 
09-Jan-18,1497.3,564039237,,INTER-BANK CREDIT,Dunn Richardson and Parker,6150.719999999996,Other Income, 
10-Jan-18,-1908.96,564039237,,INTER-BANK CREDIT,952719535317766 CANNON GUTIERREZ AND HOFFMAN ,4241.759999999996,Bills, 
10-Jan-18,-661.74,564039237,,INTER-BANK CREDIT,Berger-Robinson,3580.019999999996,Bills, 
13-Jan-18,-1215.52,564039237,,AUTOMATIC DRAWING,212003345021180 WALTERS PIERCE AND SPENCER ,2364.499999999996,Bills, 
15-Jan-18,-647.03,564039237,,INTER-BANK CREDIT,307204294086033 HILL-GRAHAM ,1717.469999999996,Other Income, 
16-Jan-18,-222.86,564039237,,AUTOMATIC DRAWING,Avery Bailey and Wolfe,1494.609999999996,Other Income, 
19-Jan-18,-967.7,564039237,,TRANSFER DEBIT,Holt LLC,526.909999999996,Other Income, 
22-Jan-18,-836.89,564039237,,TRANSFER DEBIT,633383242331833 MEDINA-HERRERA ,-309.980000000004,Other Income, 
23-Jan-18,1777.98,564039237,,INTER-BANK CREDIT,559758809102476 JOHNSON INC ,1467.999999999996,Financial, 
23-Jan-18,-419.14,564039237,,INTER-BANK CREDIT,Ward-Carter,1048.859999999996,Bills, 
25-Jan-18,594.16,564039237,,TRANSFER DEBIT,563835500074865 CRAWFORD INC ,1643.019999999996,Other Income, 
27-Jan-18,228.79,564039237,,AUTOMATIC DRAWING,921373207842599 ROWE BARNES AND ALVAREZ ,1871.8099999999959,Uncategorised, 
30-Jan-18,127.46,564039237,,AUTOMATIC DRAWING,969317011515797 MARTIN AND SONS ,1999.269999999996,Financial, 
02-Feb-18,-1773.96,564039237,,INTER-BANK CREDIT,706774157894831 SHEPHERD MOSES AND KING ,225.30999999999585,Other Income, 
04-Feb-18,946.45,564039237,,TRANSFER DEBIT,White-Dorsey,1171.759999999996,Uncategorised, 
05-Feb-18,224.91,564039237,,INTER-BANK CREDIT,336114119647440 RODRIGUEZ WHITAKER AND OSBORNE ,1396.669999999996,Financial, 
05-Feb-18,934.39,564039237,,INTER-BANK CREDIT,Evans Johnston and Galvan,2331.059999999996,Bills, 
08-Feb-18,-832.1,564039237,,INTER-BANK CREDIT,928300432734245 LEE PRESTON AND FULLER ,1498.959999999996,Bills, 
08-Feb-18,-1263.0,564039237,,TRANSFER DEBIT,315479429965335 DOUGHERTY LLC ,235.95999999999594,Uncategorised, 
10-Feb-18,1012.64,564039237,,TRANSFER DEBIT,Pham-Parker,1248.5999999999958,Bills, 
13-Feb-18,-123.31,564039237,,INTER-BANK CREDIT,747186209871345 CRANE-LE ,1125.2899999999959,Financial, 
15-Feb-18,-1404.39,564039237,,TRANSFER DEBIT,937781303589343 BARRETT HANSON AND ODOM ,-279.10000000000423,Financial, 
16-Feb-18,-407.89,564039237,,TRANSFER DEBIT,21578068798807 WILSON PLC ,-686.9900000000042,Financial, 
16-Feb-18,271.2,564039237,,AUTOMATIC DRAWING,799179838016446 ARCHER COPELAND AND SANTANA ,-415.7900000000042,Bills, 
17-Feb-18,-1266.46,564039237,,INTER-BANK CREDIT,Reeves PLC,-1682.2500000000043,Bills, 
18-Feb-18,-369.0,564039237,,INTER-BANK CREDIT,614933803795319 BLACK WILLIAMS AND WILCOX ,-2051.2500000000045,Other Income, 
18-Feb-18,294.49,564039237,,TRANSFER DEBIT,3429758255252 ROMERO GALVAN AND ADAMS ,-1756.7600000000045,Bills, 
21-Feb-18,-649.57,564039237,,INTER-BANK CREDIT,991870277028309 BERRY COX AND HARRINGTON ,-2406.3300000000045,Uncategorised, 
22-Feb-18,-1733.6,564039237,,INTER-BANK CREDIT,Ali-Stevens,-4139.930000000004,Financial, 
24-Feb-18,755.18,564039237,,INTER-BANK CREDIT,895787530718014 ROWLAND TAYLOR AND FIELDS ,-3384.750000000004,Uncategorised, 
24-Feb-18,327.95,564039237,,AUTOMATIC DRAWING,396257348252690 JACKSON PLC ,-3056.8000000000043,Uncategorised, 
24-Feb-18,-861.59,564039237,,INTER-BANK CREDIT,Jackson Ltd,-3918.3900000000044,Financial, 
25-Feb-18,-14.28,564039237,,AUTOMATIC DRAWING,942336431607869 SALAZAR RICHARDSON AND WHEELER ,-3932.6700000000046,Uncategorised, 
25-Feb-18,1509.62,564039237,,TRANSFER DEBIT,Norton Ward and Brown,-2423.0500000000047,Financial, 
26-Feb-18,-1117.91,564039237,,AUTOMATIC DRAWING,569385024188281 BAILEY-THOMAS ,-3540.9600000000046,Bills, 
27-Feb-18,1721.25,564039237,,AUTOMATIC DRAWING,976552356987150 WARD AND SONS ,-1819.7100000000046,Other Income, 
27-Feb-18,-304.5,564039237,,AUTOMATIC DRAWING,Lopez and Sons,-2124.2100000000046,Bills, 
27-Feb-18,672.16,564039237,,INTER-BANK CREDIT,Valdez LLC,-1452.0500000000047,Bills, 
27-Feb-18,262.61,564039237,,AUTOMATIC DRAWING,Thompson Wagner and Foster,-1189.4400000000046,Other Income, 
28-Feb-18,-640.84,564039237,,AUTOMATIC DRAWING,902582466191584 HEBERT INC ,-1830.2800000000047,Uncategorised, 
01-Mar-18,-1037.08,564039237,,TRANSFER DEBIT,James Inc,-2867.3600000000047,Other Income, 
03-Mar-18,-887.11,564039237,,INTER-BANK CREDIT,Miller Group,-3754.470000000005,Bills, 
04-Mar-18,1411.8,564039237,,AUTOMATIC DRAWING,Taylor-Michael,-2342.6700000000046,Bills, 
06-Mar-18,424.2,564039237,,TRANSFER DEBIT,Mcpherson and Sons,-1918.4700000000046,Uncategorised, 
06-Mar-18,627.89,564039237,,INTER-BANK CREDIT,538669531678477 YOUNG AND SONS ,-1290.5800000000045,Financial, 
08-Mar-18,-4.07,564039237,,AUTOMATIC DRAWING,Davis Hernandez and Taylor,-1294.6500000000044,Financial, 
11-Mar-18,-1562.78,564039237,,TRANSFER DEBIT,Mcguire-Hays,-2857.4300000000044,Financial, 
11-Mar-18,469.4,564039237,,AUTOMATIC DRAWING,Garrison Ltd,-2388.0300000000043,Bills, 
14-Mar-18,1642.29,564039237,,AUTOMATIC DRAWING,951856278306522 SPEARS-STEVENSON ,-745.7400000000043,Other Income, 
14-Mar-18,-1178.46,564039237,,TRANSFER DEBIT,Price Kim and Sherman,-1924.2000000000044,Bills, 
17-Mar-18,1842.23,564039237,,INTER-BANK CREDIT,Matthews Ltd,-81.97000000000435,Bills, 
20-Mar-18,1600.7,564039237,,TRANSFER DEBIT,55006877320935 KEMP AND SONS ,1518.7299999999957,Bills, 
20-Mar-18,-1571.42,564039237,,AUTOMATIC DRAWING,Collins Vaughn and Pineda,-52.690000000004375,Bills, 
22-Mar-18,332.3,564039237,,INTER-BANK CREDIT,55987522375178 WEAVER SMITH AND MURRAY ,279.60999999999564,Uncategorised, 
25-Mar-18,1012.9,564039237,,TRANSFER DEBIT,645338011974277 CHUNG AND SONS ,1292.5099999999957,Bills, 
25-Mar-18,328.47,564039237,,TRANSFER DEBIT,Porter Group,1620.9799999999957,Financial, 
27-Mar-18,-812.31,564039237,,INTER-BANK CREDIT,364710026137411 LAMB FISCHER AND MEZA ,808.6699999999958,Financial, 
28-Mar-18,-1627.13,564039237,,INTER-BANK CREDIT,Hansen Group,-818.4600000000044,Other Income, 
30-Mar-18,1837.14,564039237,,TRANSFER DEBIT,Miller-Foster,1018.6799999999957,Financial, 
02-Apr-18,-1965.53,564039237,,AUTOMATIC DRAWING,331535991246269 HANSEN-ROBINSON ,-946.8500000000042,Financial, 
05-Apr-18,-501.53,564039237,,TRANSFER DEBIT,Fernandez Houston and Swanson,-1448.3800000000042,Uncategorised, 
06-Apr-18,-1262.85,564039237,,INTER-BANK CREDIT,483549901052247 AUSTIN-WILSON ,-2711.230000000004,Uncategorised, 
06-Apr-18,-154.93,564039237,,INTER-BANK CREDIT,Black-Phillips,-2866.160000000004,Bills, 
07-Apr-18,-1633.41,564039237,,INTER-BANK CREDIT,627619648574443 WILEY LLC ,-4499.570000000004,Uncategorised, 
08-Apr-18,1770.13,564039237,,INTER-BANK CREDIT,170038310378804 HERNANDEZ PLC ,-2729.440000000004,Financial, 
08-Apr-18,-1786.64,564039237,,INTER-BANK CREDIT,Graham-Hinton,-4516.0800000000045,Uncategorised, 
11-Apr-18,277.36,564039237,,AUTOMATIC DRAWING,White Wood and Johnson,-4238.720000000005,Other Income, 
14-Apr-18,-694.95,564039237,,INTER-BANK CREDIT,277161399176170 PHAM THOMAS AND SMITH ,-4933.670000000005,Other Income, 
15-Apr-18,1743.32,564039237,,INTER-BANK CREDIT,36367940530022 WILLIAMS-KRAUSE ,-3190.350000000005,Uncategorised, 
15-Apr-18,-136.86,564039237,,INTER-BANK CREDIT,1853117256580 POPE INC ,-3327.210000000005,Other Income, 
18-Apr-18,1094.6,564039237,,INTER-BANK CREDIT,245850751902696 FLEMING TERRY AND DAWSON ,-2232.610000000005,Other Income, 
19-Apr-18,-1615.58,564039237,,INTER-BANK CREDIT,914622959103447 SANCHEZ GROUP ,-3848.190000000005,Uncategorised, 
19-Apr-18,-1398.16,564039237,,AUTOMATIC DRAWING,Spence-Henry,-5246.350000000005,Other Income, 
22-Apr-18,-838.6,564039237,,INTER-BANK CREDIT,396367813110963 GRAHAM JOHNSON AND PEARSON ,-6084.950000000005,Bills, 
22-Apr-18,-1180.68,564039237,,INTER-BANK CREDIT,Dodson Wilcox and Brooks,-7265.630000000006,Financial, 
23-Apr-18,1270.0,564039237,,AUTOMATIC DRAWING,Trujillo Ltd,-5995.630000000006,Financial, 
26-Apr-18,1715.73,564039237,,INTER-BANK CREDIT,217283184065554 GOLDEN HAMILTON AND CHANDLER ,-4279.900000000005,Other Income, 
26-Apr-18,480.54,564039237,,INTER-BANK CREDIT,Aguilar PLC,-3799.360000000005,Bills, 
28-Apr-18,-1438.77,564039237,,AUTOMATIC DRAWING,Browning Christensen and Grimes,-5238.130000000005,Other Income, 
28-Apr-18,808.36,564039237,,INTER-BANK CREDIT,402694162632253 WILLIAMS GROUP ,-4429.770000000005,Bills, 
29-Apr-18,935.52,564039237,,INTER-BANK CREDIT,Wilson-West,-3494.250000000005,Uncategorised, 
30-Apr-18,-347.44,564039237,,AUTOMATIC DRAWING,Green-Wood,-3841.690000000005,Financial, 
03-May-18,-875.31,564039237,,TRANSFER DEBIT,328698434317666 FORD BENNETT AND MOORE ,-4717.0000000000055,Bills, 
03-May-18,287.37,564039237,,TRANSFER DEBIT,992596781760378 GONZALES LTD ,-4429.630000000006,Bills, 
06-May-18,1553.94,564039237,,AUTOMATIC DRAWING,Perez-Allen,-2875.6900000000055,Other Income, 
08-May-18,913.4,564039237,,AUTOMATIC DRAWING,410845665840938 MURPHY WELLS AND JOHNSON ,-1962.2900000000054,Other Income, 
08-May-18,440.03,564039237,,TRANSFER DEBIT,975569120949289 REYES PLC ,-1522.2600000000054,Uncategorised, 
09-May-18,-496.15,564039237,,TRANSFER DEBIT,Burns-Campbell,-2018.4100000000053,Financial, 
09-May-18,-909.39,564039237,,AUTOMATIC DRAWING,885150584020546 MARTIN-ANDERSON ,-2927.800000000005,Financial, 
11-May-18,-1522.46,564039237,,TRANSFER DEBIT,Kemp-Miller,-4450.260000000006,Uncategorised, 
12-May-18,1272.88,564039237,,INTER-BANK CREDIT,George-Craig,-3177.3800000000056,Bills, 
15-May-18,1661.86,564039237,,INTER-BANK CREDIT,710012732677953 DICKSON PATTERSON AND GARCIA ,-1515.5200000000057,Bills, 
15-May-18,-957.96,564039237,,AUTOMATIC DRAWING,491578676344833 VARGAS-MCDANIEL ,-2473.480000000006,Uncategorised, 
17-May-18,-464.74,564039237,,INTER-BANK CREDIT,Murray-Martin,-2938.2200000000057,Uncategorised, 
19-May-18,612.77,564039237,,TRANSFER DEBIT,798420399297729 RAY SANDERS AND FULLER ,-2325.4500000000057,Uncategorised, 
22-May-18,1850.34,564039237,,INTER-BANK CREDIT,Lopez-Hess,-475.1100000000058,Uncategorised, 
25-May-18,9.14,564039237,,INTER-BANK CREDIT,674966671413301 COOKE SALAZAR AND ROSS ,-465.9700000000058,Other Income, 
28-May-18,1092.93,564039237,,TRANSFER DEBIT,Gonzalez PLC,626.9599999999942,Other Income, 
28-May-18,-1303.5,564039237,,INTER-BANK CREDIT,Rasmussen-White,-676.5400000000058,Bills, 
31-May-18,638.48,564039237,,INTER-BANK CREDIT,Brooks-Wise,-38.06000000000574,Uncategorised, 
31-May-18,-1028.02,564039237,,INTER-BANK CREDIT,Cochran-White,-1066.0800000000058,Uncategorised, 
03-Jun-18,-1653.62,564039237,,INTER-BANK CREDIT,Parker-Allen,-2719.7000000000057,Financial, 
03-Jun-18,414.73,564039237,,AUTOMATIC DRAWING,983662136825296 THOMPSON AND SONS ,-2304.9700000000057,Bills, 
04-Jun-18,1524.03,564039237,,AUTOMATIC DRAWING,911359938510370 BRIGGS-NEWTON ,-780.9400000000057,Other Income, 
07-Jun-18,-690.4,564039237,,INTER-BANK CREDIT,897312600235049 COOK LTD ,-1471.3400000000056,Uncategorised, 
08-Jun-18,165.17,564039237,,AUTOMATIC DRAWING,Sharp-Roberts,-1306.1700000000055,Bills, 
11-Jun-18,723.41,564039237,,INTER-BANK CREDIT,55037089578668 SPENCE BROWN AND DAY ,-582.7600000000056,Bills, 
11-Jun-18,-291.31,564039237,,TRANSFER DEBIT,349297003811372 CANTRELL BENNETT AND WEAVER ,-874.0700000000056,Other Income, 
13-Jun-18,1154.41,564039237,,INTER-BANK CREDIT,Brown Group,280.33999999999446,Other Income, 
16-Jun-18,-1291.35,564039237,,TRANSFER DEBIT,Nichols Inc,-1011.0100000000054,Uncategorised, 
19-Jun-18,-1324.73,564039237,,INTER-BANK CREDIT,607424277349474 MOORE DAVIS AND HAAS ,-2335.7400000000052,Financial, 
21-Jun-18,702.89,564039237,,AUTOMATIC DRAWING,Dalton Smith and Haley,-1632.8500000000054,Bills, 
21-Jun-18,1303.4,564039237,,AUTOMATIC DRAWING,Walker PLC,-329.4500000000053,Financial, 
23-Jun-18,1210.41,564039237,,INTER-BANK CREDIT,324874655800152 SMITH CORTEZ AND WILLIAMS ,880.9599999999948,Other Income, 
23-Jun-18,-1226.31,564039237,,INTER-BANK CREDIT,954909555239920 CURRY LLC ,-345.35000000000514,Other Income, 
26-Jun-18,-965.48,564039237,,INTER-BANK CREDIT,842795375800700 MARTIN PLC ,-1310.8300000000052,Bills, 
29-Jun-18,-1157.21,564039237,,INTER-BANK CREDIT,Shelton LLC,-2468.0400000000054,Uncategorised, 
01-Jul-18,-285.6,564039237,,TRANSFER DEBIT,Friedman-Williams,-2753.6400000000053,Uncategorised, 
04-Jul-18,-695.71,564039237,,INTER-BANK CREDIT,350210411071699 BENTLEY-ARNOLD ,-3449.3500000000054,Uncategorised, 
04-Jul-18,-57.02,564039237,,INTER-BANK CREDIT,533581521831120 SMITH RAMIREZ AND CORDOVA ,-3506.3700000000053,Uncategorised, 
07-Jul-18,-812.8,564039237,,AUTOMATIC DRAWING,52391490271164 MARTINEZ BOWEN AND PORTER ,-4319.1700000000055,Financial, 
10-Jul-18,962.3,564039237,,AUTOMATIC DRAWING,Reynolds Marshall and Orr,-3356.8700000000053,Uncategorised, 
10-Jul-18,662.41,564039237,,AUTOMATIC DRAWING,983326340803846 MORSE-BROWN ,-2694.4600000000055,Financial, 
12-Jul-18,238.46,564039237,,TRANSFER DEBIT,Baxter Group,-2456.0000000000055,Uncategorised, 
12-Jul-18,-1223.13,564039237,,INTER-BANK CREDIT,867834709385650 WHITE-CUNNINGHAM ,-3679.1300000000056,Financial, 
13-Jul-18,1764.71,564039237,,TRANSFER DEBIT,Hall-Miller,-1914.4200000000055,Uncategorised, 
13-Jul-18,103.23,564039237,,TRANSFER DEBIT,Williams and Sons,-1811.1900000000055,Financial, 
13-Jul-18,-733.39,564039237,,INTER-BANK CREDIT,Freeman Henderson and Cabrera,-2544.5800000000054,Bills, 
16-Jul-18,-208.25,564039237,,TRANSFER DEBIT,288448500745806 MAYO LTD ,-2752.8300000000054,Financial, 
19-Jul-18,341.62,564039237,,AUTOMATIC DRAWING,820136159783186 PORTER LTD ,-2411.2100000000055,Bills, 
22-Jul-18,1864.94,564039237,,INTER-BANK CREDIT,Cole Inc,-546.2700000000054,Bills, 
25-Jul-18,985.15,564039237,,INTER-BANK CREDIT,862943254974504 KRAMER-BARRERA ,438.87999999999454,Uncategorised, 
27-Jul-18,202.71,564039237,,AUTOMATIC DRAWING,Peters Vaughn and Smith,641.5899999999946,Other Income, 
27-Jul-18,1942.57,564039237,,AUTOMATIC DRAWING,Watson Harris and Rosales,2584.1599999999944,Financial, 
29-Jul-18,-582.33,564039237,,INTER-BANK CREDIT,Powell PLC,2001.8299999999945,Financial, 
30-Jul-18,1294.09,564039237,,INTER-BANK CREDIT,739548706326740 LOPEZ GROUP ,3295.9199999999946,Uncategorised, 
31-Jul-18,-83.73,564039237,,AUTOMATIC DRAWING,828080371287349 DAWSON LTD ,3212.1899999999946,Financial, 
03-Aug-18,-877.43,564039237,,INTER-BANK CREDIT,Terry Martinez and Martin,2334.7599999999948,Bills, 
04-Aug-18,-804.5,564039237,,INTER-BANK CREDIT,283261345542629 WALTON INC ,1530.2599999999948,Other Income, 
05-Aug-18,1667.44,564039237,,INTER-BANK CREDIT,Thompson-Sanchez,3197.699999999995,Bills, 
07-Aug-18,-1718.64,564039237,,AUTOMATIC DRAWING,426735145680056 SCOTT KNIGHT AND TORRES ,1479.0599999999947,Financial, 
07-Aug-18,1639.84,564039237,,INTER-BANK CREDIT,Taylor James and Contreras,3118.8999999999946,Financial, 
09-Aug-18,332.08,564039237,,AUTOMATIC DRAWING,Young-Ramos,3450.9799999999946,Other Income, 
09-Aug-18,1301.83,564039237,,INTER-BANK CREDIT,802363145178201 PRESTON-WALKER ,4752.809999999994,Uncategorised, 
12-Aug-18,-1610.34,564039237,,AUTOMATIC DRAWING,Flores Ltd,3142.469999999994,Financial, 
13-Aug-18,1527.56,564039237,,TRANSFER DEBIT,428111257233186 JUAREZ-MCCLAIN ,4670.029999999993,Uncategorised, 
13-Aug-18,-1823.75,564039237,,AUTOMATIC DRAWING,306967039108611 FISHER LTD ,2846.2799999999934,Financial, 
15-Aug-18,1872.55,564039237,,INTER-BANK CREDIT,Navarro LLC,4718.829999999994,Financial, 
15-Aug-18,-1106.97,564039237,,INTER-BANK CREDIT,433700365871385 NICHOLS BARRETT AND NOLAN ,3611.8599999999933,Bills, 
15-Aug-18,1167.07,564039237,,AUTOMATIC DRAWING,961032781398856 MURPHY TURNER AND SANTOS ,4778.929999999993,Bills, 
18-Aug-18,1971.95,564039237,,AUTOMATIC DRAWING,Patel Mckenzie and Wise,6750.879999999993,Financial, 
20-Aug-18,-867.4,564039237,,AUTOMATIC DRAWING,Walton-Allen,5883.479999999993,Uncategorised, 
20-Aug-18,-1953.32,564039237,,INTER-BANK CREDIT,Cook Ramirez and Howell,3930.1599999999935,Bills, 
20-Aug-18,-1663.13,564039237,,AUTOMATIC DRAWING,516957923124584 LEWIS-WATSON ,2267.0299999999934,Financial, 
22-Aug-18,1862.94,564039237,,INTER-BANK CREDIT,119507252524000 REYNOLDS TURNER AND EWING ,4129.969999999994,Uncategorised, 
24-Aug-18,179.88,564039237,,TRANSFER DEBIT,Martin Patel and Whitehead,4309.849999999994,Bills, 
27-Aug-18,236.33,564039237,,INTER-BANK CREDIT,Serrano-Burnett,4546.179999999994,Bills, 
28-Aug-18,1869.92,564039237,,INTER-BANK CREDIT,Wilson Group,6416.099999999994,Uncategorised, 
30-Aug-18,-617.8,564039237,,INTER-BANK CREDIT,Harper Crawford and Perez,5798.299999999994,Financial, 
30-Aug-18,1209.29,564039237,,AUTOMATIC DRAWING,834463050418823 MATTHEWS-PECK ,7007.589999999994,Uncategorised, 
02-Sep-18,-755.45,564039237,,INTER-BANK CREDIT,555615462384869 PEREZ KEMP AND COFFEY ,6252.139999999994,Uncategorised, 
02-Sep-18,798.31,564039237,,INTER-BANK CREDIT,Arellano Harrington and Armstrong,7050.449999999993,Bills, 
02-Sep-18,-1958.98,564039237,,TRANSFER DEBIT,Thomas-Armstrong,5091.469999999994,Bills, 
02-Sep-18,-1726.45,564039237,,INTER-BANK CREDIT,78596172200121 HOWARD-CARROLL ,3365.019999999994,Uncategorised, 
05-Sep-18,-1277.44,564039237,,INTER-BANK CREDIT,341658382013350 HULL AND SONS ,2087.579999999994,Uncategorised, 
08-Sep-18,-631.88,564039237,,AUTOMATIC DRAWING,422069773237058 VARGAS MCBRIDE AND HALL ,1455.699999999994,Other Income, 
08-Sep-18,-1791.11,564039237,,INTER-BANK CREDIT,716238520237469 HARMON BENITEZ AND OSBORNE ,-335.410000000006,Uncategorised, 
10-Sep-18,-1965.87,564039237,,AUTOMATIC DRAWING,Hopkins Newman and Carey,-2301.280000000006,Financial, 
13-Sep-18,-99.34,564039237,,TRANSFER DEBIT,Gross-Bean,-2400.6200000000063,Uncategorised, 
13-Sep-18,1514.39,564039237,,AUTOMATIC DRAWING,Delgado Gordon and Taylor,-886.2300000000062,Bills, 
14-Sep-18,1467.01,564039237,,INTER-BANK CREDIT,423638059425103 RILEY HAHN AND VAZQUEZ ,580.7799999999938,Bills, 
16-Sep-18,-1505.69,564039237,,INTER-BANK CREDIT,660263268428765 LONG LLC ,-924.9100000000062,Uncategorised, 
19-Sep-18,348.56,564039237,,INTER-BANK CREDIT,744487130416855 WARD-ERICKSON ,-576.3500000000063,Bills, 
19-Sep-18,1229.34,564039237,,TRANSFER DEBIT,Garcia-Campos,652.9899999999936,Uncategorised, 
20-Sep-18,859.66,564039237,,AUTOMATIC DRAWING,Baker Jackson and Bates,1512.6499999999937,Bills, 
21-Sep-18,1859.26,564039237,,INTER-BANK CREDIT,28201657915818 BAUER THOMPSON AND PERKINS ,3371.9099999999935,Uncategorised, 
22-Sep-18,-140.32,564039237,,AUTOMATIC DRAWING,White LLC,3231.5899999999933,Other Income, 
25-Sep-18,324.19,564039237,,TRANSFER DEBIT,680661262517494 WRIGHT LEWIS AND SNYDER ,3555.7799999999934,Bills, 
28-Sep-18,1398.95,564039237,,INTER-BANK CREDIT,523444219005138 MCCORMICK RANGEL AND HARRISON ,4954.729999999993,Financial, 
01-Oct-18,712.98,564039237,,INTER-BANK CREDIT,28863249308696 EVANS CANNON AND BENTLEY ,5667.709999999994,Uncategorised, 
02-Oct-18,1741.06,564039237,,TRANSFER DEBIT,Mitchell Inc,7408.769999999993,Other Income, 
02-Oct-18,1833.31,564039237,,INTER-BANK CREDIT,Gentry Ltd,9242.079999999993,Financial, 
04-Oct-18,-1622.7,564039237,,INTER-BANK CREDIT,Ball LLC,7619.379999999993,Financial, 
04-Oct-18,1558.26,564039237,,TRANSFER DEBIT,197939653139844 GRIFFITH-PITTS ,9177.639999999992,Financial, 
06-Oct-18,959.52,564039237,,INTER-BANK CREDIT,Lee Inc,10137.159999999993,Uncategorised, 
06-Oct-18,-1875.25,564039237,,TRANSFER DEBIT,Thomas Williams and Tanner,8261.909999999993,Uncategorised, 
09-Oct-18,-43.52,564039237,,TRANSFER DEBIT,385737118567021 TURNER INC ,8218.389999999992,Financial, 
10-Oct-18,-975.8,564039237,,INTER-BANK CREDIT,192372892361167 MARTINEZ LTD ,7242.589999999992,Financial, 
11-Oct-18,-53.82,564039237,,INTER-BANK CREDIT,216344821926144 RUIZ-TAYLOR ,7188.769999999992,Uncategorised, 
14-Oct-18,441.33,564039237,,INTER-BANK CREDIT,705183823538557 MORRISON SIMMONS AND WILLIAMS ,7630.099999999992,Bills, 
16-Oct-18,-640.03,564039237,,AUTOMATIC DRAWING,Stone Grant and Mejia,6990.069999999992,Uncategorised, 
19-Oct-18,1278.47,564039237,,INTER-BANK CREDIT,679120420139857 ZUNIGA MCCALL AND TUCKER ,8268.539999999992,Other Income, 
21-Oct-18,-590.45,564039237,,INTER-BANK CREDIT,283350195625639 FLETCHER-LOPEZ ,7678.089999999992,Bills, 
23-Oct-18,-650.88,564039237,,TRANSFER DEBIT,Parker-Johnson,7027.209999999992,Financial, 
24-Oct-18,-394.76,564039237,,INTER-BANK CREDIT,9285797117345 BARKER INC ,6632.449999999992,Financial, 
25-Oct-18,-1483.31,564039237,,INTER-BANK CREDIT,Murillo LLC,5149.139999999992,Bills, 
25-Oct-18,1143.96,564039237,,INTER-BANK CREDIT,128161495832271 JOHNSON SCHMIDT AND FORD ,6293.099999999992,Bills, 
28-Oct-18,-511.95,564039237,,INTER-BANK CREDIT,Whitehead White and Anderson,5781.149999999992,Financial, 
29-Oct-18,-928.25,564039237,,INTER-BANK CREDIT,Robertson-Barber,4852.899999999992,Other Income, 
30-Oct-18,131.41,564039237,,INTER-BANK CREDIT,Lewis-Walter,4984.309999999992,Uncategorised, 
30-Oct-18,1445.34,564039237,,INTER-BANK CREDIT,Hampton-Haynes,6429.649999999992,Financial, 
01-Nov-18,-889.29,564039237,,AUTOMATIC DRAWING,Dunn Inc,5540.359999999992,Bills, 
03-Nov-18,-520.88,564039237,,AUTOMATIC DRAWING,Green Reeves and Compton,5019.479999999992,Uncategorised, 
05-Nov-18,1428.89,564039237,,AUTOMATIC DRAWING,Lara Moody and Jenkins,6448.369999999993,Bills, 
05-Nov-18,-1566.02,564039237,,INTER-BANK CREDIT,Henson and Sons,4882.349999999993,Financial, 
08-Nov-18,1150.46,564039237,,AUTOMATIC DRAWING,Torres Jones and Goodman,6032.809999999993,Financial, 
08-Nov-18,-1583.65,564039237,,TRANSFER DEBIT,913704416749978 HUFF KENNEDY AND HALL ,4449.159999999993,Bills, 
10-Nov-18,-16.14,564039237,,AUTOMATIC DRAWING,May Gomez and Shepherd,4433.019999999992,Bills, 
13-Nov-18,2.44,564039237,,INTER-BANK CREDIT,850005291838965 DYER-DIXON ,4435.459999999992,Other Income, 
15-Nov-18,1823.71,564039237,,INTER-BANK CREDIT,848552865493404 WELCH FREEMAN AND SIMMONS ,6259.169999999992,Uncategorised, 
16-Nov-18,372.94,564039237,,INTER-BANK CREDIT,273840310187249 FARMER-MARTIN ,6632.1099999999915,Financial, 
18-Nov-18,176.24,564039237,,TRANSFER DEBIT,304248962037317 MEJIA-MYERS ,6808.349999999991,Bills, 
20-Nov-18,-1228.49,564039237,,AUTOMATIC DRAWING,Jacobs LLC,5579.8599999999915,Other Income, 
21-Nov-18,608.6,564039237,,TRANSFER DEBIT,172077548046947 MENDEZ GRIMES AND LAMBERT ,6188.459999999992,Bills, 
22-Nov-18,56.41,564039237,,INTER-BANK CREDIT,Sheppard Cole and Doyle,6244.869999999992,Bills, 
22-Nov-18,-545.91,564039237,,AUTOMATIC DRAWING,Phillips LLC,5698.959999999992,Uncategorised, 
24-Nov-18,123.8,564039237,,AUTOMATIC DRAWING,594167500802988 JONES-BERRY ,5822.759999999992,Financial, 
25-Nov-18,-839.93,564039237,,INTER-BANK CREDIT,Johnson-Mcdonald,4982.829999999992,Bills, 
27-Nov-18,-1796.73,564039237,,INTER-BANK CREDIT,164432935845285 CHAPMAN WILLIAMS AND DAVIS ,3186.0999999999917,Financial, 
29-Nov-18,754.1,564039237,,INTER-BANK CREDIT,553001996028903 PERRY LLC ,3940.1999999999916,Other Income, 
29-Nov-18,-1860.14,564039237,,TRANSFER DEBIT,Joseph-Sanchez,2080.0599999999913,Uncategorised, 
30-Nov-18,-1950.28,564039237,,TRANSFER DEBIT,Carey-Armstrong,129.77999999999133,Bills, 
01-Dec-18,-1881.85,564039237,,INTER-BANK CREDIT,Perez-Sellers,-1752.0700000000086,Financial, 
03-Dec-18,424.32,564039237,,TRANSFER DEBIT,Nash PLC,-1327.7500000000086,Bills, 
05-Dec-18,559.44,564039237,,INTER-BANK CREDIT,Peterson Walton and Peterson,-768.3100000000086,Bills, 
06-Dec-18,1010.54,564039237,,INTER-BANK CREDIT,Nguyen Montoya and Romero,242.22999999999138,Financial, 
07-Dec-18,1350.37,564039237,,AUTOMATIC DRAWING,Fowler and Sons,1592.5999999999913,Financial, 
07-Dec-18,1838.41,564039237,,TRANSFER DEBIT,792581404551848 GALLOWAY-MUNOZ ,3431.009999999991,Uncategorised, 
09-Dec-18,-1747.73,564039237,,INTER-BANK CREDIT,Miller-Chapman,1683.279999999991,Uncategorised, 
12-Dec-18,-1145.41,564039237,,AUTOMATIC DRAWING,653639776221685 KENNEDY SANCHEZ AND MILLER ,537.869999999991,Financial, 
15-Dec-18,-455.47,564039237,,AUTOMATIC DRAWING,Morgan Inc,82.399999999991,Uncategorised, 
15-Dec-18,-1716.66,564039237,,INTER-BANK CREDIT,212006188372924 MILLER PLC ,-1634.260000000009,Financial, 
16-Dec-18,-194.26,564039237,,INTER-BANK CREDIT,Powell Butler and Barnes,-1828.520000000009,Other Income, 
17-Dec-18,1302.69,564039237,,INTER-BANK CREDIT,438507948979251 CLINE-SMITH ,-525.830000000009,Uncategorised, 
19-Dec-18,179.18,564039237,,INTER-BANK CREDIT,185587837618444 KING COLLINS AND GREER ,-346.650000000009,Uncategorised, 
20-Dec-18,235.45,564039237,,INTER-BANK CREDIT,Choi Pratt and Burnett,-111.20000000000903,Other Income, 
21-Dec-18,1247.51,564039237,,INTER-BANK CREDIT,227398404630292 SPENCE LLC ,1136.3099999999909,Other Income, 
23-Dec-18,-1732.25,564039237,,INTER-BANK CREDIT,Evans Smith and Foster,-595.9400000000091,Uncategorised, 
23-Dec-18,1643.5,564039237,,INTER-BANK CREDIT,554870529508513 PINEDA MITCHELL AND HILL ,1047.5599999999909,Uncategorised, 
