Date,Amount,Account Number,,Transaction Type,Transaction Details,Balance,Category,Merchant Name
23-Dec-17,720.3,488663959,,INTER-BANK CREDIT,Robinson Abbott and Salazar,4312.67,Uncategorised, 
24-Dec-17,832.57,488663959,,INTER-BANK CREDIT,Gonzalez Wilson and Pitts,5145.24,Financial, 
25-Dec-17,-631.34,488663959,,INTER-BANK CREDIT,Dickerson LLC,4513.9,Bills, 
25-Dec-17,-1731.15,488663959,,INTER-BANK CREDIT,988688859626239 ADAMS-BRAUN ,2782.7499999999995,Financial, 
27-Dec-17,-922.94,488663959,,TRANSFER DEBIT,Allen PLC,1859.8099999999995,Financial, 
29-Dec-17,673.61,488663959,,TRANSFER DEBIT,Bennett Ltd,2533.4199999999996,Uncategorised, 
29-Dec-17,1875.49,488663959,,INTER-BANK CREDIT,242799645577025 ZIMMERMAN-WALSH ,4408.91,Bills, 
01-Jan-18,1559.27,488663959,,AUTOMATIC DRAWING,877132162925392 ALVAREZ GROUP ,5968.18,Other Income, 
02-Jan-18,1730.13,488663959,,INTER-BANK CREDIT,Kelly Barnes and Diaz,7698.31,Financial, 
05-Jan-18,-1260.02,488663959,,TRANSFER DEBIT,757523315983331 MARTINEZ VANG AND BROWN ,6438.290000000001,Other Income, 
08-Jan-18,-1040.84,488663959,,INTER-BANK CREDIT,Payne Garcia and Robertson,5397.450000000001,Financial, 
11-Jan-18,1771.9,488663959,,AUTOMATIC DRAWING,Stevens PLC,7169.35,Other Income, 
12-Jan-18,-860.5,488663959,,INTER-BANK CREDIT,Stephens Hart and Watkins,6308.85,Other Income, 
14-Jan-18,1173.59,488663959,,TRANSFER DEBIT,543114580447085 HOLT-HARMON ,7482.4400000000005,Bills, 
17-Jan-18,1501.69,488663959,,INTER-BANK CREDIT,974418185519843 HARRIS INC ,8984.130000000001,Other Income, 
17-Jan-18,126.03,488663959,,INTER-BANK CREDIT,Perez PLC,9110.160000000002,Bills, 
17-Jan-18,-4.95,488663959,,TRANSFER DEBIT,575794969843251 NEAL-PACE ,9105.210000000001,Uncategorised, 
17-Jan-18,1889.34,488663959,,AUTOMATIC DRAWING,534661614186335 WARNER MARTIN AND HALEY ,10994.550000000001,Other Income, 
20-Jan-18,-1250.45,488663959,,AUTOMATIC DRAWING,876491455030689 WONG-BROWN ,9744.1,Bills, 
23-Jan-18,-1148.67,488663959,,TRANSFER DEBIT,263028614544123 SANTANA GROUP ,8595.43,Bills, 
26-Jan-18,1099.82,488663959,,AUTOMATIC DRAWING,183604540302922 TAYLOR JONES AND SHAH ,9695.25,Uncategorised, 
29-Jan-18,1602.28,488663959,,TRANSFER DEBIT,King-Butler,11297.53,Uncategorised, 
30-Jan-18,-581.13,488663959,,TRANSFER DEBIT,Shaffer-Hernandez,10716.400000000001,Uncategorised, 
31-Jan-18,-751.73,488663959,,INTER-BANK CREDIT,Nelson-Hall,9964.670000000002,Financial, 
02-Feb-18,930.81,488663959,,AUTOMATIC DRAWING,Castaneda and Sons,10895.480000000001,Uncategorised, 
03-Feb-18,2.62,488663959,,TRANSFER DEBIT,Maynard Inc,10898.100000000002,Bills, 
04-Feb-18,184.2,488663959,,AUTOMATIC DRAWING,Turner Inc,11082.300000000003,Financial, 
06-Feb-18,-1876.87,488663959,,INTER-BANK CREDIT,Patton Scott and Thornton,9205.430000000004,Other Income, 
09-Feb-18,-142.82,488663959,,INTER-BANK CREDIT,72004909524191 MULLINS VILLANUEVA AND GONZALEZ ,9062.610000000004,Financial, 
09-Feb-18,1787.65,488663959,,INTER-BANK CREDIT,410352854857167 PORTER AND SONS ,10850.260000000004,Other Income, 
10-Feb-18,-476.75,488663959,,INTER-BANK CREDIT,Obrien Inc,10373.510000000004,Other Income, 
12-Feb-18,-583.39,488663959,,AUTOMATIC DRAWING,Meyers Delacruz and Davis,9790.120000000004,Other Income, 
13-Feb-18,247.23,488663959,,AUTOMATIC DRAWING,Duncan Myers and Lee,10037.350000000004,Bills, 
13-Feb-18,1318.63,488663959,,INTER-BANK CREDIT,Saunders LLC,11355.980000000003,Financial, 
15-Feb-18,615.26,488663959,,INTER-BANK CREDIT,Martin Pacheco and Wright,11971.240000000003,Uncategorised, 
18-Feb-18,-1599.8,488663959,,INTER-BANK CREDIT,155071165183880 WARREN-WALKER ,10371.440000000004,Financial, 
21-Feb-18,-1317.13,488663959,,AUTOMATIC DRAWING,Jacobson Massey and Lynn,9054.310000000005,Uncategorised, 
22-Feb-18,1444.45,488663959,,INTER-BANK CREDIT,752562542478579 MORRIS INC ,10498.760000000006,Financial, 
22-Feb-18,-1751.86,488663959,,AUTOMATIC DRAWING,Green and Sons,8746.900000000005,Financial, 
24-Feb-18,760.72,488663959,,INTER-BANK CREDIT,Kelley Rivera and Gaines,9507.620000000004,Financial, 
24-Feb-18,1826.3,488663959,,INTER-BANK CREDIT,Hall Brown and Graham,11333.920000000004,Other Income, 
27-Feb-18,-181.65,488663959,,INTER-BANK CREDIT,Wilson-Delgado,11152.270000000004,Uncategorised, 
02-Mar-18,1802.95,488663959,,INTER-BANK CREDIT,Allen PLC,12955.220000000005,Financial, 
02-Mar-18,185.91,488663959,,INTER-BANK CREDIT,Jones Serrano and Wong,13141.130000000005,Other Income, 
02-Mar-18,-1371.39,488663959,,INTER-BANK CREDIT,507206041532557 PEREZ JOHNSON AND BOOKER ,11769.740000000005,Other Income, 
03-Mar-18,-57.21,488663959,,TRANSFER DEBIT,Allen LLC,11712.530000000006,Uncategorised, 
04-Mar-18,-1065.79,488663959,,AUTOMATIC DRAWING,Thompson-Perkins,10646.740000000005,Bills, 
07-Mar-18,-1789.81,488663959,,INTER-BANK CREDIT,Jones-Morris,8856.930000000006,Bills, 
07-Mar-18,-1071.72,488663959,,AUTOMATIC DRAWING,350353292572165 WYATT GROUP ,7785.2100000000055,Bills, 
10-Mar-18,1116.11,488663959,,INTER-BANK CREDIT,522976942493115 REEVES PLC ,8901.320000000005,Other Income, 
10-Mar-18,1257.27,488663959,,TRANSFER DEBIT,Mason-Silva,10158.590000000006,Financial, 
13-Mar-18,-1004.38,488663959,,TRANSFER DEBIT,Gonzalez Gilbert and Howell,9154.210000000006,Other Income, 
13-Mar-18,-1950.02,488663959,,TRANSFER DEBIT,212447345423242 RICE CAMPBELL AND STEWART ,7204.190000000006,Financial, 
16-Mar-18,965.59,488663959,,TRANSFER DEBIT,Vaughn-Hodge,8169.780000000006,Uncategorised, 
18-Mar-18,365.62,488663959,,INTER-BANK CREDIT,168484040791994 HAMILTON-JOHNSON ,8535.400000000007,Financial, 
19-Mar-18,-1131.24,488663959,,AUTOMATIC DRAWING,Williams Thomas and Bernard,7404.160000000007,Bills, 
21-Mar-18,1029.07,488663959,,TRANSFER DEBIT,Hayes-Miller,8433.230000000007,Financial, 
21-Mar-18,1493.68,488663959,,INTER-BANK CREDIT,104052672719830 DIAZ MERCER AND MURRAY ,9926.910000000007,Other Income, 
23-Mar-18,-834.67,488663959,,INTER-BANK CREDIT,Wright Group,9092.240000000007,Uncategorised, 
26-Mar-18,1827.02,488663959,,TRANSFER DEBIT,Howell PLC,10919.260000000007,Financial, 
28-Mar-18,-1720.13,488663959,,AUTOMATIC DRAWING,522632936580538 BRUCE-SOLIS ,9199.130000000008,Bills, 
31-Mar-18,-1919.35,488663959,,INTER-BANK CREDIT,300822005172555 CAMPBELL LLC ,7279.780000000008,Financial, 
31-Mar-18,-16.26,488663959,,AUTOMATIC DRAWING,White-Johnson,7263.520000000008,Bills, 
03-Apr-18,96.85,488663959,,TRANSFER DEBIT,Simon Ltd,7360.370000000008,Financial, 
04-Apr-18,1274.52,488663959,,INTER-BANK CREDIT,Edwards-Lamb,8634.890000000009,Uncategorised, 
04-Apr-18,821.39,488663959,,AUTOMATIC DRAWING,679414740743378 SIMMONS GROUP ,9456.280000000008,Other Income, 
04-Apr-18,623.85,488663959,,INTER-BANK CREDIT,Butler Cole and Holden,10080.130000000008,Uncategorised, 
04-Apr-18,-981.79,488663959,,TRANSFER DEBIT,588227934639939 JOHNSON-RODRIGUEZ ,9098.340000000007,Financial, 
05-Apr-18,959.89,488663959,,TRANSFER DEBIT,241805846533231 REID JOHNSON AND FISHER ,10058.230000000007,Other Income, 
07-Apr-18,202.4,488663959,,INTER-BANK CREDIT,Wright PLC,10260.630000000006,Financial, 
08-Apr-18,1767.21,488663959,,AUTOMATIC DRAWING,642958404830094 DURHAM INC ,12027.840000000007,Bills, 
11-Apr-18,790.04,488663959,,INTER-BANK CREDIT,824542981461750 WALLACE-FRIEDMAN ,12817.880000000008,Bills, 
13-Apr-18,-1628.58,488663959,,INTER-BANK CREDIT,794941284565033 ADAMS-BISHOP ,11189.300000000008,Uncategorised, 
14-Apr-18,1142.33,488663959,,INTER-BANK CREDIT,89817133980590 HAYES HALL AND DAVIS ,12331.630000000008,Other Income, 
15-Apr-18,446.26,488663959,,INTER-BANK CREDIT,Griffin-Rodriguez,12777.890000000009,Uncategorised, 
17-Apr-18,-946.31,488663959,,INTER-BANK CREDIT,586698927150954 FISCHER ESTRADA AND HARDING ,11831.580000000009,Financial, 
19-Apr-18,1702.03,488663959,,INTER-BANK CREDIT,Cooper PLC,13533.61000000001,Financial, 
21-Apr-18,865.18,488663959,,AUTOMATIC DRAWING,10960419043570 FOX LLC ,14398.79000000001,Financial, 
22-Apr-18,1852.42,488663959,,INTER-BANK CREDIT,Smith-Hernandez,16251.21000000001,Financial, 
25-Apr-18,-1374.81,488663959,,AUTOMATIC DRAWING,Swanson-Medina,14876.40000000001,Bills, 
26-Apr-18,1187.9,488663959,,AUTOMATIC DRAWING,308473455695649 WARD-HILL ,16064.30000000001,Bills, 
27-Apr-18,-1753.38,488663959,,INTER-BANK CREDIT,928657169375341 HARMON-MCINTOSH ,14310.92000000001,Uncategorised, 
28-Apr-18,-515.45,488663959,,AUTOMATIC DRAWING,Mendez LLC,13795.470000000008,Other Income, 
01-May-18,36.19,488663959,,INTER-BANK CREDIT,Smith-Thompson,13831.660000000009,Uncategorised, 
03-May-18,306.69,488663959,,INTER-BANK CREDIT,Johnson Baker and Smith,14138.35000000001,Bills, 
03-May-18,213.31,488663959,,INTER-BANK CREDIT,784538417313941 SAMPSON LLC ,14351.660000000009,Uncategorised, 
06-May-18,-1464.68,488663959,,TRANSFER DEBIT,Floyd Herrera and Woods,12886.980000000009,Other Income, 
09-May-18,1708.66,488663959,,TRANSFER DEBIT,92924546441782 HOOVER INC ,14595.640000000009,Other Income, 
12-May-18,-1274.61,488663959,,TRANSFER DEBIT,Reese-Davis,13321.030000000008,Bills, 
12-May-18,-1729.28,488663959,,INTER-BANK CREDIT,Rivera and Sons,11591.750000000007,Other Income, 
14-May-18,-42.06,488663959,,TRANSFER DEBIT,695927316143428 HENSLEY-ALLEN ,11549.690000000008,Financial, 
15-May-18,-589.75,488663959,,AUTOMATIC DRAWING,Wilson Inc,10959.940000000008,Financial, 
15-May-18,1792.65,488663959,,AUTOMATIC DRAWING,Newman Inc,12752.590000000007,Bills, 
17-May-18,308.76,488663959,,INTER-BANK CREDIT,392349003149258 PRICE AND SONS ,13061.350000000008,Other Income, 
18-May-18,-556.52,488663959,,INTER-BANK CREDIT,951406878171048 MCGEE-RICHARDS ,12504.830000000007,Bills, 
18-May-18,-817.69,488663959,,INTER-BANK CREDIT,Wolf Clayton and Orozco,11687.140000000007,Other Income, 
20-May-18,1284.23,488663959,,AUTOMATIC DRAWING,Hoffman and Sons,12971.370000000006,Bills, 
22-May-18,-1896.12,488663959,,AUTOMATIC DRAWING,Pitts-Bell,11075.250000000007,Financial, 
22-May-18,623.68,488663959,,TRANSFER DEBIT,Wood Holder and Warren,11698.930000000008,Bills, 
25-May-18,671.25,488663959,,INTER-BANK CREDIT,Schwartz-Galvan,12370.180000000008,Bills, 
25-May-18,-1525.52,488663959,,INTER-BANK CREDIT,528822936767139 BUCK WRIGHT AND COOPER ,10844.660000000007,Bills, 
26-May-18,600.48,488663959,,INTER-BANK CREDIT,203551367077477 CHAMBERS-ANDREWS ,11445.140000000007,Bills, 
28-May-18,1283.83,488663959,,INTER-BANK CREDIT,Peterson Lee and Ellis,12728.970000000007,Bills, 
31-May-18,1396.38,488663959,,AUTOMATIC DRAWING,Graves LLC,14125.350000000006,Financial, 
02-Jun-18,1760.77,488663959,,TRANSFER DEBIT,Wilson-Tucker,15886.120000000006,Bills, 
05-Jun-18,-1320.56,488663959,,TRANSFER DEBIT,229960853296377 MARSHALL NELSON AND MORA ,14565.560000000007,Bills, 
07-Jun-18,-1297.91,488663959,,INTER-BANK CREDIT,150154263890751 STEPHENS-SHERMAN ,13267.650000000007,Uncategorised, 
10-Jun-18,111.18,488663959,,AUTOMATIC DRAWING,825898319054821 LOGAN-WONG ,13378.830000000007,Financial, 
11-Jun-18,525.37,488663959,,AUTOMATIC DRAWING,103458607441215 CALHOUN GROUP ,13904.200000000008,Other Income, 
13-Jun-18,488.63,488663959,,AUTOMATIC DRAWING,709157215428564 SILVA LTD ,14392.830000000007,Uncategorised, 
16-Jun-18,345.79,488663959,,INTER-BANK CREDIT,304067932294126 JOHNSON PLC ,14738.620000000008,Uncategorised, 
18-Jun-18,1693.1,488663959,,TRANSFER DEBIT,Miller and Sons,16431.72000000001,Financial, 
20-Jun-18,548.17,488663959,,AUTOMATIC DRAWING,793541295569416 MITCHELL-BROWN ,16979.890000000007,Other Income, 
21-Jun-18,748.88,488663959,,INTER-BANK CREDIT,Grimes-Williams,17728.770000000008,Uncategorised, 
24-Jun-18,-307.89,488663959,,TRANSFER DEBIT,696126553744988 SAVAGE-RICHARDS ,17420.88000000001,Bills, 
26-Jun-18,-45.74,488663959,,INTER-BANK CREDIT,Tucker Vega and Davis,17375.140000000007,Bills, 
28-Jun-18,948.56,488663959,,INTER-BANK CREDIT,825609229162812 SMITH LLC ,18323.700000000008,Bills, 
30-Jun-18,-1566.53,488663959,,AUTOMATIC DRAWING,Evans Haynes and Hudson,16757.17000000001,Financial, 
30-Jun-18,125.89,488663959,,INTER-BANK CREDIT,406354315513130 COX-FROST ,16883.06000000001,Uncategorised, 
03-Jul-18,1615.83,488663959,,TRANSFER DEBIT,Doyle Vaughn and Garcia,18498.890000000007,Bills, 
04-Jul-18,1960.76,488663959,,TRANSFER DEBIT,107851753515789 WILLIAMS-SMITH ,20459.650000000005,Bills, 
05-Jul-18,718.31,488663959,,INTER-BANK CREDIT,Ashley Hernandez and Williams,21177.960000000006,Financial, 
06-Jul-18,-1826.03,488663959,,TRANSFER DEBIT,821534459664101 CASTILLO-ZIMMERMAN ,19351.930000000008,Other Income, 
09-Jul-18,-1620.81,488663959,,INTER-BANK CREDIT,Wilson-Mitchell,17731.120000000006,Bills, 
12-Jul-18,-1261.8,488663959,,AUTOMATIC DRAWING,263934298067292 TUCKER CARTER AND MORRIS ,16469.320000000007,Other Income, 
15-Jul-18,-480.67,488663959,,TRANSFER DEBIT,580975715058139 JACKSON JOHNSON AND CLARK ,15988.650000000007,Bills, 
17-Jul-18,-1035.85,488663959,,TRANSFER DEBIT,Michael LLC,14952.800000000007,Financial, 
20-Jul-18,1714.4,488663959,,AUTOMATIC DRAWING,868560920470746 THOMAS INC ,16667.200000000008,Bills, 
23-Jul-18,-1257.09,488663959,,AUTOMATIC DRAWING,Anderson-Thompson,15410.110000000008,Other Income, 
24-Jul-18,-1058.43,488663959,,TRANSFER DEBIT,661400362903213 TYLER INC ,14351.680000000008,Financial, 
26-Jul-18,-961.67,488663959,,AUTOMATIC DRAWING,897070078905856 SHAFFER-MAY ,13390.010000000007,Other Income, 
28-Jul-18,-131.14,488663959,,INTER-BANK CREDIT,903517358227114 OWEN-GALLAGHER ,13258.870000000008,Financial, 
28-Jul-18,1204.46,488663959,,INTER-BANK CREDIT,15297579913239 ROSS PLC ,14463.330000000009,Other Income, 
28-Jul-18,614.11,488663959,,INTER-BANK CREDIT,304307003841088 CASEY-CASTILLO ,15077.44000000001,Uncategorised, 
28-Jul-18,1791.49,488663959,,AUTOMATIC DRAWING,Pineda LLC,16868.93000000001,Uncategorised, 
28-Jul-18,-490.15,488663959,,INTER-BANK CREDIT,Greer-Martin,16378.780000000012,Other Income, 
28-Jul-18,-33.79,488663959,,TRANSFER DEBIT,Gomez Norman and Pham,16344.99000000001,Financial, 
29-Jul-18,-1129.68,488663959,,INTER-BANK CREDIT,967802399986446 DEAN-EVANS ,15215.31000000001,Uncategorised, 
30-Jul-18,-130.99,488663959,,AUTOMATIC DRAWING,Guzman-Weaver,15084.32000000001,Uncategorised, 
31-Jul-18,800.24,488663959,,INTER-BANK CREDIT,461202528331165 COLE GROUP ,15884.56000000001,Bills, 
02-Aug-18,-1029.26,488663959,,AUTOMATIC DRAWING,723018681179482 MERCER AND SONS ,14855.30000000001,Other Income, 
03-Aug-18,-1426.17,488663959,,AUTOMATIC DRAWING,533075391454609 WILSON REID AND WHITE ,13429.13000000001,Other Income, 
05-Aug-18,-1720.95,488663959,,AUTOMATIC DRAWING,70735699747580 KELLY LTD ,11708.18000000001,Uncategorised, 
07-Aug-18,519.74,488663959,,TRANSFER DEBIT,Johnston-Brown,12227.92000000001,Other Income, 
10-Aug-18,-37.44,488663959,,INTER-BANK CREDIT,Taylor-Zamora,12190.480000000009,Financial, 
12-Aug-18,1931.51,488663959,,AUTOMATIC DRAWING,514335907696996 BENJAMIN THOMAS AND SNYDER ,14121.990000000009,Uncategorised, 
14-Aug-18,1734.06,488663959,,AUTOMATIC DRAWING,632005265795561 CARTER-LIVINGSTON ,15856.050000000008,Bills, 
14-Aug-18,1475.85,488663959,,TRANSFER DEBIT,163609318850447 WOLF-NICHOLS ,17331.90000000001,Bills, 
16-Aug-18,-381.04,488663959,,AUTOMATIC DRAWING,150468935475432 POTTS VEGA AND ORTIZ ,16950.860000000008,Financial, 
17-Aug-18,900.39,488663959,,TRANSFER DEBIT,Brown LLC,17851.250000000007,Financial, 
18-Aug-18,-972.04,488663959,,TRANSFER DEBIT,634830113896457 TAYLOR AND SONS ,16879.210000000006,Other Income, 
19-Aug-18,1426.83,488663959,,INTER-BANK CREDIT,441844447015587 GREENE-DIAZ ,18306.040000000008,Other Income, 
21-Aug-18,-1920.95,488663959,,INTER-BANK CREDIT,683104438376758 MENDOZA DELGADO AND MURPHY ,16385.090000000007,Bills, 
21-Aug-18,1544.85,488663959,,AUTOMATIC DRAWING,Allen-Bond,17929.940000000006,Other Income, 
22-Aug-18,-1546.29,488663959,,INTER-BANK CREDIT,117389586010916 WASHINGTON-SHAH ,16383.650000000005,Uncategorised, 
25-Aug-18,1177.86,488663959,,INTER-BANK CREDIT,716921628876131 BERGER-POWELL ,17561.510000000006,Financial, 
25-Aug-18,-483.81,488663959,,INTER-BANK CREDIT,Long PLC,17077.700000000004,Bills, 
28-Aug-18,-1844.82,488663959,,AUTOMATIC DRAWING,Klein Fritz and Oneal,15232.880000000005,Other Income, 
31-Aug-18,1956.0,488663959,,AUTOMATIC DRAWING,706734628601651 ROBERTS RODRIGUEZ AND RUSSO ,17188.880000000005,Uncategorised, 
01-Sep-18,580.17,488663959,,TRANSFER DEBIT,57584207670970 ZAMORA GROUP ,17769.050000000003,Financial, 
01-Sep-18,-1122.18,488663959,,AUTOMATIC DRAWING,963282484976729 BURKE-FLEMING ,16646.870000000003,Bills, 
01-Sep-18,1293.49,488663959,,INTER-BANK CREDIT,803086046463267 ROCHA-DURAN ,17940.360000000004,Bills, 
03-Sep-18,1530.77,488663959,,INTER-BANK CREDIT,Potter and Sons,19471.130000000005,Uncategorised, 
05-Sep-18,-58.95,488663959,,TRANSFER DEBIT,Hansen Harris and Morgan,19412.180000000004,Uncategorised, 
08-Sep-18,633.36,488663959,,INTER-BANK CREDIT,219012800890321 LEON-GARCIA ,20045.540000000005,Other Income, 
10-Sep-18,1594.13,488663959,,TRANSFER DEBIT,922235900772282 MORENO INC ,21639.670000000006,Bills, 
13-Sep-18,-1382.77,488663959,,TRANSFER DEBIT,109881106627679 ROWE-NEWMAN ,20256.900000000005,Other Income, 
13-Sep-18,1149.74,488663959,,INTER-BANK CREDIT,809542746902588 HERNANDEZ-WILSON ,21406.640000000007,Bills, 
13-Sep-18,991.05,488663959,,INTER-BANK CREDIT,289769475228518 BARR-CUNNINGHAM ,22397.690000000006,Bills, 
13-Sep-18,-562.73,488663959,,AUTOMATIC DRAWING,909369509600704 TAYLOR HOGAN AND CARSON ,21834.960000000006,Bills, 
14-Sep-18,-229.19,488663959,,TRANSFER DEBIT,Mitchell-Bryant,21605.770000000008,Other Income, 
14-Sep-18,595.72,488663959,,INTER-BANK CREDIT,859797815661266 YOUNG AND SONS ,22201.49000000001,Uncategorised, 
17-Sep-18,-1269.08,488663959,,TRANSFER DEBIT,Lowe Soto and Dennis,20932.41000000001,Financial, 
20-Sep-18,94.67,488663959,,INTER-BANK CREDIT,404051834790706 HAYDEN LTD ,21027.08000000001,Uncategorised, 
21-Sep-18,-1502.55,488663959,,TRANSFER DEBIT,974314489957193 KIM DAVIS AND CHANDLER ,19524.53000000001,Financial, 
22-Sep-18,600.33,488663959,,INTER-BANK CREDIT,355836806134642 DECKER FRANK AND JAMES ,20124.86000000001,Uncategorised, 
22-Sep-18,-1894.94,488663959,,AUTOMATIC DRAWING,Williams-Fry,18229.920000000013,Uncategorised, 
23-Sep-18,1203.06,488663959,,INTER-BANK CREDIT,103331438737766 KELLY-WILSON ,19432.980000000014,Uncategorised, 
23-Sep-18,-1871.22,488663959,,INTER-BANK CREDIT,Sanchez Ltd,17561.760000000013,Other Income, 
25-Sep-18,-1656.78,488663959,,INTER-BANK CREDIT,Maddox-Harrison,15904.980000000012,Uncategorised, 
28-Sep-18,522.21,488663959,,TRANSFER DEBIT,Sanchez-Bell,16427.190000000013,Uncategorised, 
28-Sep-18,-240.66,488663959,,AUTOMATIC DRAWING,Mccoy PLC,16186.530000000013,Uncategorised, 
01-Oct-18,919.68,488663959,,INTER-BANK CREDIT,396139997115765 ALI-JOHNSTON ,17106.210000000014,Uncategorised, 
02-Oct-18,-63.4,488663959,,INTER-BANK CREDIT,411929587323260 PRICE-THOMAS ,17042.810000000012,Other Income, 
04-Oct-18,1036.12,488663959,,INTER-BANK CREDIT,667412287382580 SANCHEZ-PATEL ,18078.93000000001,Other Income, 
04-Oct-18,-417.19,488663959,,AUTOMATIC DRAWING,507932251015101 BROOKS STANLEY AND SALAZAR ,17661.740000000013,Uncategorised, 
06-Oct-18,-739.47,488663959,,TRANSFER DEBIT,Morgan-Torres,16922.27000000001,Financial, 
08-Oct-18,-403.29,488663959,,INTER-BANK CREDIT,Gilbert and Sons,16518.98000000001,Bills, 
09-Oct-18,1524.43,488663959,,INTER-BANK CREDIT,323690367254335 LAMB DAVIS AND JOHNSON ,18043.41000000001,Uncategorised, 
10-Oct-18,1371.4,488663959,,AUTOMATIC DRAWING,Martin PLC,19414.810000000012,Bills, 
11-Oct-18,-1197.92,488663959,,INTER-BANK CREDIT,Schmidt Group,18216.890000000014,Bills, 
11-Oct-18,-1246.98,488663959,,TRANSFER DEBIT,Woods Smith and Houston,16969.910000000014,Financial, 
13-Oct-18,-1671.8,488663959,,INTER-BANK CREDIT,Jones-Hall,15298.110000000015,Other Income, 
16-Oct-18,1544.23,488663959,,INTER-BANK CREDIT,549734386984874 NOVAK WEAVER AND DANIEL ,16842.340000000015,Other Income, 
18-Oct-18,-1212.54,488663959,,INTER-BANK CREDIT,Taylor PLC,15629.800000000014,Uncategorised, 
20-Oct-18,-74.81,488663959,,INTER-BANK CREDIT,Baird-Scott,15554.990000000014,Bills, 
22-Oct-18,-722.92,488663959,,INTER-BANK CREDIT,Davis-West,14832.070000000014,Uncategorised, 
23-Oct-18,502.59,488663959,,TRANSFER DEBIT,436367561383463 STOKES-PORTER ,15334.660000000014,Uncategorised, 
23-Oct-18,-781.94,488663959,,TRANSFER DEBIT,Davila PLC,14552.720000000014,Financial, 
24-Oct-18,1450.52,488663959,,AUTOMATIC DRAWING,Small-Patel,16003.240000000014,Bills, 
25-Oct-18,-361.26,488663959,,AUTOMATIC DRAWING,174667783275645 GARCIA LLC ,15641.980000000014,Bills, 
28-Oct-18,-31.48,488663959,,INTER-BANK CREDIT,419794678627302 CHAVEZ GROUP ,15610.500000000015,Other Income, 
29-Oct-18,-1197.97,488663959,,TRANSFER DEBIT,Marsh Group,14412.530000000015,Financial, 
30-Oct-18,52.16,488663959,,INTER-BANK CREDIT,Beltran and Sons,14464.690000000015,Financial, 
01-Nov-18,-214.27,488663959,,AUTOMATIC DRAWING,Yates-Pope,14250.420000000015,Uncategorised, 
01-Nov-18,-541.47,488663959,,AUTOMATIC DRAWING,357589862391282 DAVIS-FOX ,13708.950000000015,Other Income, 
04-Nov-18,-1336.91,488663959,,AUTOMATIC DRAWING,247227173330396 TURNER SUTTON AND WOODS ,12372.040000000015,Other Income, 
07-Nov-18,105.45,488663959,,AUTOMATIC DRAWING,178708374851034 JONES-WILKINSON ,12477.490000000016,Financial, 
08-Nov-18,-1953.8,488663959,,AUTOMATIC DRAWING,928386581855235 SUAREZ INC ,10523.690000000017,Bills, 
10-Nov-18,405.27,488663959,,INTER-BANK CREDIT,775825747259931 FLOYD-SMITH ,10928.960000000017,Uncategorised, 
11-Nov-18,-215.97,488663959,,INTER-BANK CREDIT,634456495804682 MUELLER GROUP ,10712.990000000018,Other Income, 
14-Nov-18,1433.6,488663959,,AUTOMATIC DRAWING,235531225710231 JOHNSON INC ,12146.590000000018,Uncategorised, 
16-Nov-18,-558.85,488663959,,TRANSFER DEBIT,687988496346009 BECK-ROGERS ,11587.740000000018,Bills, 
18-Nov-18,-285.94,488663959,,INTER-BANK CREDIT,Ballard-Lopez,11301.800000000017,Other Income, 
18-Nov-18,519.9,488663959,,INTER-BANK CREDIT,Scott Stevenson and Schwartz,11821.700000000017,Uncategorised, 
20-Nov-18,995.51,488663959,,INTER-BANK CREDIT,159081891222635 SWEENEY GROUP ,12817.210000000017,Bills, 
23-Nov-18,-1330.62,488663959,,INTER-BANK CREDIT,522242161009997 WILLIAMS PLC ,11486.590000000018,Uncategorised, 
23-Nov-18,-1187.29,488663959,,TRANSFER DEBIT,394004963224517 CARNEY ROBINSON AND YOUNG ,10299.300000000017,Other Income, 
24-Nov-18,-1296.9,488663959,,INTER-BANK CREDIT,Wheeler-Walker,9002.400000000018,Uncategorised, 
26-Nov-18,-1467.48,488663959,,INTER-BANK CREDIT,693503132184266 SIMMONS-MURPHY ,7534.920000000018,Other Income, 
27-Nov-18,1881.04,488663959,,INTER-BANK CREDIT,Ramos Ltd,9415.960000000017,Bills, 
30-Nov-18,-747.47,488663959,,INTER-BANK CREDIT,204790208338882 HINTON PLC ,8668.490000000018,Uncategorised, 
02-Dec-18,-1032.97,488663959,,TRANSFER DEBIT,Benton Crawford and Molina,7635.520000000018,Bills, 
05-Dec-18,1126.89,488663959,,INTER-BANK CREDIT,Bradley-Chan,8762.410000000018,Financial, 
06-Dec-18,-327.7,488663959,,TRANSFER DEBIT,Gray LLC,8434.710000000017,Uncategorised, 
07-Dec-18,11.98,488663959,,INTER-BANK CREDIT,398508224485716 MILLER AND SONS ,8446.690000000017,Financial, 
09-Dec-18,1824.17,488663959,,TRANSFER DEBIT,813246866440280 ELLIOTT MILLS AND THOMPSON ,10270.860000000017,Financial, 
10-Dec-18,-1190.63,488663959,,TRANSFER DEBIT,512824984172827 GOMEZ-LINDSEY ,9080.230000000018,Uncategorised, 
10-Dec-18,-1452.75,488663959,,INTER-BANK CREDIT,Jensen Group,7627.480000000018,Other Income, 
13-Dec-18,1646.49,488663959,,TRANSFER DEBIT,589144271033356 COX KING AND NICHOLSON ,9273.970000000018,Financial, 
13-Dec-18,372.91,488663959,,INTER-BANK CREDIT,31507926196889 CLARK-WILLIAMS ,9646.880000000017,Bills, 
16-Dec-18,-1036.36,488663959,,INTER-BANK CREDIT,Garcia-Ellis,8610.520000000017,Financial, 
17-Dec-18,-1075.69,488663959,,AUTOMATIC DRAWING,Mcfarland-Riley,7534.830000000016,Other Income, 
19-Dec-18,-1689.95,488663959,,INTER-BANK CREDIT,Lopez-Brown,5844.8800000000165,Bills, 
19-Dec-18,-578.57,488663959,,AUTOMATIC DRAWING,Valenzuela Inc,5266.310000000017,Uncategorised, 
20-Dec-18,-1391.86,488663959,,INTER-BANK CREDIT,728427842222883 FRANCO AND SONS ,3874.450000000017,Financial, 
23-Dec-18,1815.14,488663959,,TRANSFER DEBIT,Solis-Johnson,5689.590000000017,Other Income, 
25-Dec-18,-416.79,488663959,,INTER-BANK CREDIT,Cole and Sons,5272.8000000000175,Financial, 
25-Dec-18,21.41,488663959,,AUTOMATIC DRAWING,723896031076304 MCGEE PLC ,5294.210000000017,Bills, 
26-Dec-18,-1948.72,488663959,,AUTOMATIC DRAWING,798725965224525 LEONARD-PHILLIPS ,3345.490000000017,Bills, 
29-Dec-18,1393.34,488663959,,INTER-BANK CREDIT,Mora LLC,4738.830000000017,Uncategorised, 
01-Jan-19,-213.77,488663959,,INTER-BANK CREDIT,Bruce Lopez and Hicks,4525.060000000017,Bills, 
01-Jan-19,1777.63,488663959,,INTER-BANK CREDIT,777530904659402 WALTER LLC ,6302.690000000017,Other Income, 
02-Jan-19,-1798.83,488663959,,INTER-BANK CREDIT,Sherman-Fernandez,4503.860000000017,Financial, 
04-Jan-19,1819.78,488663959,,TRANSFER DEBIT,Lucas Ltd,6323.640000000017,Uncategorised, 
06-Jan-19,-1694.72,488663959,,TRANSFER DEBIT,177167795718576 CARTER STEWART AND GARCIA ,4628.920000000016,Financial, 
06-Jan-19,-228.88,488663959,,AUTOMATIC DRAWING,317077078356627 WAGNER-ORTIZ ,4400.040000000016,Other Income, 
09-Jan-19,507.51,488663959,,TRANSFER DEBIT,276669505134351 JONES-THOMPSON ,4907.550000000017,Bills, 
12-Jan-19,-72.97,488663959,,TRANSFER DEBIT,383633239820065 AVILA-MALDONADO ,4834.580000000016,Uncategorised, 
13-Jan-19,-402.43,488663959,,INTER-BANK CREDIT,Smith and Sons,4432.150000000016,Financial, 
14-Jan-19,-1123.87,488663959,,TRANSFER DEBIT,842515270568509 RODRIGUEZ-CLARKE ,3308.280000000016,Other Income, 
15-Jan-19,-1726.05,488663959,,AUTOMATIC DRAWING,973958210897347 ROSS PLC ,1582.2300000000162,Financial, 
16-Jan-19,-1272.4,488663959,,AUTOMATIC DRAWING,192084394184959 GREGORY AND SONS ,309.83000000001607,Financial, 
16-Jan-19,178.46,488663959,,TRANSFER DEBIT,541696658989500 UNDERWOOD AND SONS ,488.2900000000161,Other Income, 
18-Jan-19,-1270.25,488663959,,TRANSFER DEBIT,Smith LLC,-781.9599999999839,Bills, 
18-Jan-19,-739.19,488663959,,AUTOMATIC DRAWING,Jackson PLC,-1521.149999999984,Other Income, 
20-Jan-19,1348.27,488663959,,INTER-BANK CREDIT,159310818160097 ADAMS-BRADFORD ,-172.87999999998397,Bills, 
20-Jan-19,-560.17,488663959,,TRANSFER DEBIT,Moore Bradshaw and Ramirez,-733.0499999999839,Financial, 
21-Jan-19,1220.78,488663959,,INTER-BANK CREDIT,979929423771587 DELEON-HALL ,487.73000000001605,Uncategorised, 
21-Jan-19,399.03,488663959,,INTER-BANK CREDIT,453339767397324 OWEN-TAPIA ,886.760000000016,Financial, 
24-Jan-19,1292.97,488663959,,TRANSFER DEBIT,291648022406772 PROCTOR HAMILTON AND NORTON ,2179.730000000016,Other Income, 
25-Jan-19,1144.41,488663959,,AUTOMATIC DRAWING,Lynn LLC,3324.140000000016,Financial, 
28-Jan-19,-1109.37,488663959,,INTER-BANK CREDIT,Alexander Brown and Hicks,2214.770000000016,Financial, 
31-Jan-19,160.58,488663959,,INTER-BANK CREDIT,Conrad LLC,2375.350000000016,Bills, 
03-Feb-19,-873.16,488663959,,AUTOMATIC DRAWING,692702537789150 KOCH MILLER AND SIMMONS ,1502.190000000016,Financial, 
05-Feb-19,1823.61,488663959,,INTER-BANK CREDIT,523001215628461 ESPARZA-MARTINEZ ,3325.8000000000156,Financial, 
07-Feb-19,343.38,488663959,,TRANSFER DEBIT,Hartman Fox and Harrell,3669.1800000000158,Other Income, 
09-Feb-19,-129.49,488663959,,INTER-BANK CREDIT,126761305897432 WALLACE-DUNN ,3539.690000000016,Uncategorised, 
09-Feb-19,-484.5,488663959,,AUTOMATIC DRAWING,Green Johnson and Rodriguez,3055.190000000016,Financial, 
12-Feb-19,1281.07,488663959,,TRANSFER DEBIT,Benson Ltd,4336.260000000016,Financial, 
15-Feb-19,1154.8,488663959,,AUTOMATIC DRAWING,Cox-Murray,5491.060000000016,Uncategorised, 
15-Feb-19,-1910.69,488663959,,TRANSFER DEBIT,465637808810126 TUCKER-CASTILLO ,3580.370000000016,Bills, 
18-Feb-19,177.54,488663959,,TRANSFER DEBIT,Frank Inc,3757.9100000000158,Other Income, 
20-Feb-19,1430.1,488663959,,INTER-BANK CREDIT,Miller Parker and Landry,5188.010000000016,Bills, 
20-Feb-19,250.62,488663959,,INTER-BANK CREDIT,713267165551106 ROLLINS WARE AND DAVIS ,5438.630000000016,Financial, 
23-Feb-19,-486.37,488663959,,INTER-BANK CREDIT,Perez-Casey,4952.260000000016,Bills, 
23-Feb-19,-1532.65,488663959,,AUTOMATIC DRAWING,653161313919095 ANDERSON GARCIA AND ALVAREZ ,3419.6100000000156,Other Income, 
23-Feb-19,1202.42,488663959,,INTER-BANK CREDIT,63459073722165 RYAN INGRAM AND STEELE ,4622.030000000015,Bills, 
25-Feb-19,-1640.17,488663959,,TRANSFER DEBIT,200204485464277 JOHNSON PALMER AND WEEKS ,2981.860000000015,Bills, 
28-Feb-19,1944.38,488663959,,AUTOMATIC DRAWING,Nash PLC,4926.240000000015,Uncategorised, 
01-Mar-19,595.29,488663959,,AUTOMATIC DRAWING,Duke Livingston and Brooks,5521.530000000015,Other Income, 
02-Mar-19,1575.15,488663959,,INTER-BANK CREDIT,2267576939626 YOUNG-GILBERT ,7096.680000000015,Uncategorised, 
04-Mar-19,1805.39,488663959,,INTER-BANK CREDIT,Fleming-Reynolds,8902.070000000014,Financial, 
06-Mar-19,1205.79,488663959,,INTER-BANK CREDIT,681650626206508 KLEIN HARRIS AND JONES ,10107.860000000015,Financial, 
08-Mar-19,-1307.14,488663959,,INTER-BANK CREDIT,920469956696451 BAILEY INC ,8800.720000000016,Bills, 
11-Mar-19,-999.89,488663959,,INTER-BANK CREDIT,Harris-Buck,7800.830000000015,Uncategorised, 
13-Mar-19,1879.41,488663959,,AUTOMATIC DRAWING,633562433156918 SCOTT INC ,9680.240000000016,Bills, 
16-Mar-19,1979.49,488663959,,AUTOMATIC DRAWING,493440065440203 SMITH INC ,11659.730000000016,Uncategorised, 
18-Mar-19,-1976.68,488663959,,AUTOMATIC DRAWING,202937787706856 RANDALL-PEREZ ,9683.050000000016,Financial, 
19-Mar-19,1734.23,488663959,,TRANSFER DEBIT,869954757621184 ROSS PATTERSON AND WEBER ,11417.280000000015,Uncategorised, 
19-Mar-19,-1338.87,488663959,,AUTOMATIC DRAWING,117933735382140 PATTERSON-HALL ,10078.410000000014,Bills, 
21-Mar-19,-1907.57,488663959,,INTER-BANK CREDIT,862595525017332 CARPENTER-ROBERTS ,8170.840000000015,Uncategorised, 
24-Mar-19,719.86,488663959,,INTER-BANK CREDIT,Strickland Inc,8890.700000000015,Bills, 
26-Mar-19,-1790.22,488663959,,TRANSFER DEBIT,Briggs Group,7100.480000000015,Other Income, 
27-Mar-19,1571.63,488663959,,INTER-BANK CREDIT,781002432746158 BROWN AND SONS ,8672.110000000015,Other Income, 
27-Mar-19,-1314.72,488663959,,AUTOMATIC DRAWING,977416720766899 COHEN LTD ,7357.390000000015,Bills, 
28-Mar-19,-1933.64,488663959,,INTER-BANK CREDIT,Haas Ritter and Phillips,5423.750000000015,Financial, 
28-Mar-19,34.7,488663959,,TRANSFER DEBIT,Jackson LLC,5458.450000000014,Other Income, 
31-Mar-19,-985.19,488663959,,INTER-BANK CREDIT,Brown-Martin,4473.260000000015,Bills, 
02-Apr-19,1485.01,488663959,,TRANSFER DEBIT,Soto Logan and Collins,5958.270000000015,Uncategorised, 
04-Apr-19,672.98,488663959,,TRANSFER DEBIT,Anderson-James,6631.250000000015,Financial, 
05-Apr-19,1443.63,488663959,,TRANSFER DEBIT,Watson Ltd,8074.880000000015,Financial, 
06-Apr-19,1026.09,488663959,,INTER-BANK CREDIT,Mendez Inc,9100.970000000014,Financial, 
08-Apr-19,-51.26,488663959,,AUTOMATIC DRAWING,378185330645068 MURPHY AND SONS ,9049.710000000014,Financial, 
10-Apr-19,-457.82,488663959,,AUTOMATIC DRAWING,Mccullough Ltd,8591.890000000014,Other Income, 
13-Apr-19,-645.32,488663959,,INTER-BANK CREDIT,West-Holland,7946.570000000014,Other Income, 
16-Apr-19,-1641.75,488663959,,INTER-BANK CREDIT,Powell-Coffey,6304.820000000014,Bills, 
18-Apr-19,-1153.91,488663959,,TRANSFER DEBIT,399164854445862 ROBINSON-WOODWARD ,5150.910000000014,Bills, 
18-Apr-19,-1372.14,488663959,,INTER-BANK CREDIT,Taylor Cruz and Becker,3778.770000000014,Financial, 
20-Apr-19,-809.17,488663959,,AUTOMATIC DRAWING,428621014877637 WILEY JENKINS AND WEAVER ,2969.600000000014,Other Income, 
20-Apr-19,-1238.56,488663959,,INTER-BANK CREDIT,Flynn Martin and Hamilton,1731.040000000014,Uncategorised, 
22-Apr-19,170.79,488663959,,INTER-BANK CREDIT,Scott-Contreras,1901.830000000014,Other Income, 
23-Apr-19,1594.17,488663959,,TRANSFER DEBIT,857430054510568 WILLIAMS BRAUN AND VASQUEZ ,3496.000000000014,Bills, 
26-Apr-19,1229.77,488663959,,AUTOMATIC DRAWING,155631510837759 GARCIA FARRELL AND FISHER ,4725.770000000014,Other Income, 
27-Apr-19,-1420.66,488663959,,INTER-BANK CREDIT,860160748357802 SHORT-MORGAN ,3305.110000000014,Other Income, 
29-Apr-19,-734.2,488663959,,INTER-BANK CREDIT,Stewart Ltd,2570.9100000000144,Financial, 
30-Apr-19,-830.32,488663959,,AUTOMATIC DRAWING,Cox Brown and Watson,1740.5900000000142,Uncategorised, 
01-May-19,651.3,488663959,,INTER-BANK CREDIT,Brown-Castaneda,2391.890000000014,Other Income, 
01-May-19,650.5,488663959,,INTER-BANK CREDIT,114868528212799 MITCHELL-BARNES ,3042.390000000014,Uncategorised, 
03-May-19,-1970.48,488663959,,AUTOMATIC DRAWING,267761625796108 COOK-ALVAREZ ,1071.910000000014,Bills, 
03-May-19,1560.22,488663959,,TRANSFER DEBIT,Leach-Moore,2632.1300000000138,Financial, 
05-May-19,108.5,488663959,,TRANSFER DEBIT,161950304779074 ALI HAYS AND FUENTES ,2740.6300000000138,Financial, 
08-May-19,522.45,488663959,,INTER-BANK CREDIT,Sanchez-Caldwell,3263.0800000000136,Bills, 
11-May-19,413.19,488663959,,INTER-BANK CREDIT,730663528228610 BROWN BAKER AND JENSEN ,3676.2700000000136,Bills, 
11-May-19,-86.67,488663959,,INTER-BANK CREDIT,Walker Group,3589.6000000000136,Bills, 
11-May-19,656.81,488663959,,INTER-BANK CREDIT,Hansen-Gonzalez,4246.4100000000135,Bills, 
14-May-19,1525.28,488663959,,AUTOMATIC DRAWING,Meyer-Thompson,5771.690000000013,Other Income, 
17-May-19,-1005.2,488663959,,INTER-BANK CREDIT,488516697087195 TATE LTD ,4766.490000000013,Financial, 
17-May-19,-1609.41,488663959,,TRANSFER DEBIT,Martinez-Nguyen,3157.0800000000136,Financial, 
19-May-19,824.17,488663959,,TRANSFER DEBIT,Dougherty LLC,3981.2500000000136,Other Income, 
21-May-19,-1059.76,488663959,,INTER-BANK CREDIT,Keller Baker and Dennis,2921.4900000000134,Other Income, 
22-May-19,136.17,488663959,,AUTOMATIC DRAWING,213445620412126 HANSEN-DIAZ ,3057.6600000000135,Bills, 
22-May-19,-1807.39,488663959,,TRANSFER DEBIT,235542000105865 ATKINS INC ,1250.2700000000134,Bills, 
25-May-19,952.19,488663959,,AUTOMATIC DRAWING,Kelly and Sons,2202.4600000000137,Bills, 
27-May-19,1116.7,488663959,,INTER-BANK CREDIT,Ortiz-Newman,3319.1600000000135,Other Income, 
30-May-19,-1602.29,488663959,,INTER-BANK CREDIT,Melton Group,1716.8700000000135,Financial, 
01-Jun-19,-1656.3,488663959,,TRANSFER DEBIT,725719805473598 RUSSELL THOMAS AND GALLOWAY ,60.57000000001358,Other Income, 
03-Jun-19,-1343.46,488663959,,AUTOMATIC DRAWING,Benson and Sons,-1282.8899999999865,Other Income, 
04-Jun-19,1697.76,488663959,,TRANSFER DEBIT,Allen and Sons,414.87000000001353,Bills, 
06-Jun-19,-743.71,488663959,,AUTOMATIC DRAWING,868110715636669 HOWARD SANDERS AND BUCHANAN ,-328.8399999999865,Other Income, 
08-Jun-19,-1990.99,488663959,,INTER-BANK CREDIT,305519455327372 FLETCHER LLC ,-2319.8299999999863,Other Income, 
11-Jun-19,1517.95,488663959,,INTER-BANK CREDIT,813434181377908 GOMEZ-LEE ,-801.8799999999862,Financial, 
14-Jun-19,1831.26,488663959,,TRANSFER DEBIT,557371096832992 MATTHEWS PARKER AND MCCARTHY ,1029.3800000000138,Bills, 
15-Jun-19,-1135.18,488663959,,INTER-BANK CREDIT,Ellis Little and Gonzalez,-105.79999999998631,Financial, 
18-Jun-19,1238.65,488663959,,INTER-BANK CREDIT,947396780219035 SMITH STEWART AND HILL ,1132.8500000000138,Bills, 
18-Jun-19,-334.51,488663959,,TRANSFER DEBIT,Castillo-Cisneros,798.3400000000138,Uncategorised, 
21-Jun-19,-906.17,488663959,,TRANSFER DEBIT,592420485841421 WHITE AGUILAR AND RAMSEY ,-107.82999999998617,Uncategorised, 
22-Jun-19,-853.05,488663959,,AUTOMATIC DRAWING,741231191303760 RODGERS DAVIS AND ROBERTS ,-960.8799999999861,Other Income, 
22-Jun-19,81.23,488663959,,INTER-BANK CREDIT,Key Ltd,-879.6499999999861,Uncategorised, 
25-Jun-19,-233.22,488663959,,TRANSFER DEBIT,Jones Ltd,-1112.869999999986,Other Income, 
28-Jun-19,287.63,488663959,,AUTOMATIC DRAWING,826012934081496 DAVIS-COWAN ,-825.239999999986,Bills, 
28-Jun-19,-817.2,488663959,,INTER-BANK CREDIT,315664059094539 NELSON-CARTER ,-1642.439999999986,Bills, 
29-Jun-19,-482.23,488663959,,TRANSFER DEBIT,Watts PLC,-2124.669999999986,Bills, 
02-Jul-19,-1629.96,488663959,,INTER-BANK CREDIT,550541737227539 WILLIAMS LLC ,-3754.629999999986,Bills, 
03-Jul-19,1153.1,488663959,,TRANSFER DEBIT,Ferguson Inc,-2601.529999999986,Uncategorised, 
05-Jul-19,-1383.26,488663959,,TRANSFER DEBIT,882819507931768 SULLIVAN PRATT AND BAKER ,-3984.7899999999863,Uncategorised, 
08-Jul-19,1598.9,488663959,,INTER-BANK CREDIT,Long Fowler and Alvarez,-2385.8899999999862,Other Income, 
08-Jul-19,-1001.92,488663959,,AUTOMATIC DRAWING,Bullock Cole and Snow,-3387.8099999999863,Bills, 
08-Jul-19,-470.65,488663959,,TRANSFER DEBIT,Ruiz Group,-3858.4599999999864,Other Income, 
10-Jul-19,-652.62,488663959,,AUTOMATIC DRAWING,796058763212723 BECK AND SONS ,-4511.079999999986,Financial, 
11-Jul-19,821.04,488663959,,AUTOMATIC DRAWING,75512787636902 SCHROEDER JOHNSON AND JOHNSON ,-3690.0399999999863,Financial, 
11-Jul-19,-1928.74,488663959,,INTER-BANK CREDIT,Yates-Perkins,-5618.779999999986,Financial, 
12-Jul-19,670.16,488663959,,AUTOMATIC DRAWING,410950264526940 CASE ROBERTS AND TORRES ,-4948.619999999986,Bills, 
12-Jul-19,-214.7,488663959,,TRANSFER DEBIT,776224552756487 PETERSEN AND SONS ,-5163.319999999986,Uncategorised, 
14-Jul-19,1691.69,488663959,,INTER-BANK CREDIT,841825104610908 AGUILAR AND SONS ,-3471.629999999986,Bills, 
14-Jul-19,-1156.54,488663959,,TRANSFER DEBIT,Howard Sanchez and Mclean,-4628.1699999999855,Other Income, 
16-Jul-19,269.08,488663959,,TRANSFER DEBIT,599122484566445 STRONG WEEKS AND CARTER ,-4359.089999999986,Financial, 
17-Jul-19,122.82,488663959,,AUTOMATIC DRAWING,Williams Rios and Becker,-4236.269999999986,Bills, 
17-Jul-19,-1417.98,488663959,,AUTOMATIC DRAWING,667078176127274 MEADOWS-RODRIGUEZ ,-5654.249999999985,Financial, 
20-Jul-19,1633.1,488663959,,TRANSFER DEBIT,382334417127143 LUCAS PLC ,-4021.1499999999855,Uncategorised, 
23-Jul-19,350.95,488663959,,TRANSFER DEBIT,935174057933552 GARZA DUARTE AND NGUYEN ,-3670.1999999999857,Other Income, 
26-Jul-19,-1086.46,488663959,,TRANSFER DEBIT,Hopkins Dennis and Liu,-4756.659999999985,Uncategorised, 
27-Jul-19,-22.15,488663959,,TRANSFER DEBIT,Harvey Ltd,-4778.809999999985,Other Income, 
29-Jul-19,-1484.76,488663959,,TRANSFER DEBIT,Herrera Inc,-6263.569999999985,Bills, 
31-Jul-19,-385.48,488663959,,AUTOMATIC DRAWING,Burgess-Smith,-6649.049999999985,Financial, 
03-Aug-19,-544.54,488663959,,AUTOMATIC DRAWING,Mendoza-Reeves,-7193.589999999985,Other Income, 
06-Aug-19,1217.24,488663959,,AUTOMATIC DRAWING,Little Inc,-5976.349999999985,Financial, 
07-Aug-19,455.49,488663959,,INTER-BANK CREDIT,Stevens-Powers,-5520.859999999985,Uncategorised, 
09-Aug-19,1248.76,488663959,,TRANSFER DEBIT,Nguyen Ltd,-4272.099999999985,Uncategorised, 
10-Aug-19,184.78,488663959,,INTER-BANK CREDIT,528171844630687 GARCIA GROUP ,-4087.3199999999847,Bills, 
11-Aug-19,1671.17,488663959,,INTER-BANK CREDIT,Roberts Thornton and Small,-2416.1499999999846,Financial, 
14-Aug-19,-737.65,488663959,,AUTOMATIC DRAWING,423276733955736 ASHLEY-DIAZ ,-3153.7999999999847,Other Income, 
17-Aug-19,-1381.62,488663959,,INTER-BANK CREDIT,906905814957070 JONES-KEITH ,-4535.419999999985,Uncategorised, 
17-Aug-19,-675.52,488663959,,INTER-BANK CREDIT,Stanley-Morgan,-5210.939999999984,Other Income, 
20-Aug-19,-399.15,488663959,,TRANSFER DEBIT,913964688090262 COMPTON TAYLOR AND HARDIN ,-5610.089999999984,Financial, 
20-Aug-19,-3.88,488663959,,AUTOMATIC DRAWING,119064574363694 HOGAN LLC ,-5613.969999999984,Other Income, 
22-Aug-19,-664.4,488663959,,INTER-BANK CREDIT,130707810411934 NUNEZ FRIEDMAN AND HOFFMAN ,-6278.3699999999835,Financial, 
22-Aug-19,297.61,488663959,,AUTOMATIC DRAWING,Martin Group,-5980.759999999984,Financial, 
22-Aug-19,172.96,488663959,,INTER-BANK CREDIT,Stephens Walker and Bishop,-5807.799999999984,Bills, 
23-Aug-19,727.28,488663959,,TRANSFER DEBIT,473522341723194 RODRIGUEZ-MORGAN ,-5080.519999999984,Bills, 
25-Aug-19,-1578.53,488663959,,INTER-BANK CREDIT,660792726556799 TAYLOR LLC ,-6659.049999999984,Uncategorised, 
27-Aug-19,647.04,488663959,,INTER-BANK CREDIT,690760831855349 CHEN AND SONS ,-6012.009999999984,Bills, 
29-Aug-19,52.25,488663959,,TRANSFER DEBIT,Andrews-Lewis,-5959.759999999984,Other Income, 
01-Sep-19,1746.47,488663959,,INTER-BANK CREDIT,Hess and Sons,-4213.289999999984,Other Income, 
03-Sep-19,592.12,488663959,,INTER-BANK CREDIT,854177733092607 JOHNSON LLC ,-3621.1699999999837,Uncategorised, 
04-Sep-19,1499.99,488663959,,AUTOMATIC DRAWING,Carney Austin and King,-2121.179999999984,Bills, 
05-Sep-19,-1155.62,488663959,,INTER-BANK CREDIT,894795061417860 STRONG WILLIAMS AND PATEL ,-3276.799999999984,Financial, 
05-Sep-19,473.12,488663959,,TRANSFER DEBIT,Anderson Inc,-2803.679999999984,Uncategorised, 
08-Sep-19,615.53,488663959,,INTER-BANK CREDIT,486788272585670 FORD-STONE ,-2188.149999999984,Bills, 
11-Sep-19,-1445.61,488663959,,INTER-BANK CREDIT,924423240991667 SMITH GROUP ,-3633.759999999984,Bills, 
13-Sep-19,-1502.71,488663959,,INTER-BANK CREDIT,353186732550249 GREENE PLC ,-5136.469999999984,Other Income, 
14-Sep-19,1132.92,488663959,,INTER-BANK CREDIT,Durham-Barnett,-4003.549999999984,Financial, 
14-Sep-19,1029.74,488663959,,AUTOMATIC DRAWING,506221658140680 SAUNDERS-DAVIS ,-2973.809999999984,Other Income, 
15-Sep-19,589.01,488663959,,INTER-BANK CREDIT,Hall Ross and Herrera,-2384.799999999984,Financial, 
16-Sep-19,-1379.28,488663959,,INTER-BANK CREDIT,893471863723706 MUNOZ TERRY AND HART ,-3764.0799999999836,Financial, 
18-Sep-19,-487.58,488663959,,TRANSFER DEBIT,236145559243460 ALVAREZ INC ,-4251.6599999999835,Uncategorised, 
19-Sep-19,510.97,488663959,,INTER-BANK CREDIT,Howell-Carr,-3740.6899999999832,Financial, 
20-Sep-19,1144.71,488663959,,AUTOMATIC DRAWING,Fischer Huang and Campbell,-2595.979999999983,Uncategorised, 
21-Sep-19,-86.96,488663959,,INTER-BANK CREDIT,Torres-Carter,-2682.9399999999832,Uncategorised, 
22-Sep-19,-490.51,488663959,,TRANSFER DEBIT,720101289982729 HAYES INC ,-3173.4499999999834,Bills, 
23-Sep-19,1789.35,488663959,,TRANSFER DEBIT,Cohen-Harrington,-1384.0999999999835,Other Income, 
25-Sep-19,-1549.26,488663959,,AUTOMATIC DRAWING,Hunt Camacho and Cole,-2933.3599999999833,Financial, 
26-Sep-19,1527.87,488663959,,AUTOMATIC DRAWING,Hansen-Landry,-1405.4899999999834,Other Income, 
29-Sep-19,-211.62,488663959,,INTER-BANK CREDIT,Smith Estes and Daugherty,-1617.1099999999833,Uncategorised, 
01-Oct-19,-1479.02,488663959,,TRANSFER DEBIT,Smith Newton and Webb,-3096.1299999999833,Financial, 
03-Oct-19,-1897.34,488663959,,AUTOMATIC DRAWING,Nelson-Cobb,-4993.469999999983,Other Income, 
