Date,Amount,Account Number,,Transaction Type,Transaction Details,Balance,Category,Merchant Name
08-Jul-17,-604.68,644959701,,TRANSFER DEBIT,Harrington Willis and Brown,537.0300000000001,Uncategorised, 
08-Jul-17,1147.92,644959701,,INTER-BANK CREDIT,Bowers Rodriguez and Young,1684.9500000000003,Uncategorised, 
11-Jul-17,-1314.62,644959701,,TRANSFER DEBIT,Hall Ruiz and Nichols,370.3300000000004,Financial, 
12-Jul-17,-452.32,644959701,,INTER-BANK CREDIT,Bailey and Sons,-81.98999999999961,Financial, 
12-Jul-17,490.39,644959701,,INTER-BANK CREDIT,984972461198260 TATE-HARRINGTON ,408.4000000000004,Other Income, 
14-Jul-17,388.47,644959701,,INTER-BANK CREDIT,836429303845548 BURNS HALL AND LANDRY ,796.8700000000003,Other Income, 
14-Jul-17,1252.55,644959701,,AUTOMATIC DRAWING,233312704533799 MAXWELL GONZALES AND COOPER ,2049.42,Other Income, 
14-Jul-17,-555.46,644959701,,AUTOMATIC DRAWING,495717341502311 KELLY CALHOUN AND BUTLER ,1493.96,Uncategorised, 
16-Jul-17,1835.65,644959701,,AUTOMATIC DRAWING,790595929756742 BISHOP-SANCHEZ ,3329.61,Financial, 
17-Jul-17,-574.72,644959701,,TRANSFER DEBIT,866728277110555 ROWE KIRBY AND ALLEN ,2754.8900000000003,Other Income, 
17-Jul-17,1369.82,644959701,,INTER-BANK CREDIT,Maxwell-Hall,4124.71,Bills, 
19-Jul-17,677.21,644959701,,AUTOMATIC DRAWING,25243765802852 RAMOS PAUL AND FLETCHER ,4801.92,Other Income, 
20-Jul-17,-965.09,644959701,,TRANSFER DEBIT,Torres Flores and Mullen,3836.83,Financial, 
23-Jul-17,1159.04,644959701,,TRANSFER DEBIT,Smith Inc,4995.87,Financial, 
25-Jul-17,1482.21,644959701,,TRANSFER DEBIT,Chung Glover and Hull,6478.08,Other Income, 
27-Jul-17,-568.15,644959701,,INTER-BANK CREDIT,425857391905714 COLLINS GLENN AND DAVIS ,5909.93,Bills, 
28-Jul-17,469.71,644959701,,AUTOMATIC DRAWING,Rodriguez PLC,6379.64,Other Income, 
28-Jul-17,-388.27,644959701,,TRANSFER DEBIT,583765817883077 MEJIA BROWN AND FRANKLIN ,5991.370000000001,Uncategorised, 
31-Jul-17,851.78,644959701,,INTER-BANK CREDIT,566763486320530 CRAIG CISNEROS AND MCDONALD ,6843.150000000001,Bills, 
02-Aug-17,-321.11,644959701,,TRANSFER DEBIT,Heath-David,6522.040000000001,Financial, 
04-Aug-17,546.46,644959701,,AUTOMATIC DRAWING,156717418169772 BLAKE-DUNN ,7068.500000000001,Financial, 
07-Aug-17,-348.08,644959701,,AUTOMATIC DRAWING,Olson Bentley and Heath,6720.420000000001,Uncategorised, 
07-Aug-17,746.78,644959701,,INTER-BANK CREDIT,931373155602932 THOMPSON BOYD AND MORGAN ,7467.200000000001,Other Income, 
10-Aug-17,1872.56,644959701,,AUTOMATIC DRAWING,195748661436130 JOHNSON-GONZALEZ ,9339.76,Financial, 
11-Aug-17,1645.84,644959701,,AUTOMATIC DRAWING,16132542893671 MYERS GROUP ,10985.6,Uncategorised, 
13-Aug-17,-1809.63,644959701,,TRANSFER DEBIT,19332163923591 RUIZ GROUP ,9175.970000000001,Bills, 
15-Aug-17,-1896.18,644959701,,INTER-BANK CREDIT,Fuentes Spencer and Rodriguez,7279.790000000001,Uncategorised, 
15-Aug-17,-1078.65,644959701,,AUTOMATIC DRAWING,Johnson-Davis,6201.140000000001,Uncategorised, 
18-Aug-17,-475.62,644959701,,AUTOMATIC DRAWING,474509171376486 COLEMAN LLC ,5725.520000000001,Other Income, 
18-Aug-17,250.07,644959701,,TRANSFER DEBIT,135086533188146 GARCIA INC ,5975.590000000001,Other Income, 
21-Aug-17,316.48,644959701,,AUTOMATIC DRAWING,678247261737440 HOOD NUNEZ AND MURPHY ,6292.0700000000015,Bills, 
24-Aug-17,285.3,644959701,,INTER-BANK CREDIT,730603013769893 CURTIS AND SONS ,6577.370000000002,Financial, 
24-Aug-17,701.36,644959701,,TRANSFER DEBIT,699174083509986 WALTERS-HOOD ,7278.730000000001,Financial, 
26-Aug-17,852.82,644959701,,TRANSFER DEBIT,Cole-Arroyo,8131.550000000001,Financial, 
29-Aug-17,550.95,644959701,,INTER-BANK CREDIT,Gibson-Harding,8682.500000000002,Financial, 
29-Aug-17,1198.57,644959701,,TRANSFER DEBIT,491272654084976 MASSEY-ROGERS ,9881.070000000002,Financial, 
31-Aug-17,-1268.91,644959701,,TRANSFER DEBIT,Myers Ltd,8612.160000000002,Uncategorised, 
03-Sep-17,162.3,644959701,,INTER-BANK CREDIT,279619997058555 RAMIREZ PLC ,8774.460000000001,Uncategorised, 
06-Sep-17,592.78,644959701,,AUTOMATIC DRAWING,Lee and Sons,9367.240000000002,Bills, 
09-Sep-17,288.55,644959701,,INTER-BANK CREDIT,606897060860785 BROWN LTD ,9655.79,Other Income, 
10-Sep-17,1931.86,644959701,,INTER-BANK CREDIT,Harris-Williams,11587.650000000001,Bills, 
10-Sep-17,-1505.24,644959701,,AUTOMATIC DRAWING,Kelly-Schultz,10082.410000000002,Bills, 
10-Sep-17,981.47,644959701,,AUTOMATIC DRAWING,Kelly Group,11063.880000000001,Bills, 
13-Sep-17,-753.05,644959701,,INTER-BANK CREDIT,334834127384447 MUELLER INC ,10310.830000000002,Uncategorised, 
14-Sep-17,-1727.5,644959701,,TRANSFER DEBIT,910116134790737 LOPEZ-KING ,8583.330000000002,Other Income, 
16-Sep-17,-1319.28,644959701,,INTER-BANK CREDIT,348330750267335 LOVE BANKS AND RODGERS ,7264.050000000002,Financial, 
19-Sep-17,-545.23,644959701,,TRANSFER DEBIT,699620216796576 GRANT-GLENN ,6718.8200000000015,Bills, 
19-Sep-17,972.48,644959701,,AUTOMATIC DRAWING,Camacho Kaufman and Mccoy,7691.300000000001,Financial, 
21-Sep-17,1203.08,644959701,,INTER-BANK CREDIT,641675113203675 BUTLER WRIGHT AND CAMPOS ,8894.380000000001,Other Income, 
22-Sep-17,-1138.41,644959701,,INTER-BANK CREDIT,White-Kelly,7755.970000000001,Other Income, 
23-Sep-17,1415.62,644959701,,INTER-BANK CREDIT,Rivera-Schneider,9171.59,Uncategorised, 
26-Sep-17,-362.44,644959701,,INTER-BANK CREDIT,479031025458528 JOHNSON-BROWN ,8809.15,Financial, 
27-Sep-17,-93.49,644959701,,AUTOMATIC DRAWING,593721045880384 GONZALEZ-HENSLEY ,8715.66,Other Income, 
28-Sep-17,-1536.26,644959701,,INTER-BANK CREDIT,31638889885108 HICKMAN-OLSON ,7179.4,Financial, 
28-Sep-17,356.8,644959701,,AUTOMATIC DRAWING,914537125366498 JACKSON PLC ,7536.2,Uncategorised, 
29-Sep-17,-549.3,644959701,,TRANSFER DEBIT,86969445595934 NAVARRO-JOHNSON ,6986.9,Bills, 
02-Oct-17,935.36,644959701,,TRANSFER DEBIT,106335593185121 WRIGHT-NGUYEN ,7922.259999999999,Financial, 
03-Oct-17,1254.53,644959701,,TRANSFER DEBIT,697890946038652 TERRY AND SONS ,9176.789999999999,Other Income, 
03-Oct-17,-1745.65,644959701,,AUTOMATIC DRAWING,Kennedy Salazar and Reyes,7431.139999999999,Uncategorised, 
05-Oct-17,-1995.28,644959701,,TRANSFER DEBIT,Simmons-Evans,5435.86,Uncategorised, 
06-Oct-17,1493.1,644959701,,AUTOMATIC DRAWING,311605674415767 CAREY BAKER AND JOHNSON ,6928.959999999999,Uncategorised, 
08-Oct-17,521.2,644959701,,INTER-BANK CREDIT,185697205093109 GUERRA AND SONS ,7450.159999999999,Uncategorised, 
08-Oct-17,1994.07,644959701,,TRANSFER DEBIT,449210921329213 BAKER-SMITH ,9444.23,Bills, 
08-Oct-17,-1123.56,644959701,,AUTOMATIC DRAWING,Powell PLC,8320.67,Other Income, 
08-Oct-17,-1954.98,644959701,,INTER-BANK CREDIT,243068831714425 JOHNSON HOBBS AND BOND ,6365.6900000000005,Other Income, 
08-Oct-17,1395.85,644959701,,INTER-BANK CREDIT,Long-King,7761.540000000001,Bills, 
09-Oct-17,863.61,644959701,,TRANSFER DEBIT,316065806715833 CUMMINGS INC ,8625.150000000001,Other Income, 
12-Oct-17,-1271.59,644959701,,TRANSFER DEBIT,338420380056478 HENRY INC ,7353.560000000001,Bills, 
12-Oct-17,1727.11,644959701,,INTER-BANK CREDIT,Palmer-Cannon,9080.670000000002,Financial, 
14-Oct-17,-1497.29,644959701,,INTER-BANK CREDIT,312584135352721 REED CARSON AND WELCH ,7583.380000000002,Financial, 
14-Oct-17,1656.0,644959701,,INTER-BANK CREDIT,793676283006866 EVANS PLC ,9239.380000000001,Uncategorised, 
14-Oct-17,1542.97,644959701,,INTER-BANK CREDIT,Phillips-Carter,10782.35,Uncategorised, 
17-Oct-17,1470.7,644959701,,INTER-BANK CREDIT,765601113317808 THOMAS GONZALEZ AND BASS ,12253.050000000001,Other Income, 
20-Oct-17,881.04,644959701,,TRANSFER DEBIT,217565658281606 SCHMIDT-BLACKWELL ,13134.09,Uncategorised, 
20-Oct-17,-1507.36,644959701,,INTER-BANK CREDIT,16109856235530 WALKER-HOUSTON ,11626.73,Other Income, 
20-Oct-17,1578.61,644959701,,AUTOMATIC DRAWING,61959610313554 POPE GROUP ,13205.34,Bills, 
21-Oct-17,-122.4,644959701,,TRANSFER DEBIT,Wilson Ramirez and Chambers,13082.94,Financial, 
24-Oct-17,-346.92,644959701,,TRANSFER DEBIT,Robinson Group,12736.02,Other Income, 
24-Oct-17,1656.48,644959701,,INTER-BANK CREDIT,905767988280440 GILLESPIE GROUP ,14392.5,Uncategorised, 
27-Oct-17,-69.61,644959701,,AUTOMATIC DRAWING,104137057419685 RICHARDSON INC ,14322.89,Bills, 
30-Oct-17,-495.86,644959701,,INTER-BANK CREDIT,Lawrence Ltd,13827.029999999999,Bills, 
31-Oct-17,271.65,644959701,,INTER-BANK CREDIT,Rocha-Pacheco,14098.679999999998,Bills, 
31-Oct-17,-1474.94,644959701,,AUTOMATIC DRAWING,238848900537896 TUCKER LLC ,12623.739999999998,Uncategorised, 
02-Nov-17,336.39,644959701,,TRANSFER DEBIT,Webb Ltd,12960.129999999997,Bills, 
04-Nov-17,153.54,644959701,,AUTOMATIC DRAWING,Montgomery and Sons,13113.669999999998,Uncategorised, 
06-Nov-17,-812.84,644959701,,INTER-BANK CREDIT,Chavez Ward and Aguirre,12300.829999999998,Uncategorised, 
08-Nov-17,-725.15,644959701,,INTER-BANK CREDIT,Diaz-Bell,11575.679999999998,Uncategorised, 
10-Nov-17,-1410.13,644959701,,INTER-BANK CREDIT,Thornton-Page,10165.55,Financial, 
10-Nov-17,-424.72,644959701,,INTER-BANK CREDIT,Yang-Hernandez,9740.83,Uncategorised, 
12-Nov-17,104.55,644959701,,AUTOMATIC DRAWING,Hatfield and Sons,9845.38,Other Income, 
13-Nov-17,-740.53,644959701,,AUTOMATIC DRAWING,Parker PLC,9104.849999999999,Other Income, 
13-Nov-17,389.6,644959701,,TRANSFER DEBIT,Collins PLC,9494.449999999999,Financial, 
13-Nov-17,-984.73,644959701,,INTER-BANK CREDIT,Smith PLC,8509.72,Bills, 
16-Nov-17,-1528.63,644959701,,TRANSFER DEBIT,436450346820497 FOSTER PLC ,6981.089999999999,Financial, 
17-Nov-17,-114.37,644959701,,TRANSFER DEBIT,Brown Inc,6866.719999999999,Uncategorised, 
17-Nov-17,-283.17,644959701,,INTER-BANK CREDIT,744367117179310 WAGNER GROUP ,6583.549999999999,Financial, 
20-Nov-17,-1472.04,644959701,,TRANSFER DEBIT,978416712422343 PIERCE-CLARKE ,5111.509999999999,Financial, 
23-Nov-17,-546.33,644959701,,AUTOMATIC DRAWING,Leon-Gordon,4565.179999999999,Bills, 
23-Nov-17,-909.41,644959701,,AUTOMATIC DRAWING,875471632535921 GREEN-WILSON ,3655.7699999999995,Other Income, 
23-Nov-17,540.83,644959701,,INTER-BANK CREDIT,Smith Ltd,4196.599999999999,Financial, 
23-Nov-17,-1065.86,644959701,,INTER-BANK CREDIT,Stewart PLC,3130.74,Other Income, 
25-Nov-17,796.86,644959701,,TRANSFER DEBIT,956606504800854 CHAPMAN TOWNSEND AND MILLER ,3927.6,Uncategorised, 
26-Nov-17,-317.92,644959701,,INTER-BANK CREDIT,Kelly and Sons,3609.68,Financial, 
27-Nov-17,1875.76,644959701,,INTER-BANK CREDIT,Williams Inc,5485.44,Financial, 
28-Nov-17,784.18,644959701,,TRANSFER DEBIT,349772939973588 DUKE JAMES AND GALLEGOS ,6269.62,Financial, 
01-Dec-17,604.59,644959701,,TRANSFER DEBIT,Glenn-Clark,6874.21,Financial, 
02-Dec-17,-1124.43,644959701,,AUTOMATIC DRAWING,862758085608288 GRANT-REED ,5749.78,Other Income, 
04-Dec-17,-843.98,644959701,,INTER-BANK CREDIT,710488244907781 RICH-FREY ,4905.799999999999,Uncategorised, 
07-Dec-17,-1495.39,644959701,,TRANSFER DEBIT,Brown Group,3410.409999999999,Financial, 
10-Dec-17,53.95,644959701,,INTER-BANK CREDIT,199772389984490 RUSSELL MCLAUGHLIN AND STEWART ,3464.3599999999988,Bills, 
10-Dec-17,189.81,644959701,,AUTOMATIC DRAWING,76066506103696 BELL GONZALEZ AND MCKEE ,3654.1699999999987,Financial, 
10-Dec-17,121.38,644959701,,AUTOMATIC DRAWING,Gonzales Smith and Mendez,3775.549999999999,Uncategorised, 
12-Dec-17,1640.37,644959701,,AUTOMATIC DRAWING,Lawson-Ingram,5415.919999999998,Financial, 
13-Dec-17,-1401.87,644959701,,INTER-BANK CREDIT,491640786600399 HAYDEN-PENA ,4014.0499999999984,Financial, 
16-Dec-17,-1412.24,644959701,,INTER-BANK CREDIT,Holden Ltd,2601.8099999999986,Financial, 
19-Dec-17,-808.99,644959701,,INTER-BANK CREDIT,Christensen Glover and Baker,1792.8199999999986,Financial, 
22-Dec-17,-1815.97,644959701,,INTER-BANK CREDIT,Graves Ramirez and Bailey,-23.150000000001455,Other Income, 
22-Dec-17,-405.87,644959701,,INTER-BANK CREDIT,Lopez Farrell and Benjamin,-429.02000000000146,Other Income, 
23-Dec-17,640.64,644959701,,AUTOMATIC DRAWING,562028042421522 FERGUSON SIMON AND ROBLES ,211.61999999999853,Uncategorised, 
25-Dec-17,-646.57,644959701,,INTER-BANK CREDIT,41375132990486 GARCIA-MILLER ,-434.9500000000015,Financial, 
26-Dec-17,-1470.15,644959701,,INTER-BANK CREDIT,Hunter-Wood,-1905.1000000000017,Other Income, 
28-Dec-17,-1869.97,644959701,,INTER-BANK CREDIT,Everett and Sons,-3775.0700000000015,Financial, 
28-Dec-17,-864.3,644959701,,INTER-BANK CREDIT,Flowers-Stewart,-4639.370000000002,Other Income, 
29-Dec-17,-1321.52,644959701,,AUTOMATIC DRAWING,Tran Garcia and Duarte,-5960.890000000001,Bills, 
30-Dec-17,437.21,644959701,,INTER-BANK CREDIT,124355156885409 MIDDLETON-HANSON ,-5523.680000000001,Uncategorised, 
02-Jan-18,1323.59,644959701,,TRANSFER DEBIT,Miller LLC,-4200.090000000001,Other Income, 
03-Jan-18,819.66,644959701,,AUTOMATIC DRAWING,Clark Group,-3380.430000000001,Financial, 
03-Jan-18,-1152.04,644959701,,INTER-BANK CREDIT,586097504271302 BENITEZ SUTTON AND MILLER ,-4532.470000000001,Uncategorised, 
05-Jan-18,210.09,644959701,,AUTOMATIC DRAWING,Hall LLC,-4322.380000000001,Uncategorised, 
07-Jan-18,-1434.46,644959701,,AUTOMATIC DRAWING,247158286626582 ELLISON MOORE AND ROSS ,-5756.840000000001,Financial, 
09-Jan-18,87.61,644959701,,INTER-BANK CREDIT,419159512210658 DAVIS INC ,-5669.230000000001,Financial, 
12-Jan-18,-1561.78,644959701,,TRANSFER DEBIT,364939894499716 GREER GROUP ,-7231.010000000001,Bills, 
14-Jan-18,1638.1,644959701,,AUTOMATIC DRAWING,White-Peters,-5592.910000000002,Other Income, 
16-Jan-18,1170.87,644959701,,TRANSFER DEBIT,758003552346221 RANDOLPH WEST AND POWELL ,-4422.040000000002,Bills, 
17-Jan-18,-1174.54,644959701,,AUTOMATIC DRAWING,Hawkins-Maldonado,-5596.580000000002,Uncategorised, 
19-Jan-18,850.38,644959701,,TRANSFER DEBIT,Garcia Wood and Fuller,-4746.200000000002,Other Income, 
20-Jan-18,304.48,644959701,,TRANSFER DEBIT,Hicks Young and Anderson,-4441.720000000001,Uncategorised, 
23-Jan-18,-935.05,644959701,,INTER-BANK CREDIT,Davis Ryan and Boyd,-5376.770000000001,Bills, 
26-Jan-18,36.46,644959701,,AUTOMATIC DRAWING,Baird-Dalton,-5340.310000000001,Bills, 
27-Jan-18,695.13,644959701,,TRANSFER DEBIT,651173507350233 ALLEN NUNEZ AND JENNINGS ,-4645.180000000001,Uncategorised, 
28-Jan-18,34.94,644959701,,INTER-BANK CREDIT,337387107399479 TAYLOR LEBLANC AND BROWN ,-4610.240000000002,Financial, 
28-Jan-18,-39.38,644959701,,TRANSFER DEBIT,649858845107763 HAMILTON LLC ,-4649.620000000002,Financial, 
29-Jan-18,403.15,644959701,,INTER-BANK CREDIT,Montoya and Sons,-4246.470000000002,Other Income, 
31-Jan-18,-680.6,644959701,,INTER-BANK CREDIT,Humphrey Ltd,-4927.070000000002,Bills, 
03-Feb-18,1797.04,644959701,,INTER-BANK CREDIT,111239566764769 CAMPOS-SIMPSON ,-3130.0300000000025,Other Income, 
03-Feb-18,1709.92,644959701,,TRANSFER DEBIT,118692469510021 HOOPER-MARTINEZ ,-1420.1100000000024,Uncategorised, 
05-Feb-18,-525.44,644959701,,INTER-BANK CREDIT,885329732225664 TAYLOR GROUP ,-1945.5500000000025,Bills, 
05-Feb-18,698.48,644959701,,AUTOMATIC DRAWING,Bailey-Adkins,-1247.0700000000024,Financial, 
07-Feb-18,-1428.21,644959701,,TRANSFER DEBIT,148955355913122 WOODARD-ELLIOTT ,-2675.2800000000025,Other Income, 
08-Feb-18,-141.97,644959701,,INTER-BANK CREDIT,Harris PLC,-2817.2500000000023,Bills, 
10-Feb-18,-611.29,644959701,,AUTOMATIC DRAWING,649760598015734 KELLER INC ,-3428.5400000000022,Bills, 
11-Feb-18,-927.35,644959701,,TRANSFER DEBIT,145271102366424 COX-ANDREWS ,-4355.890000000002,Other Income, 
14-Feb-18,478.12,644959701,,INTER-BANK CREDIT,Young Lopez and Barron,-3877.7700000000023,Financial, 
14-Feb-18,-1876.95,644959701,,INTER-BANK CREDIT,500796278719793 SANDERS LTD ,-5754.720000000002,Other Income, 
14-Feb-18,1262.87,644959701,,TRANSFER DEBIT,693050365461008 WHITE PLC ,-4491.850000000002,Other Income, 
17-Feb-18,1485.25,644959701,,TRANSFER DEBIT,Ramirez-Watson,-3006.600000000002,Other Income, 
18-Feb-18,-646.8,644959701,,INTER-BANK CREDIT,476242571434817 DAVIS LLC ,-3653.4000000000024,Uncategorised, 
21-Feb-18,-1878.01,644959701,,TRANSFER DEBIT,33465869758704 MAXWELL LEWIS AND DELACRUZ ,-5531.410000000003,Other Income, 
22-Feb-18,1113.51,644959701,,AUTOMATIC DRAWING,Giles Wall and Norris,-4417.900000000002,Other Income, 
24-Feb-18,16.08,644959701,,INTER-BANK CREDIT,149276472749842 ROTH-WALKER ,-4401.820000000002,Other Income, 
26-Feb-18,-811.69,644959701,,TRANSFER DEBIT,887787961598086 SMITH PLC ,-5213.510000000002,Uncategorised, 
27-Feb-18,826.79,644959701,,INTER-BANK CREDIT,169561127796276 SANDERS LLC ,-4386.720000000002,Other Income, 
28-Feb-18,-306.92,644959701,,TRANSFER DEBIT,Small-Henderson,-4693.640000000002,Bills, 
02-Mar-18,-1958.89,644959701,,INTER-BANK CREDIT,699540868876273 MOON-SANDERS ,-6652.5300000000025,Other Income, 
04-Mar-18,-1733.7,644959701,,TRANSFER DEBIT,Thompson-Daniels,-8386.230000000003,Uncategorised, 
05-Mar-18,1929.2,644959701,,INTER-BANK CREDIT,855830519526718 MYERS-GARCIA ,-6457.030000000003,Uncategorised, 
05-Mar-18,-1204.95,644959701,,INTER-BANK CREDIT,85098924541995 JACKSON-SHARP ,-7661.980000000003,Uncategorised, 
07-Mar-18,1688.13,644959701,,INTER-BANK CREDIT,Koch Inc,-5973.850000000003,Uncategorised, 
08-Mar-18,181.03,644959701,,INTER-BANK CREDIT,110831549137129 FORD-PERRY ,-5792.820000000003,Other Income, 
08-Mar-18,-1.23,644959701,,INTER-BANK CREDIT,758013303158361 GREEN HANCOCK AND RODRIGUEZ ,-5794.050000000003,Uncategorised, 
08-Mar-18,-266.14,644959701,,INTER-BANK CREDIT,653717282690484 CANNON SHAW AND WOLF ,-6060.190000000003,Other Income, 
10-Mar-18,-721.83,644959701,,TRANSFER DEBIT,Sanchez Goodwin and Neal,-6782.020000000003,Financial, 
13-Mar-18,-258.7,644959701,,INTER-BANK CREDIT,20136169030927 ROY MOORE AND BOWMAN ,-7040.720000000003,Other Income, 
13-Mar-18,585.33,644959701,,INTER-BANK CREDIT,Adams-West,-6455.390000000003,Other Income, 
16-Mar-18,-1570.63,644959701,,TRANSFER DEBIT,Dickson-Kirby,-8026.020000000003,Bills, 
17-Mar-18,-976.82,644959701,,AUTOMATIC DRAWING,854209587350684 WILLIAMS SPEARS AND ROSARIO ,-9002.840000000004,Other Income, 
18-Mar-18,-526.1,644959701,,INTER-BANK CREDIT,Mckinney-Anderson,-9528.940000000004,Uncategorised, 
19-Mar-18,357.93,644959701,,TRANSFER DEBIT,Gay Garrett and Green,-9171.010000000004,Other Income, 
20-Mar-18,1463.74,644959701,,INTER-BANK CREDIT,Green Group,-7707.270000000004,Bills, 
23-Mar-18,1423.49,644959701,,AUTOMATIC DRAWING,290987265674273 GOODMAN-ARROYO ,-6283.780000000004,Other Income, 
24-Mar-18,686.98,644959701,,INTER-BANK CREDIT,786769792957424 KELLY JENKINS AND CHRISTENSEN ,-5596.800000000005,Financial, 
24-Mar-18,160.32,644959701,,INTER-BANK CREDIT,Hughes PLC,-5436.480000000005,Uncategorised, 
24-Mar-18,967.87,644959701,,INTER-BANK CREDIT,Baker Clark and Shaw,-4468.610000000005,Bills, 
25-Mar-18,-289.47,644959701,,INTER-BANK CREDIT,461785730554337 MCGUIRE-LEWIS ,-4758.080000000005,Uncategorised, 
28-Mar-18,1412.83,644959701,,INTER-BANK CREDIT,Ho PLC,-3345.2500000000055,Other Income, 
31-Mar-18,-1252.99,644959701,,INTER-BANK CREDIT,Preston Garcia and Sims,-4598.240000000005,Other Income, 
03-Apr-18,-1964.28,644959701,,TRANSFER DEBIT,Thompson-Manning,-6562.520000000005,Other Income, 
04-Apr-18,-1505.61,644959701,,TRANSFER DEBIT,665611615888485 JOHNSON-GUTIERREZ ,-8068.130000000005,Financial, 
06-Apr-18,1411.26,644959701,,INTER-BANK CREDIT,Butler PLC,-6656.870000000004,Bills, 
08-Apr-18,-55.8,644959701,,AUTOMATIC DRAWING,Kennedy-Mullen,-6712.670000000005,Uncategorised, 
11-Apr-18,1879.49,644959701,,AUTOMATIC DRAWING,Santiago Ltd,-4833.180000000005,Financial, 
14-Apr-18,-264.54,644959701,,INTER-BANK CREDIT,Jordan Miller and Garcia,-5097.720000000005,Bills, 
15-Apr-18,1249.22,644959701,,TRANSFER DEBIT,223930000433972 ROBERTSON-HUNTER ,-3848.5000000000045,Financial, 
16-Apr-18,-1384.42,644959701,,AUTOMATIC DRAWING,419405680736171 OROZCO-HALL ,-5232.920000000005,Uncategorised, 
16-Apr-18,1968.44,644959701,,TRANSFER DEBIT,Lin-Maldonado,-3264.4800000000046,Bills, 
17-Apr-18,-1192.77,644959701,,AUTOMATIC DRAWING,Carter Peters and Rodriguez,-4457.250000000005,Other Income, 
17-Apr-18,229.81,644959701,,INTER-BANK CREDIT,104141023882363 ANDERSON JOHNSON AND CARROLL ,-4227.440000000004,Bills, 
19-Apr-18,1193.46,644959701,,INTER-BANK CREDIT,555149475891679 VALENTINE PAUL AND MOORE ,-3033.980000000004,Other Income, 
19-Apr-18,1624.04,644959701,,AUTOMATIC DRAWING,238911696940000 MENDEZ-RICHARD ,-1409.9400000000041,Uncategorised, 
22-Apr-18,-1768.93,644959701,,TRANSFER DEBIT,727610690869240 YU CAMPBELL AND ADAMS ,-3178.8700000000044,Financial, 
24-Apr-18,-1063.38,644959701,,INTER-BANK CREDIT,393616517041785 HUERTA WILLIAMS AND ROBLES ,-4242.250000000005,Uncategorised, 
27-Apr-18,-1406.51,644959701,,INTER-BANK CREDIT,Howard Schneider and Miller,-5648.760000000005,Bills, 
28-Apr-18,-44.34,644959701,,AUTOMATIC DRAWING,139664039821679 TORRES PACHECO AND FLETCHER ,-5693.100000000005,Bills, 
30-Apr-18,-459.62,644959701,,INTER-BANK CREDIT,Hubbard Ltd,-6152.720000000005,Financial, 
03-May-18,1638.06,644959701,,AUTOMATIC DRAWING,937364080336585 CRANE-ZIMMERMAN ,-4514.660000000005,Financial, 
05-May-18,983.19,644959701,,INTER-BANK CREDIT,910062553829901 PERKINS LTD ,-3531.4700000000053,Bills, 
08-May-18,769.05,644959701,,AUTOMATIC DRAWING,967800647970589 COLLINS-SMITH ,-2762.4200000000055,Bills, 
10-May-18,820.39,644959701,,INTER-BANK CREDIT,Smith-Gutierrez,-1942.0300000000057,Other Income, 
11-May-18,-195.83,644959701,,TRANSFER DEBIT,233249145684352 DAVIDSON-MCCANN ,-2137.8600000000056,Other Income, 
13-May-18,-1391.84,644959701,,INTER-BANK CREDIT,Wells Price and Welch,-3529.7000000000053,Bills, 
16-May-18,1239.63,644959701,,INTER-BANK CREDIT,595697659472110 BROWN LTD ,-2290.070000000005,Bills, 
17-May-18,-1732.24,644959701,,INTER-BANK CREDIT,119800491670515 JONES-BROWN ,-4022.310000000005,Bills, 
18-May-18,-370.78,644959701,,AUTOMATIC DRAWING,Brown Davis and Smith,-4393.090000000005,Other Income, 
19-May-18,-1284.55,644959701,,AUTOMATIC DRAWING,Davis Martinez and Conley,-5677.640000000005,Financial, 
19-May-18,-114.81,644959701,,INTER-BANK CREDIT,Rosario Bond and Sampson,-5792.450000000005,Uncategorised, 
19-May-18,-1883.28,644959701,,AUTOMATIC DRAWING,175362239980324 WILLIAMS-MAXWELL ,-7675.730000000005,Other Income, 
20-May-18,1388.54,644959701,,INTER-BANK CREDIT,Lewis LLC,-6287.190000000005,Financial, 
23-May-18,-919.35,644959701,,INTER-BANK CREDIT,Burton-Allen,-7206.540000000005,Bills, 
26-May-18,879.9,644959701,,AUTOMATIC DRAWING,Palmer Group,-6326.640000000006,Bills, 
28-May-18,1314.56,644959701,,TRANSFER DEBIT,Clark Anderson and Mcdonald,-5012.080000000005,Financial, 
30-May-18,1044.77,644959701,,INTER-BANK CREDIT,623501520244812 CARNEY-BIRD ,-3967.3100000000054,Uncategorised, 
02-Jun-18,1617.6,644959701,,TRANSFER DEBIT,Bullock LLC,-2349.7100000000055,Bills, 
02-Jun-18,252.45,644959701,,INTER-BANK CREDIT,545105342903819 MARTINEZ-RAMOS ,-2097.2600000000057,Other Income, 
02-Jun-18,-1952.25,644959701,,TRANSFER DEBIT,753882124723661 ANDREWS-PRICE ,-4049.5100000000057,Financial, 
03-Jun-18,859.04,644959701,,AUTOMATIC DRAWING,Reeves Inc,-3190.4700000000057,Other Income, 
06-Jun-18,514.55,644959701,,INTER-BANK CREDIT,118519293674909 HARDING BOWEN AND CARSON ,-2675.9200000000055,Bills, 
08-Jun-18,-1031.73,644959701,,TRANSFER DEBIT,Torres and Sons,-3707.6500000000055,Other Income, 
11-Jun-18,-123.49,644959701,,AUTOMATIC DRAWING,218803735139229 FOSTER-EVANS ,-3831.1400000000053,Uncategorised, 
11-Jun-18,1512.98,644959701,,INTER-BANK CREDIT,899671922193046 MARTIN-DAY ,-2318.1600000000053,Uncategorised, 
14-Jun-18,1580.65,644959701,,TRANSFER DEBIT,Taylor Group,-737.5100000000052,Financial, 
16-Jun-18,186.04,644959701,,TRANSFER DEBIT,Washington Zuniga and Deleon,-551.4700000000053,Other Income, 
19-Jun-18,1528.77,644959701,,AUTOMATIC DRAWING,Luna-Martin,977.2999999999947,Uncategorised, 
20-Jun-18,-564.65,644959701,,INTER-BANK CREDIT,766599630827712 OWENS REED AND THOMPSON ,412.64999999999475,Uncategorised, 
20-Jun-18,587.26,644959701,,INTER-BANK CREDIT,Scott PLC,999.9099999999947,Financial, 
21-Jun-18,1908.51,644959701,,INTER-BANK CREDIT,Bass-Shields,2908.4199999999946,Financial, 
21-Jun-18,745.13,644959701,,TRANSFER DEBIT,366819987541904 KIM PLC ,3653.5499999999947,Other Income, 
23-Jun-18,533.19,644959701,,AUTOMATIC DRAWING,Foster Group,4186.739999999994,Financial, 
24-Jun-18,-672.74,644959701,,INTER-BANK CREDIT,Torres-Hall,3513.9999999999945,Financial, 
27-Jun-18,-979.12,644959701,,TRANSFER DEBIT,840226231683865 LYNCH-WU ,2534.8799999999947,Financial, 
27-Jun-18,286.93,644959701,,AUTOMATIC DRAWING,Stewart LLC,2821.8099999999945,Financial, 
30-Jun-18,1122.52,644959701,,INTER-BANK CREDIT,197072739173184 SANDERS-MASSEY ,3944.3299999999945,Bills, 
02-Jul-18,-1550.82,644959701,,TRANSFER DEBIT,Mata Figueroa and Smith,2393.5099999999948,Other Income, 
05-Jul-18,-1436.03,644959701,,INTER-BANK CREDIT,932958798707807 FORD FOSTER AND MATTHEWS ,957.4799999999948,Bills, 
08-Jul-18,462.55,644959701,,TRANSFER DEBIT,779345103325652 GOODWIN GROUP ,1420.0299999999947,Bills, 
11-Jul-18,-745.71,644959701,,INTER-BANK CREDIT,744801512496577 SMITH PLC ,674.3199999999947,Bills, 
13-Jul-18,1828.52,644959701,,AUTOMATIC DRAWING,Lee Nguyen and Fisher,2502.8399999999947,Bills, 
16-Jul-18,-60.85,644959701,,TRANSFER DEBIT,Sims-Fowler,2441.989999999995,Uncategorised, 
17-Jul-18,538.19,644959701,,TRANSFER DEBIT,Nelson-Young,2980.179999999995,Financial, 
19-Jul-18,-1337.93,644959701,,INTER-BANK CREDIT,Reed Fitzgerald and Shaw,1642.2499999999948,Financial, 
21-Jul-18,-1207.95,644959701,,INTER-BANK CREDIT,Wilson Inc,434.2999999999947,Financial, 
23-Jul-18,771.74,644959701,,TRANSFER DEBIT,603645884072901 HAYES-GONZALEZ ,1206.0399999999947,Other Income, 
24-Jul-18,-1715.54,644959701,,INTER-BANK CREDIT,Peterson Robertson and Diaz,-509.50000000000523,Financial, 
24-Jul-18,-1059.63,644959701,,TRANSFER DEBIT,Barrett Inc,-1569.1300000000053,Other Income, 
26-Jul-18,1240.73,644959701,,INTER-BANK CREDIT,Clark-Davila,-328.4000000000053,Other Income, 
27-Jul-18,-161.61,644959701,,INTER-BANK CREDIT,Kennedy Inc,-490.01000000000533,Financial, 
29-Jul-18,-1686.53,644959701,,TRANSFER DEBIT,Robinson Thompson and Humphrey,-2176.5400000000054,Other Income, 
30-Jul-18,20.32,644959701,,TRANSFER DEBIT,Jordan-Cisneros,-2156.2200000000053,Uncategorised, 
02-Aug-18,-1940.33,644959701,,INTER-BANK CREDIT,Moon PLC,-4096.550000000005,Other Income, 
05-Aug-18,-1488.71,644959701,,TRANSFER DEBIT,Nguyen-Miller,-5585.260000000005,Financial, 
05-Aug-18,-1009.15,644959701,,INTER-BANK CREDIT,Collins LLC,-6594.410000000004,Other Income, 
08-Aug-18,1295.05,644959701,,INTER-BANK CREDIT,283552874226886 SMITH REYNOLDS AND PATRICK ,-5299.360000000004,Other Income, 
10-Aug-18,1165.11,644959701,,TRANSFER DEBIT,Thompson Wilson and Alexander,-4134.250000000005,Bills, 
11-Aug-18,-132.39,644959701,,INTER-BANK CREDIT,434691413202396 ROMERO HAMILTON AND SCHNEIDER ,-4266.640000000005,Uncategorised, 
13-Aug-18,135.76,644959701,,AUTOMATIC DRAWING,Johnson Group,-4130.880000000005,Uncategorised, 
15-Aug-18,-310.43,644959701,,AUTOMATIC DRAWING,Mcgee Group,-4441.310000000005,Bills, 
18-Aug-18,1311.94,644959701,,AUTOMATIC DRAWING,477183390636277 RASMUSSEN-JONES ,-3129.370000000005,Financial, 
18-Aug-18,1389.32,644959701,,INTER-BANK CREDIT,Johnson Johnson and Jackson,-1740.050000000005,Uncategorised, 
20-Aug-18,-1077.1,644959701,,INTER-BANK CREDIT,Clarke-Thomas,-2817.150000000005,Financial, 
22-Aug-18,1517.79,644959701,,INTER-BANK CREDIT,Wong and Sons,-1299.3600000000051,Financial, 
23-Aug-18,-342.7,644959701,,TRANSFER DEBIT,220145327584470 HENSON THOMPSON AND KEMP ,-1642.0600000000052,Financial, 
25-Aug-18,1932.57,644959701,,TRANSFER DEBIT,416932521146740 BAILEY FREEMAN AND JOHNSTON ,290.50999999999476,Uncategorised, 
25-Aug-18,162.08,644959701,,TRANSFER DEBIT,Holt LLC,452.5899999999948,Other Income, 
26-Aug-18,1266.95,644959701,,TRANSFER DEBIT,559174162187013 HARRIS INC ,1719.539999999995,Uncategorised, 
27-Aug-18,175.73,644959701,,TRANSFER DEBIT,684081171484398 WALTER SANDOVAL AND RANGEL ,1895.269999999995,Bills, 
27-Aug-18,-209.0,644959701,,AUTOMATIC DRAWING,Scott Moon and Nguyen,1686.269999999995,Bills, 
29-Aug-18,-876.27,644959701,,INTER-BANK CREDIT,4253698045458 MCCOY-OCONNOR ,809.999999999995,Other Income, 
01-Sep-18,-350.06,644959701,,TRANSFER DEBIT,Barber Morgan and Thomas,459.939999999995,Other Income, 
04-Sep-18,1075.1,644959701,,INTER-BANK CREDIT,662765041430326 CASTRO-EDWARDS ,1535.039999999995,Other Income, 
06-Sep-18,1851.26,644959701,,INTER-BANK CREDIT,Silva-Pierce,3386.2999999999947,Other Income, 
07-Sep-18,-841.26,644959701,,TRANSFER DEBIT,153616807728812 BROCK WILLIS AND WEBSTER ,2545.0399999999945,Financial, 
08-Sep-18,1890.1,644959701,,INTER-BANK CREDIT,840841955401386 REED JORDAN AND WHITAKER ,4435.139999999994,Other Income, 
10-Sep-18,1767.91,644959701,,INTER-BANK CREDIT,Hill Inc,6203.049999999994,Uncategorised, 
12-Sep-18,463.95,644959701,,INTER-BANK CREDIT,Sandoval-Garcia,6666.999999999994,Uncategorised, 
15-Sep-18,-797.49,644959701,,TRANSFER DEBIT,876602680137590 JONES GROUP ,5869.509999999994,Bills, 
17-Sep-18,801.75,644959701,,INTER-BANK CREDIT,526313140246098 HAMPTON PLC ,6671.259999999994,Uncategorised, 
17-Sep-18,-409.25,644959701,,TRANSFER DEBIT,904793772384657 LEBLANC-HUANG ,6262.009999999994,Bills, 
17-Sep-18,200.54,644959701,,TRANSFER DEBIT,2564773651926 LEE HENDRIX AND RODRIGUEZ ,6462.549999999994,Other Income, 
18-Sep-18,1053.97,644959701,,INTER-BANK CREDIT,Cook-Walker,7516.519999999994,Uncategorised, 
19-Sep-18,1975.42,644959701,,INTER-BANK CREDIT,280339006742105 CRUZ AND SONS ,9491.939999999995,Uncategorised, 
22-Sep-18,-1225.45,644959701,,INTER-BANK CREDIT,401648374606223 MUELLER-CASTRO ,8266.489999999994,Financial, 
24-Sep-18,-779.16,644959701,,INTER-BANK CREDIT,507935466862386 ANDERSON-OSBORNE ,7487.3299999999945,Financial, 
26-Sep-18,1738.51,644959701,,AUTOMATIC DRAWING,Krueger Inc,9225.839999999995,Other Income, 
27-Sep-18,-964.73,644959701,,INTER-BANK CREDIT,Powers Ltd,8261.109999999995,Other Income, 
28-Sep-18,-97.4,644959701,,INTER-BANK CREDIT,252659274939562 WILLIAMS-TORRES ,8163.7099999999955,Uncategorised, 
28-Sep-18,325.3,644959701,,AUTOMATIC DRAWING,421678444993762 YOUNG LLC ,8489.009999999995,Bills, 
28-Sep-18,-651.24,644959701,,TRANSFER DEBIT,Thomas Clayton and Perkins,7837.769999999995,Financial, 
01-Oct-18,1266.72,644959701,,INTER-BANK CREDIT,Schultz Group,9104.489999999994,Bills, 
02-Oct-18,-1706.43,644959701,,AUTOMATIC DRAWING,972420956249415 JOHNSON-MOORE ,7398.059999999994,Financial, 
03-Oct-18,-910.38,644959701,,AUTOMATIC DRAWING,Cline Mckay and Perez,6487.679999999994,Other Income, 
04-Oct-18,481.84,644959701,,INTER-BANK CREDIT,Collier Garcia and Gonzales,6969.519999999994,Financial, 
04-Oct-18,-788.09,644959701,,INTER-BANK CREDIT,810515016196233 STEPHENSON-BRYANT ,6181.429999999994,Uncategorised, 
05-Oct-18,850.09,644959701,,INTER-BANK CREDIT,Wilcox Group,7031.519999999994,Financial, 
08-Oct-18,-1507.03,644959701,,INTER-BANK CREDIT,Dixon-Turner,5524.489999999994,Financial, 
09-Oct-18,1261.6,644959701,,AUTOMATIC DRAWING,Tate-Mcgrath,6786.089999999995,Financial, 
12-Oct-18,-1513.39,644959701,,INTER-BANK CREDIT,821466138019247 PARRISH BECK AND EDWARDS ,5272.699999999994,Uncategorised, 
12-Oct-18,630.14,644959701,,INTER-BANK CREDIT,Solis Garrett and Jackson,5902.839999999995,Uncategorised, 
14-Oct-18,1909.75,644959701,,AUTOMATIC DRAWING,Gray-Barron,7812.589999999995,Other Income, 
17-Oct-18,520.14,644959701,,INTER-BANK CREDIT,Mcdaniel Perez and King,8332.729999999994,Bills, 
19-Oct-18,541.42,644959701,,TRANSFER DEBIT,Richardson-Hudson,8874.149999999994,Bills, 
20-Oct-18,1466.13,644959701,,INTER-BANK CREDIT,238745260219162 REED-HILL ,10340.279999999995,Uncategorised, 
22-Oct-18,-184.51,644959701,,TRANSFER DEBIT,Torres Group,10155.769999999995,Other Income, 
25-Oct-18,-111.69,644959701,,TRANSFER DEBIT,Griffin Ltd,10044.079999999994,Uncategorised, 
25-Oct-18,1292.41,644959701,,INTER-BANK CREDIT,Harris Ltd,11336.489999999994,Bills, 
28-Oct-18,-1500.46,644959701,,AUTOMATIC DRAWING,930854948763422 MOORE ALVAREZ AND MCNEIL ,9836.029999999995,Uncategorised, 
30-Oct-18,1451.11,644959701,,INTER-BANK CREDIT,169058220630134 ORTEGA FREDERICK AND PRATT ,11287.139999999996,Bills, 
31-Oct-18,-452.82,644959701,,TRANSFER DEBIT,Cisneros-Lee,10834.319999999996,Bills, 
01-Nov-18,1511.49,644959701,,INTER-BANK CREDIT,409596549482723 RODRIGUEZ AND SONS ,12345.809999999996,Bills, 
03-Nov-18,-882.46,644959701,,TRANSFER DEBIT,678029981878960 JONES-FOWLER ,11463.349999999995,Uncategorised, 
04-Nov-18,579.11,644959701,,INTER-BANK CREDIT,334452174096646 PEREZ-CARTER ,12042.459999999995,Financial, 
06-Nov-18,335.25,644959701,,TRANSFER DEBIT,Kemp Ltd,12377.709999999995,Bills, 
08-Nov-18,-517.69,644959701,,INTER-BANK CREDIT,Ferguson Inc,11860.019999999995,Other Income, 
09-Nov-18,1055.8,644959701,,INTER-BANK CREDIT,Hardin-Banks,12915.819999999994,Financial, 
11-Nov-18,389.89,644959701,,AUTOMATIC DRAWING,Moore Group,13305.709999999994,Uncategorised, 
11-Nov-18,1226.06,644959701,,TRANSFER DEBIT,948323646380481 BAKER COX AND POWELL ,14531.769999999993,Financial, 
13-Nov-18,221.65,644959701,,INTER-BANK CREDIT,780995831093730 HARTMAN JIMENEZ AND GONZALEZ ,14753.419999999993,Uncategorised, 
14-Nov-18,-974.77,644959701,,INTER-BANK CREDIT,163120449187757 RUBIO GROUP ,13778.649999999992,Uncategorised, 
15-Nov-18,1418.02,644959701,,INTER-BANK CREDIT,Warner and Sons,15196.669999999993,Other Income, 
18-Nov-18,223.53,644959701,,INTER-BANK CREDIT,151361096761410 HUGHES GROUP ,15420.199999999993,Uncategorised, 
18-Nov-18,1987.92,644959701,,TRANSFER DEBIT,Santiago Jones and Davidson,17408.119999999995,Other Income, 
19-Nov-18,-1084.41,644959701,,INTER-BANK CREDIT,Sanchez Farrell and Larsen,16323.709999999995,Other Income, 
19-Nov-18,-993.46,644959701,,AUTOMATIC DRAWING,912987391579201 JONES MILLER AND PITTMAN ,15330.249999999996,Other Income, 
19-Nov-18,-753.84,644959701,,AUTOMATIC DRAWING,Johnson Spears and Huang,14576.409999999996,Financial, 
19-Nov-18,-41.17,644959701,,TRANSFER DEBIT,Moreno Lyons and Silva,14535.239999999996,Uncategorised, 
20-Nov-18,-358.15,644959701,,INTER-BANK CREDIT,74238074814718 JOHNSON GEORGE AND HERNANDEZ ,14177.089999999997,Bills, 
23-Nov-18,1922.99,644959701,,TRANSFER DEBIT,524838362002798 HORN DAWSON AND CAIN ,16100.079999999996,Financial, 
25-Nov-18,-790.0,644959701,,TRANSFER DEBIT,Johnson Reynolds and Lynch,15310.079999999996,Bills, 
28-Nov-18,-1499.9,644959701,,INTER-BANK CREDIT,740472455782987 CASTILLO LTD ,13810.179999999997,Bills, 
30-Nov-18,-40.58,644959701,,INTER-BANK CREDIT,Raymond-Waller,13769.599999999997,Financial, 
30-Nov-18,1622.96,644959701,,AUTOMATIC DRAWING,Erickson-Rodriguez,15392.559999999998,Uncategorised, 
01-Dec-18,-1238.75,644959701,,INTER-BANK CREDIT,314681170236538 HINTON LLC ,14153.809999999998,Uncategorised, 
04-Dec-18,-48.94,644959701,,AUTOMATIC DRAWING,Mann-Dickerson,14104.869999999997,Bills, 
07-Dec-18,306.45,644959701,,TRANSFER DEBIT,301220061071113 ALLEN-GUERRERO ,14411.319999999998,Financial, 
08-Dec-18,110.25,644959701,,AUTOMATIC DRAWING,Johnson-Martin,14521.569999999998,Bills, 
08-Dec-18,-1279.25,644959701,,INTER-BANK CREDIT,Riggs PLC,13242.319999999998,Financial, 
09-Dec-18,-1223.07,644959701,,INTER-BANK CREDIT,Williams-Johnson,12019.249999999998,Bills, 
10-Dec-18,-1559.07,644959701,,INTER-BANK CREDIT,972773073346866 PEREZ-SMITH ,10460.179999999998,Other Income, 
12-Dec-18,-1679.06,644959701,,INTER-BANK CREDIT,Garcia Group,8781.119999999999,Financial, 
14-Dec-18,1919.13,644959701,,INTER-BANK CREDIT,370435684795171 JACKSON INC ,10700.25,Uncategorised, 
15-Dec-18,405.04,644959701,,INTER-BANK CREDIT,350035222476995 PRUITT PLC ,11105.29,Uncategorised, 
17-Dec-18,1373.82,644959701,,INTER-BANK CREDIT,332826552312419 TAYLOR SNYDER AND ARNOLD ,12479.11,Uncategorised, 
20-Dec-18,-1605.44,644959701,,INTER-BANK CREDIT,879820823604231 DRAKE RANDOLPH AND FORD ,10873.67,Bills, 
20-Dec-18,1760.64,644959701,,AUTOMATIC DRAWING,Hernandez Inc,12634.31,Other Income, 
21-Dec-18,-870.82,644959701,,INTER-BANK CREDIT,Diaz Group,11763.49,Financial, 
24-Dec-18,-1044.96,644959701,,AUTOMATIC DRAWING,9534747985885 LEWIS-SMITH ,10718.529999999999,Bills, 
25-Dec-18,-1221.93,644959701,,TRANSFER DEBIT,405439943263108 GONZALEZ PLC ,9496.599999999999,Financial, 
27-Dec-18,-1267.81,644959701,,TRANSFER DEBIT,471527080083722 WALKER NASH AND CHOI ,8228.789999999999,Financial, 
29-Dec-18,1292.21,644959701,,INTER-BANK CREDIT,939280738511486 WALTER PLC ,9521.0,Financial, 
30-Dec-18,-1147.3,644959701,,AUTOMATIC DRAWING,Buchanan Ltd,8373.7,Uncategorised, 
30-Dec-18,716.6,644959701,,TRANSFER DEBIT,614802645124689 HARVEY GROUP ,9090.300000000001,Financial, 
02-Jan-19,1302.82,644959701,,INTER-BANK CREDIT,473945015077676 PRINCE INC ,10393.12,Uncategorised, 
04-Jan-19,1143.38,644959701,,INTER-BANK CREDIT,204555113254755 CUMMINGS-LEWIS ,11536.5,Uncategorised, 
05-Jan-19,702.11,644959701,,AUTOMATIC DRAWING,Keller-Murray,12238.61,Uncategorised, 
06-Jan-19,371.23,644959701,,INTER-BANK CREDIT,179033236607513 ADAMS GROUP ,12609.84,Bills, 
09-Jan-19,1761.73,644959701,,INTER-BANK CREDIT,Curtis Grant and Ross,14371.57,Bills, 
10-Jan-19,508.75,644959701,,AUTOMATIC DRAWING,578194801465667 MATTHEWS GROUP ,14880.32,Other Income, 
10-Jan-19,1678.67,644959701,,AUTOMATIC DRAWING,708532667261262 LIVINGSTON-ROSE ,16558.989999999998,Other Income, 
10-Jan-19,-1281.04,644959701,,INTER-BANK CREDIT,Nelson Cisneros and Ochoa,15277.949999999997,Bills, 
12-Jan-19,-176.05,644959701,,AUTOMATIC DRAWING,Hooper Davenport and Brown,15101.899999999998,Financial, 
15-Jan-19,-1883.09,644959701,,AUTOMATIC DRAWING,Moreno Ochoa and Esparza,13218.809999999998,Other Income, 
17-Jan-19,1174.71,644959701,,INTER-BANK CREDIT,Solomon Chen and Henry,14393.519999999997,Financial, 
20-Jan-19,-375.33,644959701,,INTER-BANK CREDIT,Wright Key and Brown,14018.189999999997,Other Income, 
21-Jan-19,-1176.27,644959701,,AUTOMATIC DRAWING,Gibbs Carey and Hill,12841.919999999996,Uncategorised, 
24-Jan-19,-1317.47,644959701,,INTER-BANK CREDIT,547456825292268 MARTIN BURTON AND TORRES ,11524.449999999997,Financial, 
26-Jan-19,1035.36,644959701,,INTER-BANK CREDIT,947240569134172 OLSON WELLS AND CLARK ,12559.809999999998,Bills, 
27-Jan-19,1664.13,644959701,,INTER-BANK CREDIT,693538500839006 MEYER LTD ,14223.939999999999,Other Income, 
27-Jan-19,-139.53,644959701,,INTER-BANK CREDIT,Armstrong Ltd,14084.409999999998,Financial, 
30-Jan-19,894.66,644959701,,AUTOMATIC DRAWING,811833765670291 HILL DUNN AND DAY ,14979.069999999998,Bills, 
30-Jan-19,-1901.05,644959701,,INTER-BANK CREDIT,Randolph White and Hernandez,13078.019999999999,Bills, 
01-Feb-19,1246.57,644959701,,INTER-BANK CREDIT,Jefferson-Brown,14324.589999999998,Financial, 
02-Feb-19,-213.57,644959701,,TRANSFER DEBIT,347587918974388 KELLEY PLC ,14111.019999999999,Financial, 
03-Feb-19,1440.16,644959701,,TRANSFER DEBIT,Alvarez Francis and Mcgee,15551.179999999998,Bills, 
06-Feb-19,1261.66,644959701,,INTER-BANK CREDIT,750797306983714 REYNOLDS-WOOD ,16812.84,Other Income, 
08-Feb-19,-51.48,644959701,,AUTOMATIC DRAWING,283091734737831 BOYLE PLC ,16761.36,Financial, 
09-Feb-19,-1944.83,644959701,,AUTOMATIC DRAWING,811625576573004 TODD-WILLIAMS ,14816.53,Other Income, 
11-Feb-19,-690.67,644959701,,INTER-BANK CREDIT,494512540995703 SALINAS-GARDNER ,14125.86,Bills, 
11-Feb-19,-1372.59,644959701,,INTER-BANK CREDIT,Turner Martinez and Hickman,12753.27,Bills, 
13-Feb-19,29.46,644959701,,INTER-BANK CREDIT,475762645215408 JOHNSON INC ,12782.73,Uncategorised, 
13-Feb-19,1683.68,644959701,,TRANSFER DEBIT,388879012737792 PAYNE LTD ,14466.41,Bills, 
15-Feb-19,627.69,644959701,,TRANSFER DEBIT,977677853023309 CORTEZ-JOHNSON ,15094.1,Bills, 
18-Feb-19,1329.67,644959701,,INTER-BANK CREDIT,Harris-Duran,16423.77,Bills, 
18-Feb-19,1321.58,644959701,,INTER-BANK CREDIT,378264215683806 RODGERS INC ,17745.35,Bills, 
21-Feb-19,1957.85,644959701,,INTER-BANK CREDIT,Soto-Sanchez,19703.199999999997,Bills, 
24-Feb-19,60.75,644959701,,TRANSFER DEBIT,416632875342333 SIMPSON-REED ,19763.949999999997,Financial, 
26-Feb-19,-558.22,644959701,,INTER-BANK CREDIT,276228798242500 REILLY-BOWEN ,19205.729999999996,Financial, 
26-Feb-19,1674.47,644959701,,AUTOMATIC DRAWING,Harris Hernandez and Hernandez,20880.199999999997,Financial, 
28-Feb-19,289.55,644959701,,INTER-BANK CREDIT,Johns and Sons,21169.749999999996,Bills, 
01-Mar-19,1698.69,644959701,,AUTOMATIC DRAWING,Mitchell Becker and Martin,22868.439999999995,Other Income, 
01-Mar-19,-624.19,644959701,,INTER-BANK CREDIT,Vaughn-Page,22244.249999999996,Financial, 
01-Mar-19,436.59,644959701,,AUTOMATIC DRAWING,837824916636346 GUZMAN-BENNETT ,22680.839999999997,Uncategorised, 
04-Mar-19,1064.84,644959701,,AUTOMATIC DRAWING,328603463915299 STEVENS GROUP ,23745.679999999997,Other Income, 
07-Mar-19,-986.13,644959701,,INTER-BANK CREDIT,297982045950019 HUFFMAN REYNOLDS AND RODRIGUEZ ,22759.549999999996,Bills, 
08-Mar-19,1561.22,644959701,,INTER-BANK CREDIT,Cervantes-Gonzalez,24320.769999999997,Other Income, 
11-Mar-19,728.67,644959701,,INTER-BANK CREDIT,Mitchell-Watkins,25049.439999999995,Bills, 
13-Mar-19,365.54,644959701,,TRANSFER DEBIT,227965649968997 NELSON LLC ,25414.979999999996,Uncategorised, 
15-Mar-19,-1807.76,644959701,,TRANSFER DEBIT,970842576058260 FUENTES-OLSON ,23607.219999999998,Bills, 
18-Mar-19,1472.02,644959701,,AUTOMATIC DRAWING,403463795324111 VASQUEZ LLC ,25079.239999999998,Bills, 
18-Mar-19,246.05,644959701,,INTER-BANK CREDIT,Gray Cruz and Stevenson,25325.289999999997,Financial, 
21-Mar-19,1551.62,644959701,,TRANSFER DEBIT,342916011238525 GONZALEZ-HOFFMAN ,26876.909999999996,Other Income, 
22-Mar-19,1154.19,644959701,,AUTOMATIC DRAWING,Lopez-Bridges,28031.099999999995,Financial, 
24-Mar-19,1062.6,644959701,,INTER-BANK CREDIT,Espinoza Delgado and Sims,29093.699999999993,Bills, 
25-Mar-19,-1417.34,644959701,,INTER-BANK CREDIT,376909632879404 MICHAEL LEWIS AND BARTON ,27676.359999999993,Uncategorised, 
28-Mar-19,-1960.06,644959701,,AUTOMATIC DRAWING,886650602303227 MARTIN SAMPSON AND GEORGE ,25716.299999999992,Financial, 
28-Mar-19,-685.75,644959701,,TRANSFER DEBIT,Hall-Bullock,25030.549999999992,Uncategorised, 
29-Mar-19,-417.12,644959701,,INTER-BANK CREDIT,149416414473376 BECKER-BLEVINS ,24613.429999999993,Other Income, 
31-Mar-19,1907.06,644959701,,INTER-BANK CREDIT,44846118401191 COBB INC ,26520.489999999994,Financial, 
01-Apr-19,-748.32,644959701,,INTER-BANK CREDIT,254076939597140 BLACKBURN-YOUNG ,25772.169999999995,Bills, 
04-Apr-19,370.39,644959701,,INTER-BANK CREDIT,511284995341486 RODRIGUEZ-FARLEY ,26142.559999999994,Other Income, 
04-Apr-19,-3.12,644959701,,AUTOMATIC DRAWING,Frey-Hill,26139.439999999995,Bills, 
06-Apr-19,1471.35,644959701,,INTER-BANK CREDIT,600205711030751 KELLY LLC ,27610.789999999994,Other Income, 
09-Apr-19,-997.51,644959701,,INTER-BANK CREDIT,644860238001681 STEWART MILLER AND HERNANDEZ ,26613.279999999995,Uncategorised, 
09-Apr-19,1383.2,644959701,,AUTOMATIC DRAWING,539510252648654 TAYLOR BAKER AND WEISS ,27996.479999999996,Bills, 
10-Apr-19,1751.17,644959701,,INTER-BANK CREDIT,Holmes-Perez,29747.649999999994,Financial, 
10-Apr-19,1117.06,644959701,,INTER-BANK CREDIT,Adkins and Sons,30864.709999999995,Uncategorised, 
12-Apr-19,-1888.59,644959701,,TRANSFER DEBIT,Bryant Inc,28976.119999999995,Other Income, 
15-Apr-19,519.64,644959701,,INTER-BANK CREDIT,697029800828066 WILLIAMS HENRY AND MCKENZIE ,29495.759999999995,Other Income, 
17-Apr-19,-855.18,644959701,,TRANSFER DEBIT,Howell-Warren,28640.579999999994,Other Income, 
19-Apr-19,-374.82,644959701,,INTER-BANK CREDIT,Martin Byrd and Lowe,28265.759999999995,Bills, 
21-Apr-19,-1326.21,644959701,,INTER-BANK CREDIT,Collins Ltd,26939.549999999996,Uncategorised, 
22-Apr-19,-218.88,644959701,,AUTOMATIC DRAWING,615164838728665 JOHNSON-NELSON ,26720.669999999995,Other Income, 
24-Apr-19,1282.04,644959701,,INTER-BANK CREDIT,333997127065311 CLAY-MURRAY ,28002.709999999995,Bills, 
25-Apr-19,-1281.9,644959701,,TRANSFER DEBIT,803142204235266 LOWE-STONE ,26720.809999999994,Uncategorised, 
26-Apr-19,-1757.08,644959701,,TRANSFER DEBIT,Cox-Johnson,24963.729999999996,Uncategorised, 
28-Apr-19,701.97,644959701,,INTER-BANK CREDIT,Johnson LLC,25665.699999999997,Financial, 
28-Apr-19,289.48,644959701,,INTER-BANK CREDIT,576747842155353 CISNEROS PLC ,25955.179999999997,Financial, 
01-May-19,1294.96,644959701,,TRANSFER DEBIT,Mccarty Griffin and Keith,27250.139999999996,Uncategorised, 
01-May-19,1200.0,644959701,,INTER-BANK CREDIT,581941226328960 YOUNG LLC ,28450.139999999996,Uncategorised, 
04-May-19,894.26,644959701,,TRANSFER DEBIT,557824919091413 ROGERS GARCIA AND STAFFORD ,29344.399999999994,Bills, 
06-May-19,50.35,644959701,,TRANSFER DEBIT,292458224383835 MARTINEZ HARMON AND HOWARD ,29394.749999999993,Financial, 
06-May-19,-1038.57,644959701,,AUTOMATIC DRAWING,137938475018823 ARNOLD-ALLEN ,28356.179999999993,Uncategorised, 
08-May-19,57.39,644959701,,AUTOMATIC DRAWING,329857073698237 WHITE-WATKINS ,28413.569999999992,Financial, 
08-May-19,1355.4,644959701,,INTER-BANK CREDIT,242875673101383 THOMAS QUINN AND CRUZ ,29768.969999999994,Uncategorised, 
11-May-19,-1573.94,644959701,,AUTOMATIC DRAWING,128029955903477 FLOYD-NELSON ,28195.029999999995,Bills, 
12-May-19,1095.91,644959701,,INTER-BANK CREDIT,134141697490462 DAY-HERNANDEZ ,29290.939999999995,Financial, 
13-May-19,189.69,644959701,,TRANSFER DEBIT,510953538546421 GRIFFITH TAYLOR AND MARTIN ,29480.629999999994,Other Income, 
15-May-19,1032.61,644959701,,INTER-BANK CREDIT,551020462312936 HUDSON-SMITH ,30513.239999999994,Uncategorised, 
18-May-19,-1497.91,644959701,,INTER-BANK CREDIT,18226333553650 PATEL PLC ,29015.329999999994,Financial, 
20-May-19,1954.82,644959701,,INTER-BANK CREDIT,375366629883483 CLARK PLC ,30970.149999999994,Bills, 
23-May-19,-135.17,644959701,,TRANSFER DEBIT,Chambers Inc,30834.979999999996,Bills, 
26-May-19,-392.31,644959701,,INTER-BANK CREDIT,Chavez Gonzalez and Clark,30442.669999999995,Uncategorised, 
27-May-19,-967.79,644959701,,TRANSFER DEBIT,588665037155167 WALLACE TAYLOR AND WEBSTER ,29474.879999999994,Bills, 
28-May-19,-1852.71,644959701,,TRANSFER DEBIT,675955506678201 JONES INC ,27622.169999999995,Bills, 
29-May-19,-1634.49,644959701,,INTER-BANK CREDIT,Walker PLC,25987.679999999993,Uncategorised, 
29-May-19,1782.04,644959701,,AUTOMATIC DRAWING,Hahn-Clark,27769.719999999994,Uncategorised, 
30-May-19,-828.06,644959701,,INTER-BANK CREDIT,Williams Inc,26941.659999999993,Financial, 
02-Jun-19,-971.5,644959701,,INTER-BANK CREDIT,353968466595605 MCKENZIE-JOHNSON ,25970.159999999993,Uncategorised, 
03-Jun-19,1439.46,644959701,,INTER-BANK CREDIT,Franklin-Cruz,27409.61999999999,Uncategorised, 
03-Jun-19,-1166.32,644959701,,AUTOMATIC DRAWING,915908021533577 MARTINEZ-LEE ,26243.299999999992,Bills, 
04-Jun-19,-1424.46,644959701,,TRANSFER DEBIT,Dean Ltd,24818.839999999993,Uncategorised, 
04-Jun-19,-263.99,644959701,,TRANSFER DEBIT,Wilson-Morales,24554.84999999999,Financial, 
04-Jun-19,1248.55,644959701,,INTER-BANK CREDIT,403376147419254 BENTLEY-VAUGHN ,25803.39999999999,Other Income, 
06-Jun-19,990.4,644959701,,AUTOMATIC DRAWING,Marquez Ltd,26793.799999999992,Uncategorised, 
08-Jun-19,830.56,644959701,,TRANSFER DEBIT,234319048531879 HAWKINS MILLER AND HOPKINS ,27624.359999999993,Uncategorised, 
08-Jun-19,-1279.67,644959701,,INTER-BANK CREDIT,635744504062752 JOHNSON MURRAY AND JOHNSON ,26344.689999999995,Other Income, 
08-Jun-19,451.26,644959701,,TRANSFER DEBIT,284135261419650 MCKEE BARNES AND SANCHEZ ,26795.949999999993,Financial, 
08-Jun-19,1771.12,644959701,,INTER-BANK CREDIT,493567387989837 STEWART-WILLIAMSON ,28567.069999999992,Other Income, 
08-Jun-19,-1674.88,644959701,,INTER-BANK CREDIT,Reynolds LLC,26892.18999999999,Bills, 
10-Jun-19,1458.36,644959701,,INTER-BANK CREDIT,65400472118855 COOK-DECKER ,28350.549999999992,Bills, 
10-Jun-19,37.73,644959701,,INTER-BANK CREDIT,Walker Johnson and Villegas,28388.27999999999,Uncategorised, 
13-Jun-19,687.66,644959701,,INTER-BANK CREDIT,Hogan Inc,29075.93999999999,Uncategorised, 
15-Jun-19,462.53,644959701,,INTER-BANK CREDIT,Hodge-Anderson,29538.46999999999,Other Income, 
18-Jun-19,-1883.07,644959701,,INTER-BANK CREDIT,Rowland Richards and Le,27655.39999999999,Other Income, 
21-Jun-19,-1658.04,644959701,,INTER-BANK CREDIT,Bautista Inc,25997.35999999999,Bills, 
21-Jun-19,-831.29,644959701,,AUTOMATIC DRAWING,Smith LLC,25166.06999999999,Financial, 
24-Jun-19,1917.52,644959701,,INTER-BANK CREDIT,Lane-Gardner,27083.58999999999,Other Income, 
26-Jun-19,-1539.78,644959701,,INTER-BANK CREDIT,896507913262494 WILLIAMS GROUP ,25543.80999999999,Financial, 
27-Jun-19,1044.04,644959701,,INTER-BANK CREDIT,211322572549505 ROBINSON GARCIA AND BENTON ,26587.84999999999,Uncategorised, 
27-Jun-19,1970.1,644959701,,INTER-BANK CREDIT,Robinson Cuevas and Smith,28557.94999999999,Other Income, 
29-Jun-19,1522.43,644959701,,INTER-BANK CREDIT,Martin-Brown,30080.37999999999,Other Income, 
02-Jul-19,-696.51,644959701,,INTER-BANK CREDIT,Turner Moore and Wilson,29383.86999999999,Bills, 
04-Jul-19,-1541.76,644959701,,INTER-BANK CREDIT,Chang Ltd,27842.109999999993,Other Income, 
04-Jul-19,1569.78,644959701,,TRANSFER DEBIT,Schmidt Johnson and Sanders,29411.889999999992,Other Income, 
07-Jul-19,-549.87,644959701,,INTER-BANK CREDIT,359484529627279 CARTER-JONES ,28862.019999999993,Uncategorised, 
07-Jul-19,-74.35,644959701,,TRANSFER DEBIT,106108103214307 JAMES RODRIGUEZ AND HAMMOND ,28787.669999999995,Other Income, 
09-Jul-19,1827.21,644959701,,INTER-BANK CREDIT,Day PLC,30614.879999999994,Financial, 
09-Jul-19,-1557.88,644959701,,INTER-BANK CREDIT,White LLC,29056.999999999993,Bills, 
11-Jul-19,420.48,644959701,,TRANSFER DEBIT,Ramsey LLC,29477.479999999992,Bills, 
12-Jul-19,1224.45,644959701,,AUTOMATIC DRAWING,226940211793594 ROBERTS MAYER AND HARRISON ,30701.929999999993,Bills, 
15-Jul-19,-1034.26,644959701,,TRANSFER DEBIT,Browning-Thompson,29667.669999999995,Financial, 
18-Jul-19,-638.06,644959701,,INTER-BANK CREDIT,Hall Smith and Johnson,29029.609999999993,Uncategorised, 
20-Jul-19,-35.66,644959701,,TRANSFER DEBIT,566394144924705 GILLESPIE GONZALEZ AND BROWN ,28993.949999999993,Financial, 
23-Jul-19,959.41,644959701,,TRANSFER DEBIT,Perez and Sons,29953.359999999993,Other Income, 
25-Jul-19,-953.92,644959701,,TRANSFER DEBIT,Pena Casey and Bird,28999.439999999995,Uncategorised, 
28-Jul-19,-379.71,644959701,,INTER-BANK CREDIT,460262276732782 LOPEZ-MCNEIL ,28619.729999999996,Financial, 
29-Jul-19,1918.59,644959701,,INTER-BANK CREDIT,Franklin-Boyle,30538.319999999996,Bills, 
29-Jul-19,-1948.27,644959701,,INTER-BANK CREDIT,678279081802505 VASQUEZ LTD ,28590.049999999996,Uncategorised, 
31-Jul-19,97.86,644959701,,TRANSFER DEBIT,Lamb Herrera and Shannon,28687.909999999996,Bills, 
02-Aug-19,948.45,644959701,,INTER-BANK CREDIT,Rollins LLC,29636.359999999997,Other Income, 
05-Aug-19,-712.92,644959701,,INTER-BANK CREDIT,91941326272604 PONCE-BURNS ,28923.44,Financial, 
06-Aug-19,845.4,644959701,,TRANSFER DEBIT,Freeman Mcgee and Stevenson,29768.84,Other Income, 
08-Aug-19,966.61,644959701,,INTER-BANK CREDIT,Jefferson Beck and Harrell,30735.45,Financial, 
11-Aug-19,1868.84,644959701,,INTER-BANK CREDIT,443175088324333 LUTZ-SNYDER ,32604.29,Uncategorised, 
14-Aug-19,1509.05,644959701,,TRANSFER DEBIT,301501371704705 NELSON-HAYES ,34113.340000000004,Financial, 
15-Aug-19,-1245.37,644959701,,INTER-BANK CREDIT,Summers and Sons,32867.97,Financial, 
16-Aug-19,567.04,644959701,,AUTOMATIC DRAWING,869773692002281 NELSON GROUP ,33435.01,Uncategorised, 
16-Aug-19,-678.7,644959701,,INTER-BANK CREDIT,652431479716464 RODRIGUEZ-HARPER ,32756.31,Bills, 
17-Aug-19,653.48,644959701,,AUTOMATIC DRAWING,Christensen Miller and Black,33409.79,Uncategorised, 
19-Aug-19,-763.24,644959701,,AUTOMATIC DRAWING,687991955602191 VASQUEZ LLC ,32646.55,Other Income, 
21-Aug-19,544.35,644959701,,INTER-BANK CREDIT,Coffey-Griffith,33190.9,Bills, 
21-Aug-19,-1444.49,644959701,,INTER-BANK CREDIT,Johnston-Wright,31746.41,Other Income, 
23-Aug-19,304.07,644959701,,AUTOMATIC DRAWING,Lee PLC,32050.48,Uncategorised, 
26-Aug-19,-549.31,644959701,,INTER-BANK CREDIT,Potter Vasquez and Mcbride,31501.17,Other Income, 
29-Aug-19,-1489.74,644959701,,AUTOMATIC DRAWING,459036511291198 WEBER LTD ,30011.429999999997,Other Income, 
30-Aug-19,-786.86,644959701,,INTER-BANK CREDIT,York Shepherd and Campbell,29224.569999999996,Financial, 
30-Aug-19,-1563.34,644959701,,INTER-BANK CREDIT,Rodriguez-Franklin,27661.229999999996,Uncategorised, 
02-Sep-19,-441.2,644959701,,INTER-BANK CREDIT,160160859491208 HALL-PRATT ,27220.029999999995,Other Income, 
02-Sep-19,627.5,644959701,,AUTOMATIC DRAWING,695815009535338 MENDEZ-COHEN ,27847.529999999995,Uncategorised, 
05-Sep-19,-1528.23,644959701,,INTER-BANK CREDIT,Zuniga-Mcpherson,26319.299999999996,Bills, 
05-Sep-19,1643.9,644959701,,TRANSFER DEBIT,Brown Porter and Riley,27963.199999999997,Uncategorised, 
06-Sep-19,1390.65,644959701,,INTER-BANK CREDIT,Smith PLC,29353.85,Financial, 
07-Sep-19,-1702.19,644959701,,INTER-BANK CREDIT,Keller Lewis and Stevens,27651.66,Bills, 
09-Sep-19,-865.87,644959701,,AUTOMATIC DRAWING,189097508867585 LYNCH-HUNTER ,26785.79,Bills, 
10-Sep-19,1275.03,644959701,,INTER-BANK CREDIT,664064693025096 BROWN CAREY AND DAVIS ,28060.82,Other Income, 
11-Sep-19,1549.41,644959701,,TRANSFER DEBIT,277140837418127 PARKS GROUP ,29610.23,Uncategorised, 
12-Sep-19,1602.16,644959701,,TRANSFER DEBIT,Smith-Ward,31212.39,Other Income, 
13-Sep-19,1186.15,644959701,,INTER-BANK CREDIT,Reynolds Wilson and Webster,32398.54,Bills, 
15-Sep-19,-1575.47,644959701,,TRANSFER DEBIT,709712022323410 WILLIAMS-HILL ,30823.07,Other Income, 
16-Sep-19,-346.7,644959701,,INTER-BANK CREDIT,Charles Joseph and Mason,30476.37,Bills, 
17-Sep-19,1284.7,644959701,,INTER-BANK CREDIT,Gray PLC,31761.07,Bills, 
19-Sep-19,-909.08,644959701,,TRANSFER DEBIT,881791040799841 JACKSON-JACOBSON ,30851.989999999998,Other Income, 
19-Sep-19,-1401.27,644959701,,TRANSFER DEBIT,Adams Mack and Wells,29450.719999999998,Other Income, 
21-Sep-19,-684.64,644959701,,TRANSFER DEBIT,Allen and Sons,28766.079999999998,Other Income, 
23-Sep-19,-1561.42,644959701,,TRANSFER DEBIT,383643780463822 RICE LLC ,27204.659999999996,Other Income, 
26-Sep-19,-864.13,644959701,,INTER-BANK CREDIT,37495314673690 PARRISH KENNEDY AND ORTIZ ,26340.529999999995,Other Income, 
27-Sep-19,1389.88,644959701,,INTER-BANK CREDIT,Black-Hobbs,27730.409999999996,Bills, 
29-Sep-19,1239.29,644959701,,TRANSFER DEBIT,Lawson Christensen and Hodges,28969.699999999997,Other Income, 
30-Sep-19,-1474.36,644959701,,INTER-BANK CREDIT,Long Wilson and Mitchell,27495.339999999997,Financial, 
03-Oct-19,1923.69,644959701,,INTER-BANK CREDIT,Mayer Gonzalez and Martinez,29419.029999999995,Other Income, 
04-Oct-19,715.07,644959701,,TRANSFER DEBIT,137740427318905 JOHNSTON TERRELL AND FLORES ,30134.099999999995,Uncategorised, 
04-Oct-19,1892.84,644959701,,AUTOMATIC DRAWING,Ruiz-Scott,32026.939999999995,Bills, 
06-Oct-19,-1070.54,644959701,,AUTOMATIC DRAWING,Bauer LLC,30956.399999999994,Bills, 
07-Oct-19,-414.81,644959701,,INTER-BANK CREDIT,79713229065076 GONZALEZ GROUP ,30541.589999999993,Other Income, 
07-Oct-19,1243.69,644959701,,INTER-BANK CREDIT,Simmons-Lowe,31785.27999999999,Uncategorised, 
07-Oct-19,877.29,644959701,,TRANSFER DEBIT,402551168626131 SPARKS MERCADO AND GALLOWAY ,32662.569999999992,Bills, 
09-Oct-19,1628.63,644959701,,INTER-BANK CREDIT,194544672357646 WHITE CASE AND GROSS ,34291.19999999999,Bills, 
09-Oct-19,-291.84,644959701,,TRANSFER DEBIT,496459156470052 FLORES INC ,33999.35999999999,Other Income, 
10-Oct-19,1706.08,644959701,,INTER-BANK CREDIT,Campbell-Mcdonald,35705.439999999995,Uncategorised, 
11-Oct-19,-441.39,644959701,,AUTOMATIC DRAWING,832066392770666 BEARD-PARRISH ,35264.049999999996,Financial, 
13-Oct-19,1415.04,644959701,,AUTOMATIC DRAWING,328394050940652 CLARK OWENS AND BURNS ,36679.09,Uncategorised, 
13-Oct-19,53.24,644959701,,INTER-BANK CREDIT,Valdez-Adams,36732.329999999994,Uncategorised, 
13-Oct-19,1546.02,644959701,,INTER-BANK CREDIT,Perez-Rogers,38278.34999999999,Uncategorised, 
13-Oct-19,-764.19,644959701,,TRANSFER DEBIT,Zimmerman Inc,37514.15999999999,Uncategorised, 
15-Oct-19,897.76,644959701,,INTER-BANK CREDIT,561907216324997 SANCHEZ PLC ,38411.91999999999,Uncategorised, 
18-Oct-19,-459.89,644959701,,INTER-BANK CREDIT,Montes Lee and Ward,37952.02999999999,Financial, 
21-Oct-19,-780.04,644959701,,INTER-BANK CREDIT,Harrison-Johnson,37171.98999999999,Uncategorised, 
22-Oct-19,1206.28,644959701,,INTER-BANK CREDIT,308758126216624 CALDWELL GRAVES AND PRICE ,38378.26999999999,Other Income, 
22-Oct-19,-1285.16,644959701,,INTER-BANK CREDIT,34365971461703 BAILEY THOMPSON AND BRIDGES ,37093.109999999986,Other Income, 
23-Oct-19,1940.3,644959701,,INTER-BANK CREDIT,251499024275537 DIAZ-JONES ,39033.40999999999,Bills, 
25-Oct-19,-394.36,644959701,,INTER-BANK CREDIT,Bell Ltd,38639.04999999999,Financial, 
25-Oct-19,99.51,644959701,,TRANSFER DEBIT,Castro-Nielsen,38738.55999999999,Uncategorised, 
28-Oct-19,-532.43,644959701,,INTER-BANK CREDIT,964677757327556 SCHROEDER-WATKINS ,38206.12999999999,Financial, 
28-Oct-19,-1647.15,644959701,,INTER-BANK CREDIT,Evans-Sanchez,36558.97999999999,Uncategorised, 
30-Oct-19,-1337.22,644959701,,AUTOMATIC DRAWING,Hudson Mcdonald and Jenkins,35221.75999999999,Bills, 
31-Oct-19,377.58,644959701,,INTER-BANK CREDIT,Avery and Sons,35599.33999999999,Financial, 
02-Nov-19,-88.41,644959701,,INTER-BANK CREDIT,Mason Hall and Wang,35510.929999999986,Financial, 
04-Nov-19,1287.04,644959701,,TRANSFER DEBIT,Perez-Russell,36797.96999999999,Uncategorised, 
06-Nov-19,1925.9,644959701,,AUTOMATIC DRAWING,751422988418808 FARLEY CRAWFORD AND WILLIS ,38723.86999999999,Uncategorised, 
06-Nov-19,-1871.08,644959701,,TRANSFER DEBIT,678542654884885 FOWLER RYAN AND MITCHELL ,36852.789999999986,Other Income, 
08-Nov-19,-1603.83,644959701,,INTER-BANK CREDIT,999424836743341 PEREZ HOWARD AND GONZALEZ ,35248.959999999985,Uncategorised, 
10-Nov-19,333.78,644959701,,INTER-BANK CREDIT,Vance Vazquez and Wilson,35582.73999999998,Bills, 
10-Nov-19,-87.08,644959701,,TRANSFER DEBIT,826678891104652 PAYNE WYATT AND WRIGHT ,35495.65999999998,Bills, 
12-Nov-19,17.85,644959701,,INTER-BANK CREDIT,339175096147236 HERNANDEZ-KIRK ,35513.50999999998,Financial, 
15-Nov-19,-1781.45,644959701,,TRANSFER DEBIT,Keller PLC,33732.05999999998,Other Income, 
15-Nov-19,-171.33,644959701,,INTER-BANK CREDIT,283494866085499 CRAWFORD-GRANT ,33560.72999999998,Bills, 
17-Nov-19,1558.86,644959701,,INTER-BANK CREDIT,40970284684825 KELLY AND SONS ,35119.58999999998,Bills, 
20-Nov-19,702.56,644959701,,INTER-BANK CREDIT,543102103916218 SNYDER GROUP ,35822.14999999998,Bills, 
20-Nov-19,-917.68,644959701,,INTER-BANK CREDIT,641682424953811 MILLER AND SONS ,34904.46999999998,Financial, 
23-Nov-19,207.24,644959701,,TRANSFER DEBIT,Adams Garcia and Ford,35111.70999999998,Financial, 
25-Nov-19,1415.13,644959701,,AUTOMATIC DRAWING,Vega and Sons,36526.839999999975,Other Income, 
28-Nov-19,-1334.32,644959701,,INTER-BANK CREDIT,Perez-Garrett,35192.519999999975,Other Income, 
01-Dec-19,1303.68,644959701,,INTER-BANK CREDIT,661530685477879 FLOYD-WEBSTER ,36496.199999999975,Bills, 
02-Dec-19,572.07,644959701,,INTER-BANK CREDIT,Smith Ltd,37068.269999999975,Financial, 
05-Dec-19,-870.11,644959701,,TRANSFER DEBIT,114325414555357 KELLER VANCE AND BURTON ,36198.159999999974,Uncategorised, 
06-Dec-19,-796.13,644959701,,AUTOMATIC DRAWING,778894662930486 OBRIEN TAYLOR AND FIGUEROA ,35402.02999999998,Bills, 
07-Dec-19,-1316.25,644959701,,TRANSFER DEBIT,735084834243799 OLSEN LLC ,34085.77999999998,Bills, 
09-Dec-19,-1454.07,644959701,,INTER-BANK CREDIT,White Inc,32631.709999999977,Bills, 
10-Dec-19,-769.19,644959701,,TRANSFER DEBIT,Young-Doyle,31862.51999999998,Bills, 
10-Dec-19,888.85,644959701,,INTER-BANK CREDIT,409664224516939 FORD-WILSON ,32751.369999999977,Bills, 
13-Dec-19,467.68,644959701,,INTER-BANK CREDIT,132657773365782 HAYNES LTD ,33219.049999999974,Other Income, 
13-Dec-19,1678.11,644959701,,INTER-BANK CREDIT,168674723262304 ROBERTS-JOHNSON ,34897.159999999974,Uncategorised, 
13-Dec-19,1963.23,644959701,,INTER-BANK CREDIT,Williams-Ingram,36860.38999999998,Other Income, 
16-Dec-19,1784.6,644959701,,AUTOMATIC DRAWING,849402220341371 JOHNSON INC ,38644.989999999976,Uncategorised, 
16-Dec-19,-733.62,644959701,,INTER-BANK CREDIT,523610422005321 ROGERS YOUNG AND MARTIN ,37911.36999999997,Financial, 
19-Dec-19,83.08,644959701,,AUTOMATIC DRAWING,787004200277958 ANDERSON GROUP ,37994.449999999975,Other Income, 
21-Dec-19,1767.04,644959701,,TRANSFER DEBIT,Lopez White and Martinez,39761.489999999976,Other Income, 
