Date,Amount,Account Number,,Transaction Type,Transaction Details,Balance,Category,Merchant Name
11-Sep-17,-1103.69,260271687,,INTER-BANK CREDIT,Roth-Richardson,-6945.879999999999,Uncategorised, 
13-Sep-17,1306.33,260271687,,INTER-BANK CREDIT,844558741308023 MEDINA GROUP ,-5639.549999999999,Bills, 
15-Sep-17,-124.0,260271687,,INTER-BANK CREDIT,531011040144831 MCLEAN BAXTER AND MCKENZIE ,-5763.549999999999,Financial, 
16-Sep-17,-973.07,260271687,,AUTOMATIC DRAWING,Johnson-Benjamin,-6736.619999999999,Bills, 
16-Sep-17,-1782.8,260271687,,TRANSFER DEBIT,Sharp Whitehead and Hill,-8519.419999999998,Other Income, 
17-Sep-17,1958.35,260271687,,TRANSFER DEBIT,Woodward LLC,-6561.069999999998,Financial, 
17-Sep-17,-150.83,260271687,,AUTOMATIC DRAWING,499855246919154 LEWIS-TAYLOR ,-6711.899999999998,Other Income, 
19-Sep-17,-1097.49,260271687,,INTER-BANK CREDIT,525575303160230 DUNN LLC ,-7809.389999999998,Bills, 
20-Sep-17,136.8,260271687,,INTER-BANK CREDIT,Klein Inc,-7672.589999999997,Financial, 
23-Sep-17,-1040.46,260271687,,INTER-BANK CREDIT,Schneider Perez and Lopez,-8713.049999999997,Uncategorised, 
24-Sep-17,-996.05,260271687,,TRANSFER DEBIT,691161364082403 BIRD SMITH AND BOYD ,-9709.099999999997,Uncategorised, 
26-Sep-17,-1714.15,260271687,,AUTOMATIC DRAWING,Walsh-Levy,-11423.249999999996,Bills, 
27-Sep-17,-980.68,260271687,,INTER-BANK CREDIT,610659810478716 FRANKLIN-LOPEZ ,-12403.929999999997,Bills, 
28-Sep-17,-353.68,260271687,,TRANSFER DEBIT,79244701470630 MILLS SMITH AND MEYERS ,-12757.609999999997,Other Income, 
30-Sep-17,55.12,260271687,,INTER-BANK CREDIT,810146088454098 FISHER LLC ,-12702.489999999996,Bills, 
02-Oct-17,717.99,260271687,,AUTOMATIC DRAWING,Gonzalez-Kelley,-11984.499999999996,Uncategorised, 
03-Oct-17,-412.68,260271687,,AUTOMATIC DRAWING,Boyle PLC,-12397.179999999997,Uncategorised, 
03-Oct-17,-1200.13,260271687,,TRANSFER DEBIT,Berger PLC,-13597.309999999998,Bills, 
03-Oct-17,978.66,260271687,,INTER-BANK CREDIT,789873235636008 KOCH MENDOZA AND JACKSON ,-12618.649999999998,Uncategorised, 
06-Oct-17,-450.2,260271687,,TRANSFER DEBIT,204598637972411 BURKE RANGEL AND MOLINA ,-13068.849999999999,Other Income, 
07-Oct-17,-1411.34,260271687,,INTER-BANK CREDIT,Beck Group,-14480.189999999999,Bills, 
07-Oct-17,694.52,260271687,,AUTOMATIC DRAWING,Watson Ltd,-13785.669999999998,Bills, 
09-Oct-17,1257.23,260271687,,AUTOMATIC DRAWING,Blankenship Inc,-12528.439999999999,Financial, 
12-Oct-17,-1806.54,260271687,,TRANSFER DEBIT,515182176168273 EDWARDS LLC ,-14334.98,Financial, 
12-Oct-17,-203.39,260271687,,AUTOMATIC DRAWING,268036453675082 WRIGHT-JONES ,-14538.369999999999,Uncategorised, 
13-Oct-17,-1301.66,260271687,,AUTOMATIC DRAWING,Weaver LLC,-15840.029999999999,Uncategorised, 
13-Oct-17,-213.41,260271687,,TRANSFER DEBIT,Mueller Gomez and Wilson,-16053.439999999999,Financial, 
15-Oct-17,658.99,260271687,,INTER-BANK CREDIT,Wilson Ramirez and Chase,-15394.449999999999,Bills, 
16-Oct-17,327.47,260271687,,AUTOMATIC DRAWING,716907806654446 GARCIA INC ,-15066.98,Financial, 
19-Oct-17,-1798.73,260271687,,TRANSFER DEBIT,963151689872979 HALL AND SONS ,-16865.71,Other Income, 
22-Oct-17,1024.63,260271687,,INTER-BANK CREDIT,Hamilton and Sons,-15841.079999999998,Uncategorised, 
25-Oct-17,-1176.19,260271687,,TRANSFER DEBIT,King Santiago and Marshall,-17017.269999999997,Financial, 
28-Oct-17,-281.94,260271687,,INTER-BANK CREDIT,Phillips-Simon,-17299.209999999995,Other Income, 
31-Oct-17,1666.77,260271687,,AUTOMATIC DRAWING,370010168801686 PONCE-DAVIS ,-15632.439999999995,Financial, 
31-Oct-17,1604.01,260271687,,AUTOMATIC DRAWING,946403334806697 CONLEY CLARK AND COLE ,-14028.429999999995,Other Income, 
01-Nov-17,1996.27,260271687,,INTER-BANK CREDIT,388481540976296 RODRIGUEZ LTD ,-12032.159999999994,Uncategorised, 
01-Nov-17,-318.83,260271687,,AUTOMATIC DRAWING,Oneal Horton and Pittman,-12350.989999999994,Financial, 
04-Nov-17,1838.0,260271687,,INTER-BANK CREDIT,603086145547892 ADAMS-GUTIERREZ ,-10512.989999999994,Bills, 
05-Nov-17,-217.65,260271687,,INTER-BANK CREDIT,Moss PLC,-10730.639999999994,Financial, 
05-Nov-17,-1517.77,260271687,,TRANSFER DEBIT,Smith-Mcpherson,-12248.409999999994,Financial, 
07-Nov-17,-457.33,260271687,,AUTOMATIC DRAWING,56670595038209 MITCHELL LLC ,-12705.739999999994,Financial, 
08-Nov-17,-490.36,260271687,,AUTOMATIC DRAWING,65440963447044 HOOVER-KENNEDY ,-13196.099999999995,Bills, 
11-Nov-17,-662.57,260271687,,AUTOMATIC DRAWING,474841786584223 CONRAD INC ,-13858.669999999995,Uncategorised, 
12-Nov-17,-429.95,260271687,,INTER-BANK CREDIT,Gibson-Harvey,-14288.619999999995,Bills, 
12-Nov-17,-1984.06,260271687,,AUTOMATIC DRAWING,445585655058340 REYNOLDS AND SONS ,-16272.679999999995,Financial, 
13-Nov-17,454.45,260271687,,INTER-BANK CREDIT,549839622563024 KNAPP-TUCKER ,-15818.229999999994,Other Income, 
13-Nov-17,1792.07,260271687,,INTER-BANK CREDIT,165058703697742 RAMIREZ-WILLIAMS ,-14026.159999999994,Bills, 
16-Nov-17,666.94,260271687,,TRANSFER DEBIT,649517307815121 CUNNINGHAM HUNT AND DECKER ,-13359.219999999994,Other Income, 
16-Nov-17,-1146.47,260271687,,INTER-BANK CREDIT,789858690843023 CASTANEDA WHITE AND WYATT ,-14505.689999999993,Other Income, 
18-Nov-17,-260.69,260271687,,INTER-BANK CREDIT,Fernandez and Sons,-14766.379999999994,Uncategorised, 
21-Nov-17,-312.34,260271687,,TRANSFER DEBIT,768494996558547 GRANT LLC ,-15078.719999999994,Other Income, 
24-Nov-17,1205.12,260271687,,TRANSFER DEBIT,745460955252278 ESPINOZA INC ,-13873.599999999995,Uncategorised, 
24-Nov-17,1188.24,260271687,,TRANSFER DEBIT,875748208318607 KIM HERNANDEZ AND WILLIAMS ,-12685.359999999995,Uncategorised, 
27-Nov-17,1558.81,260271687,,INTER-BANK CREDIT,Cook Watson and Jones,-11126.549999999996,Other Income, 
30-Nov-17,-1665.23,260271687,,TRANSFER DEBIT,Holmes-Vincent,-12791.779999999995,Bills, 
30-Nov-17,-569.44,260271687,,INTER-BANK CREDIT,Thompson Inc,-13361.219999999996,Bills, 
03-Dec-17,-1780.48,260271687,,INTER-BANK CREDIT,325544758281130 CARRILLO-DICKERSON ,-15141.699999999995,Other Income, 
03-Dec-17,946.2,260271687,,AUTOMATIC DRAWING,Huff Ross and Bryant,-14195.499999999995,Uncategorised, 
04-Dec-17,1246.8,260271687,,TRANSFER DEBIT,82040083006061 KLEIN-POLLARD ,-12948.699999999995,Other Income, 
05-Dec-17,1877.79,260271687,,TRANSFER DEBIT,Jones-Nunez,-11070.909999999996,Uncategorised, 
08-Dec-17,-395.58,260271687,,INTER-BANK CREDIT,102750905243032 GALVAN-SMITH ,-11466.489999999996,Uncategorised, 
11-Dec-17,-974.24,260271687,,INTER-BANK CREDIT,808831048134592 BUTLER-JAMES ,-12440.729999999996,Uncategorised, 
13-Dec-17,93.92,260271687,,INTER-BANK CREDIT,698419401071889 GOLDEN-GEORGE ,-12346.809999999996,Other Income, 
16-Dec-17,1478.02,260271687,,TRANSFER DEBIT,Gibson-Sullivan,-10868.789999999995,Uncategorised, 
19-Dec-17,1333.58,260271687,,TRANSFER DEBIT,Wilson George and Garza,-9535.209999999995,Other Income, 
19-Dec-17,1465.01,260271687,,AUTOMATIC DRAWING,Lopez Figueroa and Butler,-8070.199999999995,Financial, 
19-Dec-17,555.33,260271687,,TRANSFER DEBIT,687845782480022 DAY-DUNN ,-7514.869999999995,Other Income, 
21-Dec-17,-1936.83,260271687,,TRANSFER DEBIT,Scott Underwood and Wheeler,-9451.699999999995,Uncategorised, 
24-Dec-17,-623.74,260271687,,TRANSFER DEBIT,Perez-Wilson,-10075.439999999995,Financial, 
26-Dec-17,790.97,260271687,,INTER-BANK CREDIT,81488890565396 LITTLE LEE AND GARRETT ,-9284.469999999996,Financial, 
28-Dec-17,1943.45,260271687,,TRANSFER DEBIT,Morales-Burnett,-7341.019999999996,Financial, 
28-Dec-17,417.86,260271687,,AUTOMATIC DRAWING,57313141877911 NELSON GROUP ,-6923.159999999996,Other Income, 
30-Dec-17,-1377.85,260271687,,AUTOMATIC DRAWING,Hunt Inc,-8301.009999999997,Other Income, 
31-Dec-17,1105.57,260271687,,INTER-BANK CREDIT,Adams Pratt and Abbott,-7195.439999999997,Uncategorised, 
02-Jan-18,1168.72,260271687,,AUTOMATIC DRAWING,894885845848052 MACDONALD-ROSE ,-6026.719999999997,Other Income, 
04-Jan-18,873.37,260271687,,TRANSFER DEBIT,244762347413087 JOHNSON AND SONS ,-5153.349999999997,Bills, 
06-Jan-18,-847.48,260271687,,AUTOMATIC DRAWING,564030586115222 GREGORY LTD ,-6000.829999999996,Financial, 
07-Jan-18,4.59,260271687,,AUTOMATIC DRAWING,292558751204624 QUINN GREENE AND ALLISON ,-5996.239999999996,Bills, 
08-Jan-18,-1834.28,260271687,,INTER-BANK CREDIT,Kelly PLC,-7830.519999999996,Financial, 
10-Jan-18,677.5,260271687,,TRANSFER DEBIT,Hamilton and Sons,-7153.019999999996,Uncategorised, 
10-Jan-18,1433.25,260271687,,AUTOMATIC DRAWING,482064182664787 MOSLEY PAYNE AND HILL ,-5719.769999999996,Bills, 
11-Jan-18,1560.95,260271687,,INTER-BANK CREDIT,356896843562979 EVANS INC ,-4158.819999999996,Financial, 
13-Jan-18,-1011.5,260271687,,INTER-BANK CREDIT,Dean-Roberts,-5170.319999999996,Uncategorised, 
15-Jan-18,-210.22,260271687,,TRANSFER DEBIT,Dixon PLC,-5380.539999999996,Financial, 
16-Jan-18,844.16,260271687,,AUTOMATIC DRAWING,Lawrence-Russo,-4536.3799999999965,Bills, 
18-Jan-18,-730.48,260271687,,INTER-BANK CREDIT,Morris-Vincent,-5266.859999999997,Uncategorised, 
18-Jan-18,-865.02,260271687,,TRANSFER DEBIT,Lewis LLC,-6131.879999999997,Financial, 
19-Jan-18,-1571.97,260271687,,INTER-BANK CREDIT,Payne Mckee and Bowers,-7703.849999999998,Uncategorised, 
22-Jan-18,-945.81,260271687,,TRANSFER DEBIT,184886510115388 CRUZ-SEXTON ,-8649.659999999998,Other Income, 
22-Jan-18,-1746.07,260271687,,AUTOMATIC DRAWING,262944267751372 BROWN MCGUIRE AND STUART ,-10395.729999999998,Uncategorised, 
24-Jan-18,260.72,260271687,,INTER-BANK CREDIT,771910101126627 SPENCER-DOUGHERTY ,-10135.009999999998,Financial, 
27-Jan-18,-435.56,260271687,,INTER-BANK CREDIT,Schneider Davis and Robertson,-10570.569999999998,Financial, 
29-Jan-18,-1455.09,260271687,,AUTOMATIC DRAWING,Vasquez-Pham,-12025.659999999998,Financial, 
31-Jan-18,1226.22,260271687,,INTER-BANK CREDIT,868116669521935 SCHWARTZ-NOBLE ,-10799.439999999999,Uncategorised, 
01-Feb-18,833.01,260271687,,AUTOMATIC DRAWING,531071117128907 HAAS-BROWN ,-9966.429999999998,Bills, 
01-Feb-18,-1299.72,260271687,,INTER-BANK CREDIT,Johns Brown and Oliver,-11266.149999999998,Uncategorised, 
01-Feb-18,908.29,260271687,,AUTOMATIC DRAWING,581554551986283 FISHER BARNES AND HENSLEY ,-10357.859999999997,Bills, 
02-Feb-18,-1433.15,260271687,,INTER-BANK CREDIT,Huerta Hawkins and Austin,-11791.009999999997,Financial, 
02-Feb-18,879.79,260271687,,TRANSFER DEBIT,101828452753939 SMITH-TODD ,-10911.219999999998,Financial, 
02-Feb-18,852.65,260271687,,INTER-BANK CREDIT,135663469898216 NELSON GROUP ,-10058.569999999998,Other Income, 
05-Feb-18,1746.78,260271687,,AUTOMATIC DRAWING,Butler Group,-8311.789999999997,Financial, 
05-Feb-18,1803.59,260271687,,TRANSFER DEBIT,247651766870907 CARPENTER RYAN AND PETERSON ,-6508.199999999997,Financial, 
06-Feb-18,-400.18,260271687,,TRANSFER DEBIT,Johnson-Cunningham,-6908.379999999997,Financial, 
07-Feb-18,1972.63,260271687,,TRANSFER DEBIT,Park Group,-4935.749999999997,Bills, 
09-Feb-18,460.67,260271687,,TRANSFER DEBIT,868278130382548 SPENCER AVERY AND WATSON ,-4475.079999999997,Financial, 
09-Feb-18,-105.04,260271687,,INTER-BANK CREDIT,276760708341607 MCCOY JACOBS AND GARCIA ,-4580.119999999997,Bills, 
09-Feb-18,955.59,260271687,,INTER-BANK CREDIT,Ryan Duffy and Mueller,-3624.529999999997,Financial, 
11-Feb-18,1048.86,260271687,,AUTOMATIC DRAWING,279589852987939 GENTRY PETERS AND GARCIA ,-2575.6699999999973,Bills, 
11-Feb-18,358.72,260271687,,INTER-BANK CREDIT,Grant LLC,-2216.949999999997,Other Income, 
11-Feb-18,-19.55,260271687,,INTER-BANK CREDIT,Nelson LLC,-2236.4999999999973,Uncategorised, 
13-Feb-18,-1412.93,260271687,,AUTOMATIC DRAWING,359587242325727 ANDERSON LTD ,-3649.4299999999976,Other Income, 
13-Feb-18,1569.91,260271687,,INTER-BANK CREDIT,68078664820501 WATSON-DOWNS ,-2079.5199999999977,Other Income, 
14-Feb-18,-518.11,260271687,,INTER-BANK CREDIT,Cooper Schneider and Swanson,-2597.629999999998,Uncategorised, 
17-Feb-18,515.14,260271687,,AUTOMATIC DRAWING,247011693885759 HENSLEY GORDON AND ANDERSON ,-2082.489999999998,Other Income, 
20-Feb-18,1634.11,260271687,,INTER-BANK CREDIT,Davis and Sons,-448.37999999999806,Financial, 
23-Feb-18,-1483.94,260271687,,INTER-BANK CREDIT,792809139701935 MOORE FARMER AND DAVIS ,-1932.3199999999981,Financial, 
26-Feb-18,1249.37,260271687,,AUTOMATIC DRAWING,Lane Inc,-682.9499999999982,Bills, 
28-Feb-18,-1662.24,260271687,,AUTOMATIC DRAWING,Rivera Gomez and Wallace,-2345.1899999999982,Financial, 
02-Mar-18,-534.06,260271687,,AUTOMATIC DRAWING,412465447969214 HART-RIOS ,-2879.249999999998,Bills, 
03-Mar-18,-554.81,260271687,,INTER-BANK CREDIT,639903024890014 FORD-SERRANO ,-3434.059999999998,Uncategorised, 
05-Mar-18,1500.83,260271687,,INTER-BANK CREDIT,Nelson PLC,-1933.2299999999982,Financial, 
06-Mar-18,352.23,260271687,,TRANSFER DEBIT,Hunter-Moore,-1580.9999999999982,Bills, 
07-Mar-18,1529.16,260271687,,TRANSFER DEBIT,320206129670564 BLEVINS BECK AND BECK ,-51.8399999999981,Bills, 
10-Mar-18,552.47,260271687,,TRANSFER DEBIT,Park-Lozano,500.6300000000019,Bills, 
11-Mar-18,-940.97,260271687,,TRANSFER DEBIT,Sanford Group,-440.3399999999981,Other Income, 
13-Mar-18,1418.31,260271687,,INTER-BANK CREDIT,Vega Parker and Hernandez,977.9700000000018,Bills, 
15-Mar-18,-1142.45,260271687,,TRANSFER DEBIT,20242538628649 HUGHES LTD ,-164.4799999999982,Uncategorised, 
15-Mar-18,816.12,260271687,,AUTOMATIC DRAWING,Nolan-Medina,651.6400000000018,Other Income, 
17-Mar-18,1861.47,260271687,,INTER-BANK CREDIT,661790129956457 PEARSON OLSEN AND NORRIS ,2513.110000000002,Uncategorised, 
18-Mar-18,1662.57,260271687,,INTER-BANK CREDIT,491883266376149 EDWARDS GROUP ,4175.680000000002,Uncategorised, 
18-Mar-18,1099.33,260271687,,AUTOMATIC DRAWING,Nelson-Carr,5275.010000000002,Bills, 
18-Mar-18,1211.7,260271687,,TRANSFER DEBIT,475609237793241 RAYMOND STEWART AND COLE ,6486.710000000002,Other Income, 
18-Mar-18,112.36,260271687,,INTER-BANK CREDIT,435904605968548 SCOTT ANDERSON AND CORTEZ ,6599.0700000000015,Bills, 
20-Mar-18,-1307.0,260271687,,AUTOMATIC DRAWING,Harvey Mullins and Gray,5292.0700000000015,Financial, 
21-Mar-18,-818.91,260271687,,TRANSFER DEBIT,Sellers PLC,4473.160000000002,Financial, 
24-Mar-18,1596.53,260271687,,TRANSFER DEBIT,Moore Inc,6069.690000000001,Financial, 
24-Mar-18,248.35,260271687,,TRANSFER DEBIT,Bender-Baker,6318.040000000002,Uncategorised, 
26-Mar-18,682.38,260271687,,AUTOMATIC DRAWING,Barnett Group,7000.420000000002,Other Income, 
28-Mar-18,1046.53,260271687,,AUTOMATIC DRAWING,Lee-Miller,8046.950000000002,Uncategorised, 
28-Mar-18,-1083.97,260271687,,INTER-BANK CREDIT,Hall-Jackson,6962.980000000001,Other Income, 
29-Mar-18,-848.66,260271687,,AUTOMATIC DRAWING,656197371335895 RODRIGUEZ CLARK AND GONZALEZ ,6114.3200000000015,Uncategorised, 
29-Mar-18,1973.56,260271687,,INTER-BANK CREDIT,Williams Group,8087.880000000001,Bills, 
30-Mar-18,-432.49,260271687,,TRANSFER DEBIT,Johnson Villarreal and Wise,7655.390000000001,Financial, 
31-Mar-18,1499.75,260271687,,INTER-BANK CREDIT,Beck-Adkins,9155.140000000001,Other Income, 
01-Apr-18,-1752.12,260271687,,INTER-BANK CREDIT,463998816822657 PRUITT-SMITH ,7403.020000000001,Other Income, 
01-Apr-18,-350.38,260271687,,AUTOMATIC DRAWING,Carlson-Nelson,7052.640000000001,Financial, 
02-Apr-18,-987.8,260271687,,TRANSFER DEBIT,Holden Fox and Nelson,6064.840000000001,Financial, 
05-Apr-18,1656.66,260271687,,TRANSFER DEBIT,Johnson Bryant and Young,7721.500000000001,Financial, 
08-Apr-18,1278.65,260271687,,INTER-BANK CREDIT,Mcbride Perez and Terry,9000.150000000001,Financial, 
11-Apr-18,-562.82,260271687,,AUTOMATIC DRAWING,33112459115746 NOLAN MOORE AND JENKINS ,8437.330000000002,Other Income, 
11-Apr-18,331.46,260271687,,TRANSFER DEBIT,Bond Johnson and Solis,8768.79,Uncategorised, 
12-Apr-18,800.23,260271687,,AUTOMATIC DRAWING,877195688341246 HILL MURRAY AND LOGAN ,9569.02,Other Income, 
14-Apr-18,64.1,260271687,,AUTOMATIC DRAWING,Martinez Graham and Gill,9633.12,Financial, 
14-Apr-18,-632.65,260271687,,INTER-BANK CREDIT,Campbell Castillo and Neal,9000.470000000001,Uncategorised, 
15-Apr-18,-1389.01,260271687,,TRANSFER DEBIT,688709344583891 BARR PLC ,7611.460000000001,Uncategorised, 
15-Apr-18,-964.06,260271687,,AUTOMATIC DRAWING,648335141384664 VAZQUEZ LTD ,6647.4000000000015,Bills, 
15-Apr-18,-197.49,260271687,,AUTOMATIC DRAWING,227656382237633 LEE-MCCONNELL ,6449.910000000002,Financial, 
16-Apr-18,410.87,260271687,,INTER-BANK CREDIT,579888601327175 WILLIAMS AND SONS ,6860.780000000002,Financial, 
18-Apr-18,432.47,260271687,,TRANSFER DEBIT,Adams Gonzales and Le,7293.250000000002,Other Income, 
20-Apr-18,-898.47,260271687,,AUTOMATIC DRAWING,Black LLC,6394.780000000002,Other Income, 
20-Apr-18,-588.13,260271687,,AUTOMATIC DRAWING,122032686428269 CUNNINGHAM-WIGGINS ,5806.6500000000015,Bills, 
20-Apr-18,-761.15,260271687,,AUTOMATIC DRAWING,935055558818405 BURNS LTD ,5045.500000000002,Uncategorised, 
20-Apr-18,-1123.64,260271687,,TRANSFER DEBIT,715192891965477 HINES GROUP ,3921.8600000000015,Financial, 
21-Apr-18,-112.0,260271687,,TRANSFER DEBIT,244122208591066 ALEXANDER INC ,3809.8600000000015,Uncategorised, 
21-Apr-18,-985.83,260271687,,INTER-BANK CREDIT,Frazier-Alexander,2824.0300000000016,Other Income, 
21-Apr-18,-719.84,260271687,,AUTOMATIC DRAWING,61680505999037 NOLAN-BOND ,2104.1900000000014,Uncategorised, 
21-Apr-18,822.68,260271687,,AUTOMATIC DRAWING,954473130081253 NEWMAN-COOLEY ,2926.8700000000013,Other Income, 
23-Apr-18,1068.47,260271687,,INTER-BANK CREDIT,628219919627964 COLLINS AND SONS ,3995.340000000001,Financial, 
24-Apr-18,1410.09,260271687,,AUTOMATIC DRAWING,Moss and Sons,5405.430000000001,Bills, 
27-Apr-18,-143.9,260271687,,TRANSFER DEBIT,Dixon Davidson and Maldonado,5261.530000000002,Other Income, 
27-Apr-18,-129.86,260271687,,INTER-BANK CREDIT,George Williams and Valentine,5131.670000000002,Bills, 
28-Apr-18,701.78,260271687,,INTER-BANK CREDIT,379083950646903 COLLINS AND SONS ,5833.450000000002,Bills, 
28-Apr-18,1275.23,260271687,,INTER-BANK CREDIT,Parker Inc,7108.680000000002,Uncategorised, 
30-Apr-18,644.67,260271687,,AUTOMATIC DRAWING,196452672054304 HERNANDEZ AND SONS ,7753.350000000002,Other Income, 
02-May-18,-1741.17,260271687,,INTER-BANK CREDIT,Carter-Russell,6012.180000000002,Financial, 
03-May-18,1954.39,260271687,,AUTOMATIC DRAWING,Mayer Ltd,7966.570000000002,Other Income, 
03-May-18,-1759.17,260271687,,AUTOMATIC DRAWING,677805785281102 ROTH-WILLIAMS ,6207.400000000002,Uncategorised, 
03-May-18,-1787.39,260271687,,TRANSFER DEBIT,Owen PLC,4420.010000000002,Bills, 
05-May-18,874.79,260271687,,INTER-BANK CREDIT,Willis Inc,5294.800000000002,Other Income, 
08-May-18,-398.74,260271687,,INTER-BANK CREDIT,Murphy Williams and Chambers,4896.060000000002,Other Income, 
08-May-18,426.55,260271687,,TRANSFER DEBIT,751445213789399 RAMSEY LLC ,5322.610000000002,Uncategorised, 
11-May-18,-709.77,260271687,,TRANSFER DEBIT,Gordon-Lopez,4612.840000000002,Other Income, 
11-May-18,-1473.67,260271687,,INTER-BANK CREDIT,125596888008186 EATON-BROWN ,3139.170000000002,Bills, 
13-May-18,1677.93,260271687,,TRANSFER DEBIT,826494578765963 DOUGLAS-TAYLOR ,4817.100000000002,Other Income, 
16-May-18,-450.62,260271687,,INTER-BANK CREDIT,847277617045696 OSBORNE-ANDERSON ,4366.480000000002,Financial, 
18-May-18,26.84,260271687,,AUTOMATIC DRAWING,Allen PLC,4393.320000000002,Financial, 
20-May-18,152.18,260271687,,AUTOMATIC DRAWING,Allen Lopez and Bush,4545.500000000003,Financial, 
23-May-18,-705.05,260271687,,INTER-BANK CREDIT,152840208860364 WOLF-GREENE ,3840.4500000000025,Financial, 
25-May-18,-351.01,260271687,,INTER-BANK CREDIT,349202907868573 COLE AND SONS ,3489.4400000000023,Other Income, 
28-May-18,-614.24,260271687,,INTER-BANK CREDIT,605186562647467 SULLIVAN JENKINS AND FULLER ,2875.2000000000025,Other Income, 
31-May-18,-1152.08,260271687,,TRANSFER DEBIT,930796483880325 LOPEZ-WEBB ,1723.1200000000026,Bills, 
02-Jun-18,1833.0,260271687,,INTER-BANK CREDIT,Stone-Dunlap,3556.1200000000026,Other Income, 
02-Jun-18,647.01,260271687,,AUTOMATIC DRAWING,Holder-Sims,4203.130000000003,Financial, 
05-Jun-18,762.7,260271687,,INTER-BANK CREDIT,620861279800960 DAY REED AND REYES ,4965.830000000003,Bills, 
07-Jun-18,-94.64,260271687,,TRANSFER DEBIT,Allen PLC,4871.190000000002,Uncategorised, 
07-Jun-18,-33.88,260271687,,TRANSFER DEBIT,Shea LLC,4837.310000000002,Other Income, 
07-Jun-18,-1201.51,260271687,,AUTOMATIC DRAWING,Ali Group,3635.800000000002,Uncategorised, 
10-Jun-18,-525.1,260271687,,INTER-BANK CREDIT,Roth Jones and Payne,3110.700000000002,Bills, 
11-Jun-18,369.42,260271687,,INTER-BANK CREDIT,Smith and Sons,3480.120000000002,Financial, 
12-Jun-18,-612.59,260271687,,TRANSFER DEBIT,Burke-Hughes,2867.530000000002,Other Income, 
14-Jun-18,1946.15,260271687,,INTER-BANK CREDIT,Mccormick-Michael,4813.680000000002,Other Income, 
14-Jun-18,1970.14,260271687,,AUTOMATIC DRAWING,Jones-Finley,6783.820000000002,Uncategorised, 
15-Jun-18,1481.62,260271687,,INTER-BANK CREDIT,Wright-Greene,8265.440000000002,Uncategorised, 
16-Jun-18,1238.05,260271687,,TRANSFER DEBIT,969684385502905 REYES-RODRIGUEZ ,9503.490000000002,Uncategorised, 
19-Jun-18,1417.23,260271687,,INTER-BANK CREDIT,Robinson Chavez and Kramer,10920.720000000001,Uncategorised, 
19-Jun-18,564.1,260271687,,TRANSFER DEBIT,11422857032599 REYNOLDS PLC ,11484.820000000002,Other Income, 
20-Jun-18,-993.01,260271687,,INTER-BANK CREDIT,Peterson Ltd,10491.810000000001,Uncategorised, 
22-Jun-18,-1867.31,260271687,,TRANSFER DEBIT,952265920698490 JOHNSON-PHAM ,8624.500000000002,Financial, 
22-Jun-18,-1602.73,260271687,,INTER-BANK CREDIT,287465141086042 FRYE-WHITE ,7021.770000000002,Uncategorised, 
24-Jun-18,-1575.03,260271687,,INTER-BANK CREDIT,665438887783282 BARTLETT-GILBERT ,5446.7400000000025,Bills, 
25-Jun-18,-48.05,260271687,,INTER-BANK CREDIT,212427415527706 WILLIAMS WILLIAMS AND MEDINA ,5398.690000000002,Uncategorised, 
27-Jun-18,-633.11,260271687,,INTER-BANK CREDIT,555271773131688 BAILEY RAMIREZ AND PIERCE ,4765.580000000003,Other Income, 
28-Jun-18,506.12,260271687,,INTER-BANK CREDIT,Miranda Moody and Rodriguez,5271.700000000003,Other Income, 
29-Jun-18,-1911.37,260271687,,INTER-BANK CREDIT,794090197109210 HOFFMAN-JOHNSON ,3360.3300000000027,Bills, 
29-Jun-18,245.27,260271687,,AUTOMATIC DRAWING,Sanders-Cardenas,3605.6000000000026,Bills, 
02-Jul-18,-1134.78,260271687,,INTER-BANK CREDIT,588358927199023 GARCIA MCKAY AND BROWN ,2470.8200000000024,Bills, 
02-Jul-18,1147.43,260271687,,INTER-BANK CREDIT,Stein Vargas and Brown,3618.2500000000027,Financial, 
04-Jul-18,433.13,260271687,,INTER-BANK CREDIT,Rice Osborne and Stuart,4051.380000000003,Financial, 
05-Jul-18,-1596.08,260271687,,TRANSFER DEBIT,788543300546598 GUTIERREZ GRAY AND BURNS ,2455.300000000003,Uncategorised, 
07-Jul-18,859.05,260271687,,INTER-BANK CREDIT,445131803327931 HUNTER PLC ,3314.350000000003,Financial, 
10-Jul-18,43.0,260271687,,AUTOMATIC DRAWING,Walsh-Erickson,3357.350000000003,Bills, 
11-Jul-18,-241.66,260271687,,AUTOMATIC DRAWING,Davis Hughes and Lee,3115.6900000000032,Bills, 
13-Jul-18,-402.79,260271687,,TRANSFER DEBIT,White LLC,2712.9000000000033,Other Income, 
16-Jul-18,595.13,260271687,,AUTOMATIC DRAWING,King-Simmons,3308.0300000000034,Other Income, 
18-Jul-18,1682.64,260271687,,INTER-BANK CREDIT,Bradley Ltd,4990.670000000004,Financial, 
21-Jul-18,-975.91,260271687,,AUTOMATIC DRAWING,995934603141862 FUENTES-BOND ,4014.760000000004,Other Income, 
24-Jul-18,1709.41,260271687,,INTER-BANK CREDIT,37842718060096 HIGGINS JOHNSON AND ARROYO ,5724.170000000004,Other Income, 
27-Jul-18,-1745.66,260271687,,INTER-BANK CREDIT,Benson Gardner and Smith,3978.510000000004,Bills, 
30-Jul-18,719.79,260271687,,INTER-BANK CREDIT,Alexander and Sons,4698.300000000004,Other Income, 
30-Jul-18,773.23,260271687,,INTER-BANK CREDIT,Sanchez-Carey,5471.530000000004,Uncategorised, 
30-Jul-18,880.45,260271687,,TRANSFER DEBIT,Dunn-Underwood,6351.980000000004,Uncategorised, 
30-Jul-18,-1873.44,260271687,,INTER-BANK CREDIT,566473348410486 TURNER LLC ,4478.5400000000045,Uncategorised, 
01-Aug-18,551.98,260271687,,INTER-BANK CREDIT,928639354407495 ROSALES-PAYNE ,5030.520000000004,Uncategorised, 
01-Aug-18,1157.84,260271687,,INTER-BANK CREDIT,Morgan Inc,6188.360000000004,Financial, 
03-Aug-18,721.72,260271687,,TRANSFER DEBIT,Martinez PLC,6910.0800000000045,Financial, 
03-Aug-18,-1752.4,260271687,,INTER-BANK CREDIT,Hernandez Franklin and Hamilton,5157.680000000004,Other Income, 
06-Aug-18,629.0,260271687,,TRANSFER DEBIT,561811212306281 HOLT-ALEXANDER ,5786.680000000004,Uncategorised, 
07-Aug-18,-1594.16,260271687,,TRANSFER DEBIT,772436346913838 HOPKINS TORRES AND SCHWARTZ ,4192.520000000004,Uncategorised, 
09-Aug-18,1179.36,260271687,,INTER-BANK CREDIT,Terry-Kim,5371.880000000004,Other Income, 
12-Aug-18,-351.85,260271687,,AUTOMATIC DRAWING,784125973598357 SANCHEZ PLC ,5020.030000000003,Uncategorised, 
15-Aug-18,297.46,260271687,,INTER-BANK CREDIT,Carter-Bruce,5317.490000000003,Uncategorised, 
18-Aug-18,1911.6,260271687,,AUTOMATIC DRAWING,Garza-Pugh,7229.090000000004,Financial, 
21-Aug-18,-1152.42,260271687,,TRANSFER DEBIT,103936385133637 SULLIVAN-GOMEZ ,6076.670000000004,Other Income, 
23-Aug-18,-1364.09,260271687,,INTER-BANK CREDIT,85987196129361 LEON GROUP ,4712.580000000004,Financial, 
25-Aug-18,-1473.44,260271687,,INTER-BANK CREDIT,790693221723547 SMITH LLC ,3239.1400000000035,Bills, 
25-Aug-18,-987.49,260271687,,TRANSFER DEBIT,Tran Torres and Hall,2251.6500000000033,Uncategorised, 
27-Aug-18,-1936.43,260271687,,TRANSFER DEBIT,738294596640999 NOBLE PLC ,315.2200000000032,Financial, 
27-Aug-18,811.48,260271687,,AUTOMATIC DRAWING,570283357623533 HOLLOWAY PRICE AND WILLIAMSON ,1126.7000000000032,Financial, 
28-Aug-18,1126.99,260271687,,INTER-BANK CREDIT,79991224131986 ADKINS PLC ,2253.6900000000032,Financial, 
29-Aug-18,1662.13,260271687,,AUTOMATIC DRAWING,83925460732326 CASTRO MARTIN AND WALKER ,3915.8200000000033,Bills, 
30-Aug-18,922.05,260271687,,TRANSFER DEBIT,604384843159258 GARNER LLC ,4837.8700000000035,Financial, 
30-Aug-18,-604.94,260271687,,INTER-BANK CREDIT,381273701749538 HIGGINS-GIBSON ,4232.930000000004,Uncategorised, 
30-Aug-18,-905.62,260271687,,TRANSFER DEBIT,Thomas-Wright,3327.310000000004,Other Income, 
30-Aug-18,1557.83,260271687,,AUTOMATIC DRAWING,361561063417444 ANDRADE SANCHEZ AND SHEPARD ,4885.140000000004,Bills, 
30-Aug-18,1104.67,260271687,,AUTOMATIC DRAWING,53992581340582 CARDENAS ATKINS AND RODRIGUEZ ,5989.810000000004,Other Income, 
01-Sep-18,1794.72,260271687,,AUTOMATIC DRAWING,708925626772166 HO-MASON ,7784.530000000004,Bills, 
04-Sep-18,1650.71,260271687,,INTER-BANK CREDIT,Ross Porter and Brown,9435.240000000005,Bills, 
05-Sep-18,1713.31,260271687,,INTER-BANK CREDIT,Hutchinson Santiago and Ross,11148.550000000005,Other Income, 
06-Sep-18,1307.64,260271687,,AUTOMATIC DRAWING,Flores-Thomas,12456.190000000004,Financial, 
06-Sep-18,-1583.69,260271687,,INTER-BANK CREDIT,Buchanan Wright and Gaines,10872.500000000004,Bills, 
08-Sep-18,1304.13,260271687,,AUTOMATIC DRAWING,217133227790870 JOHNSON AND SONS ,12176.630000000005,Other Income, 
11-Sep-18,-1882.04,260271687,,AUTOMATIC DRAWING,Torres and Sons,10294.590000000004,Other Income, 
13-Sep-18,467.47,260271687,,INTER-BANK CREDIT,Hubbard-Marks,10762.060000000003,Uncategorised, 
15-Sep-18,-1492.64,260271687,,INTER-BANK CREDIT,118658341380567 JONES LTD ,9269.420000000004,Uncategorised, 
17-Sep-18,-538.75,260271687,,TRANSFER DEBIT,24815793688219 PATEL LLC ,8730.670000000004,Other Income, 
17-Sep-18,1209.7,260271687,,INTER-BANK CREDIT,Daniels-Lozano,9940.370000000004,Bills, 
19-Sep-18,1408.86,260271687,,INTER-BANK CREDIT,Sexton and Sons,11349.230000000005,Financial, 
22-Sep-18,-1280.1,260271687,,INTER-BANK CREDIT,795705835412947 ANDERSON MCFARLAND AND MARTINEZ ,10069.130000000005,Financial, 
22-Sep-18,-1929.48,260271687,,INTER-BANK CREDIT,967391109913928 TYLER FLEMING AND HERNANDEZ ,8139.650000000005,Other Income, 
23-Sep-18,611.16,260271687,,AUTOMATIC DRAWING,759933212791453 CLARK-BOWEN ,8750.810000000005,Bills, 
26-Sep-18,-1487.53,260271687,,INTER-BANK CREDIT,Johnson-Duncan,7263.280000000005,Financial, 
26-Sep-18,1473.27,260271687,,INTER-BANK CREDIT,Sanchez Powell and Dennis,8736.550000000005,Bills, 
27-Sep-18,-1491.95,260271687,,INTER-BANK CREDIT,601245593646063 CAMPBELL MURRAY AND BOLTON ,7244.600000000005,Other Income, 
29-Sep-18,1066.81,260271687,,AUTOMATIC DRAWING,389476552904315 CHOI LLC ,8311.410000000005,Bills, 
29-Sep-18,-1463.25,260271687,,AUTOMATIC DRAWING,Johnson Schaefer and Lawson,6848.160000000005,Financial, 
01-Oct-18,-767.72,260271687,,INTER-BANK CREDIT,626514179134804 ROSE PLC ,6080.440000000005,Uncategorised, 
02-Oct-18,604.89,260271687,,AUTOMATIC DRAWING,597456574752074 HERNANDEZ LLC ,6685.330000000005,Other Income, 
03-Oct-18,-1266.34,260271687,,TRANSFER DEBIT,Vasquez Orozco and Ward,5418.990000000005,Bills, 
04-Oct-18,-1787.41,260271687,,INTER-BANK CREDIT,Howard-Brown,3631.5800000000054,Uncategorised, 
05-Oct-18,-1888.61,260271687,,TRANSFER DEBIT,Sutton Fletcher and Wright,1742.9700000000055,Uncategorised, 
07-Oct-18,-616.45,260271687,,AUTOMATIC DRAWING,600772150428472 RUSSELL BARNES AND KRAUSE ,1126.5200000000054,Bills, 
09-Oct-18,-1632.87,260271687,,TRANSFER DEBIT,313445344827133 ROBINSON PLC ,-506.34999999999445,Other Income, 
09-Oct-18,835.29,260271687,,INTER-BANK CREDIT,663514159950187 GRIMES JOHNSON AND AGUIRRE ,328.9400000000055,Other Income, 
09-Oct-18,340.51,260271687,,INTER-BANK CREDIT,731607985495906 GRAY-BUCHANAN ,669.4500000000055,Bills, 
11-Oct-18,1183.71,260271687,,INTER-BANK CREDIT,920611003262568 WRIGHT-STANLEY ,1853.1600000000055,Uncategorised, 
14-Oct-18,-143.57,260271687,,AUTOMATIC DRAWING,180037188230443 NASH-MYERS ,1709.5900000000056,Uncategorised, 
15-Oct-18,1324.53,260271687,,TRANSFER DEBIT,Johnson James and Mclean,3034.1200000000053,Other Income, 
17-Oct-18,-259.83,260271687,,INTER-BANK CREDIT,985136767919445 SANTOS LTD ,2774.2900000000054,Bills, 
17-Oct-18,523.29,260271687,,AUTOMATIC DRAWING,Abbott Ltd,3297.5800000000054,Bills, 
19-Oct-18,382.68,260271687,,INTER-BANK CREDIT,Levine Group,3680.260000000005,Uncategorised, 
19-Oct-18,-474.74,260271687,,AUTOMATIC DRAWING,486874112679214 SERRANO MAYO AND OLSON ,3205.520000000005,Other Income, 
21-Oct-18,1540.99,260271687,,INTER-BANK CREDIT,998401124565855 JOSEPH FLORES AND PHILLIPS ,4746.510000000005,Other Income, 
21-Oct-18,-1696.71,260271687,,INTER-BANK CREDIT,77912293650701 SMITH INC ,3049.8000000000047,Financial, 
24-Oct-18,-325.45,260271687,,INTER-BANK CREDIT,948601728963819 ARNOLD-SMITH ,2724.350000000005,Bills, 
26-Oct-18,1291.27,260271687,,INTER-BANK CREDIT,32233764975494 GAY LTD ,4015.620000000005,Other Income, 
29-Oct-18,-886.36,260271687,,INTER-BANK CREDIT,Roth Miller and Phillips,3129.2600000000048,Bills, 
31-Oct-18,565.01,260271687,,AUTOMATIC DRAWING,Green-Johnson,3694.270000000005,Financial, 
31-Oct-18,-972.16,260271687,,AUTOMATIC DRAWING,263253493408667 WALTERS JOHNSON AND JENNINGS ,2722.110000000005,Bills, 
01-Nov-18,-1447.44,260271687,,AUTOMATIC DRAWING,501415541451627 CAMPBELL INC ,1274.670000000005,Other Income, 
03-Nov-18,-894.74,260271687,,INTER-BANK CREDIT,Kelly-Caldwell,379.93000000000507,Financial, 
05-Nov-18,-1326.56,260271687,,AUTOMATIC DRAWING,Scott PLC,-946.6299999999949,Uncategorised, 
07-Nov-18,-852.17,260271687,,INTER-BANK CREDIT,Ortiz Montes and Singleton,-1798.7999999999947,Uncategorised, 
09-Nov-18,811.39,260271687,,AUTOMATIC DRAWING,Rodriguez Chavez and Torres,-987.4099999999947,Financial, 
09-Nov-18,-708.77,260271687,,INTER-BANK CREDIT,Gray and Sons,-1696.1799999999948,Uncategorised, 
09-Nov-18,393.91,260271687,,INTER-BANK CREDIT,649973495970055 POOLE AND SONS ,-1302.2699999999948,Uncategorised, 
11-Nov-18,-1161.81,260271687,,INTER-BANK CREDIT,Miller LLC,-2464.0799999999945,Uncategorised, 
12-Nov-18,-1871.19,260271687,,TRANSFER DEBIT,147266320340910 CAMPBELL CAMPBELL AND MAXWELL ,-4335.269999999995,Bills, 
13-Nov-18,736.6,260271687,,AUTOMATIC DRAWING,802651955514456 HANSON LLC ,-3598.669999999995,Uncategorised, 
15-Nov-18,1233.58,260271687,,INTER-BANK CREDIT,922493037633672 HUERTA-ARMSTRONG ,-2365.089999999995,Financial, 
17-Nov-18,-153.52,260271687,,AUTOMATIC DRAWING,171864637518334 DOUGHERTY GROUP ,-2518.609999999995,Other Income, 
20-Nov-18,-9.16,260271687,,INTER-BANK CREDIT,Sullivan-Colon,-2527.769999999995,Financial, 
20-Nov-18,-1302.74,260271687,,INTER-BANK CREDIT,Thompson LLC,-3830.5099999999948,Other Income, 
23-Nov-18,1179.31,260271687,,TRANSFER DEBIT,406302124284382 RAMIREZ GIBSON AND KIM ,-2651.199999999995,Uncategorised, 
24-Nov-18,901.1,260271687,,TRANSFER DEBIT,960900247759067 BRYANT AND SONS ,-1750.099999999995,Financial, 
25-Nov-18,-1454.18,260271687,,INTER-BANK CREDIT,Henry-Klein,-3204.279999999995,Financial, 
28-Nov-18,80.7,260271687,,TRANSFER DEBIT,485206081831054 YOUNG NORRIS AND WILSON ,-3123.5799999999954,Uncategorised, 
28-Nov-18,-1123.49,260271687,,INTER-BANK CREDIT,Robinson-Holmes,-4247.069999999995,Other Income, 
01-Dec-18,-431.68,260271687,,AUTOMATIC DRAWING,394989571616424 DURAN-ATKINSON ,-4678.749999999995,Other Income, 
04-Dec-18,1711.43,260271687,,INTER-BANK CREDIT,110403230071079 NICHOLSON-COLEMAN ,-2967.319999999995,Other Income, 
07-Dec-18,118.26,260271687,,INTER-BANK CREDIT,130738602233447 WILLIAMS LLC ,-2849.059999999995,Bills, 
10-Dec-18,-904.35,260271687,,INTER-BANK CREDIT,431982602610348 JOHNSON HARRIS AND RIOS ,-3753.409999999995,Uncategorised, 
10-Dec-18,-633.16,260271687,,INTER-BANK CREDIT,Wade Owen and Washington,-4386.569999999995,Bills, 
12-Dec-18,-634.23,260271687,,INTER-BANK CREDIT,44103967055921 JOHNS FISHER AND MITCHELL ,-5020.799999999996,Uncategorised, 
13-Dec-18,942.36,260271687,,TRANSFER DEBIT,45004903423692 PEREZ PLC ,-4078.4399999999955,Uncategorised, 
15-Dec-18,-1414.0,260271687,,INTER-BANK CREDIT,Murray-Green,-5492.439999999995,Bills, 
16-Dec-18,-1271.13,260271687,,AUTOMATIC DRAWING,Herrera-Woods,-6763.569999999995,Bills, 
19-Dec-18,-149.8,260271687,,TRANSFER DEBIT,485093695779529 NORTON MILLS AND THOMPSON ,-6913.369999999995,Uncategorised, 
22-Dec-18,762.73,260271687,,INTER-BANK CREDIT,605733576862363 KELLY PERKINS AND SHAW ,-6150.639999999996,Other Income, 
22-Dec-18,-341.1,260271687,,INTER-BANK CREDIT,639977138200763 EVANS WALTON AND GRAY ,-6491.739999999996,Uncategorised, 
25-Dec-18,-497.59,260271687,,AUTOMATIC DRAWING,282824422428237 LEWIS-COX ,-6989.329999999996,Financial, 
28-Dec-18,513.56,260271687,,TRANSFER DEBIT,Davis Mccullough and Young,-6475.769999999997,Bills, 
28-Dec-18,-1117.73,260271687,,TRANSFER DEBIT,Wallace Cruz and Franklin,-7593.499999999996,Other Income, 
30-Dec-18,-98.0,260271687,,INTER-BANK CREDIT,362755638116150 SHAW-GLENN ,-7691.499999999996,Uncategorised, 
30-Dec-18,-271.52,260271687,,AUTOMATIC DRAWING,393691354870731 GARZA LLC ,-7963.019999999997,Other Income, 
31-Dec-18,-168.03,260271687,,INTER-BANK CREDIT,23156966355602 MONTOYA-JACKSON ,-8131.0499999999965,Bills, 
02-Jan-19,-1389.34,260271687,,AUTOMATIC DRAWING,850241740456049 FISHER-WARD ,-9520.389999999996,Uncategorised, 
02-Jan-19,-1029.33,260271687,,INTER-BANK CREDIT,Martin PLC,-10549.719999999996,Financial, 
02-Jan-19,1869.1,260271687,,AUTOMATIC DRAWING,White Ltd,-8680.619999999995,Financial, 
02-Jan-19,-1516.53,260271687,,INTER-BANK CREDIT,Ramirez Nelson and Lowery,-10197.149999999996,Uncategorised, 
04-Jan-19,335.13,260271687,,TRANSFER DEBIT,Vargas Inc,-9862.019999999997,Bills, 
05-Jan-19,-1833.5,260271687,,INTER-BANK CREDIT,Burnett Group,-11695.519999999997,Other Income, 
08-Jan-19,1342.25,260271687,,INTER-BANK CREDIT,Diaz-Howard,-10353.269999999997,Bills, 
11-Jan-19,-1669.71,260271687,,AUTOMATIC DRAWING,387574000864779 WALKER LTD ,-12022.979999999996,Bills, 
11-Jan-19,-1070.15,260271687,,AUTOMATIC DRAWING,909127184040450 DONOVAN AND SONS ,-13093.129999999996,Bills, 
12-Jan-19,-299.93,260271687,,TRANSFER DEBIT,Watkins Inc,-13393.059999999996,Bills, 
12-Jan-19,99.99,260271687,,INTER-BANK CREDIT,884331668886844 PERRY-MONROE ,-13293.069999999996,Bills, 
15-Jan-19,-1130.66,260271687,,INTER-BANK CREDIT,659654862720593 BOOTH-DEAN ,-14423.729999999996,Uncategorised, 
15-Jan-19,-1806.97,260271687,,TRANSFER DEBIT,380708078359955 NOBLE PLC ,-16230.699999999995,Financial, 
17-Jan-19,361.85,260271687,,INTER-BANK CREDIT,728925387706191 PRICE-BROWN ,-15868.849999999995,Other Income, 
19-Jan-19,239.84,260271687,,INTER-BANK CREDIT,460261820628922 TODD INC ,-15629.009999999995,Uncategorised, 
22-Jan-19,-1934.07,260271687,,TRANSFER DEBIT,Miller Jennings and Hernandez,-17563.079999999994,Uncategorised, 
23-Jan-19,1672.71,260271687,,TRANSFER DEBIT,581874852212264 THOMPSON-LIN ,-15890.369999999995,Other Income, 
25-Jan-19,-391.97,260271687,,AUTOMATIC DRAWING,935875259219441 WATKINS-BROWN ,-16282.339999999995,Uncategorised, 
28-Jan-19,-682.38,260271687,,INTER-BANK CREDIT,Lopez LLC,-16964.719999999994,Other Income, 
31-Jan-19,-693.47,260271687,,INTER-BANK CREDIT,Chan-Brooks,-17658.189999999995,Bills, 
01-Feb-19,-294.18,260271687,,INTER-BANK CREDIT,981106277191503 PATTERSON GROUP ,-17952.369999999995,Other Income, 
03-Feb-19,1172.16,260271687,,INTER-BANK CREDIT,205419731766735 WILSON INC ,-16780.209999999995,Bills, 
06-Feb-19,697.13,260271687,,TRANSFER DEBIT,Allen-Hall,-16083.079999999996,Other Income, 
08-Feb-19,1646.43,260271687,,INTER-BANK CREDIT,Skinner Inc,-14436.649999999996,Other Income, 
11-Feb-19,-331.49,260271687,,TRANSFER DEBIT,920949257611450 THOMPSON-JOHNSON ,-14768.139999999996,Other Income, 
11-Feb-19,1409.39,260271687,,INTER-BANK CREDIT,291305805669351 WRIGHT COCHRAN AND TAYLOR ,-13358.749999999996,Other Income, 
14-Feb-19,745.64,260271687,,TRANSFER DEBIT,333633035285162 LEON-MARTIN ,-12613.109999999997,Bills, 
15-Feb-19,1928.68,260271687,,AUTOMATIC DRAWING,Pena Nguyen and Yang,-10684.429999999997,Uncategorised, 
16-Feb-19,1753.61,260271687,,INTER-BANK CREDIT,466154617138797 RIVERA LIVINGSTON AND CLARK ,-8930.819999999996,Other Income, 
19-Feb-19,1059.24,260271687,,TRANSFER DEBIT,Bishop Group,-7871.579999999996,Bills, 
20-Feb-19,1470.64,260271687,,AUTOMATIC DRAWING,866147772322558 BRANDT HENDERSON AND SILVA ,-6400.939999999996,Bills, 
21-Feb-19,1525.81,260271687,,TRANSFER DEBIT,Baxter PLC,-4875.129999999996,Uncategorised, 
22-Feb-19,1137.09,260271687,,AUTOMATIC DRAWING,52736059666985 SHERMAN-JORDAN ,-3738.0399999999954,Financial, 
23-Feb-19,-1483.3,260271687,,TRANSFER DEBIT,Howard-Bender,-5221.339999999996,Financial, 
25-Feb-19,-225.25,260271687,,INTER-BANK CREDIT,827573226206496 SIMMONS ANDERSON AND ALLEN ,-5446.589999999996,Bills, 
26-Feb-19,541.79,260271687,,AUTOMATIC DRAWING,759821532925983 DAVIS-FISHER ,-4904.799999999996,Financial, 
27-Feb-19,198.4,260271687,,AUTOMATIC DRAWING,369640856606782 BRAY-GONZALEZ ,-4706.399999999996,Bills, 
27-Feb-19,1280.26,260271687,,TRANSFER DEBIT,Flores-Miller,-3426.139999999996,Bills, 
28-Feb-19,211.78,260271687,,INTER-BANK CREDIT,11411733920022 BROWN STEVENS AND TAYLOR ,-3214.3599999999956,Financial, 
01-Mar-19,-1553.9,260271687,,INTER-BANK CREDIT,449691676639660 NELSON-LINDSEY ,-4768.259999999996,Other Income, 
02-Mar-19,1926.97,260271687,,AUTOMATIC DRAWING,Scott LLC,-2841.2899999999954,Bills, 
03-Mar-19,1331.23,260271687,,TRANSFER DEBIT,827278094955620 SMITH-MCCOY ,-1510.0599999999954,Uncategorised, 
06-Mar-19,-1195.6,260271687,,INTER-BANK CREDIT,111542796485591 PHILLIPS-ZAVALA ,-2705.6599999999953,Financial, 
08-Mar-19,-254.2,260271687,,INTER-BANK CREDIT,Hansen LLC,-2959.859999999995,Uncategorised, 
11-Mar-19,-323.38,260271687,,AUTOMATIC DRAWING,677692519489341 JOHNSON LLC ,-3283.2399999999952,Financial, 
11-Mar-19,-1540.49,260271687,,INTER-BANK CREDIT,Whitaker LLC,-4823.729999999995,Other Income, 
12-Mar-19,-1072.1,260271687,,INTER-BANK CREDIT,1907259401292 MELENDEZ-BROWN ,-5895.8299999999945,Other Income, 
15-Mar-19,-1417.59,260271687,,AUTOMATIC DRAWING,791374841483791 MANNING AND SONS ,-7313.419999999995,Financial, 
17-Mar-19,-1258.68,260271687,,INTER-BANK CREDIT,587056901784850 CALDERON PLC ,-8572.099999999995,Financial, 
20-Mar-19,-806.7,260271687,,INTER-BANK CREDIT,Nielsen LLC,-9378.799999999996,Uncategorised, 
21-Mar-19,-1072.31,260271687,,AUTOMATIC DRAWING,Padilla PLC,-10451.109999999995,Other Income, 
24-Mar-19,445.21,260271687,,AUTOMATIC DRAWING,764354331664691 PRUITT AND SONS ,-10005.899999999996,Uncategorised, 
26-Mar-19,1709.6,260271687,,AUTOMATIC DRAWING,757698085999533 CHAVEZ WILLIS AND NEAL ,-8296.299999999996,Financial, 
27-Mar-19,-93.6,260271687,,INTER-BANK CREDIT,979974247794838 WILLIAMS GROUP ,-8389.899999999996,Uncategorised, 
30-Mar-19,1452.84,260271687,,INTER-BANK CREDIT,Reese PLC,-6937.059999999996,Bills, 
01-Apr-19,885.66,260271687,,AUTOMATIC DRAWING,605624766650061 NELSON GIBSON AND BREWER ,-6051.399999999996,Other Income, 
04-Apr-19,1942.45,260271687,,INTER-BANK CREDIT,Garza Dominguez and Griffin,-4108.949999999996,Bills, 
04-Apr-19,-1452.53,260271687,,TRANSFER DEBIT,Adams Dunn and Woods,-5561.479999999996,Other Income, 
05-Apr-19,1816.29,260271687,,AUTOMATIC DRAWING,164990943512340 DAVIS LTD ,-3745.189999999996,Bills, 
08-Apr-19,-1387.33,260271687,,AUTOMATIC DRAWING,543385995312858 DIXON LAWSON AND BLACKBURN ,-5132.519999999996,Financial, 
08-Apr-19,-512.13,260271687,,AUTOMATIC DRAWING,White-Boyd,-5644.649999999996,Financial, 
09-Apr-19,-60.46,260271687,,AUTOMATIC DRAWING,156992249253533 LEWIS-VANG ,-5705.109999999996,Financial, 
10-Apr-19,883.54,260271687,,TRANSFER DEBIT,816368952083965 WOOD AND SONS ,-4821.569999999996,Financial, 
11-Apr-19,28.05,260271687,,TRANSFER DEBIT,Price-Adams,-4793.519999999996,Bills, 
14-Apr-19,-1144.77,260271687,,INTER-BANK CREDIT,Callahan-Skinner,-5938.289999999995,Bills, 
16-Apr-19,-1721.36,260271687,,AUTOMATIC DRAWING,360380224532753 CHASE PENA AND WU ,-7659.649999999995,Other Income, 
17-Apr-19,-204.45,260271687,,TRANSFER DEBIT,574295111210335 ALVAREZ AND SONS ,-7864.099999999995,Financial, 
17-Apr-19,228.14,260271687,,INTER-BANK CREDIT,525949231949413 MARSH JOHNSON AND MICHAEL ,-7635.959999999995,Other Income, 
20-Apr-19,-1273.15,260271687,,AUTOMATIC DRAWING,Browning-Garcia,-8909.109999999995,Uncategorised, 
23-Apr-19,1381.16,260271687,,AUTOMATIC DRAWING,624453862103002 WATSON-SNYDER ,-7527.949999999995,Financial, 
26-Apr-19,298.01,260271687,,INTER-BANK CREDIT,961450730282959 LYNCH PLC ,-7229.939999999995,Uncategorised, 
29-Apr-19,-194.18,260271687,,TRANSFER DEBIT,Carr Daniels and Cook,-7424.119999999995,Financial, 
02-May-19,-1322.48,260271687,,INTER-BANK CREDIT,Collins Brandt and Randall,-8746.599999999995,Uncategorised, 
03-May-19,860.34,260271687,,INTER-BANK CREDIT,415853679268359 SCHULTZ LTD ,-7886.259999999995,Uncategorised, 
03-May-19,-420.32,260271687,,INTER-BANK CREDIT,Walsh Ltd,-8306.579999999994,Bills, 
05-May-19,-1077.57,260271687,,INTER-BANK CREDIT,Pennington-Frye,-9384.149999999994,Uncategorised, 
08-May-19,1699.87,260271687,,INTER-BANK CREDIT,Prince Smith and Thomas,-7684.279999999994,Uncategorised, 
10-May-19,-1924.21,260271687,,TRANSFER DEBIT,291003143245828 MARTIN-ARMSTRONG ,-9608.489999999994,Uncategorised, 
11-May-19,674.07,260271687,,TRANSFER DEBIT,801484345293701 MOSLEY-BYRD ,-8934.419999999995,Other Income, 
14-May-19,1333.81,260271687,,INTER-BANK CREDIT,Solis-Hill,-7600.609999999995,Uncategorised, 
16-May-19,-149.04,260271687,,INTER-BANK CREDIT,Holmes Lambert and Lee,-7749.649999999995,Other Income, 
19-May-19,-1808.77,260271687,,INTER-BANK CREDIT,878308638762970 SIMS BARNES AND JORDAN ,-9558.419999999995,Financial, 
19-May-19,1623.34,260271687,,INTER-BANK CREDIT,820341250014952 MAYNARD-ESTRADA ,-7935.0799999999945,Uncategorised, 
20-May-19,1919.02,260271687,,TRANSFER DEBIT,Griffith-Morrow,-6016.059999999994,Bills, 
22-May-19,998.36,260271687,,INTER-BANK CREDIT,Smith-Howard,-5017.699999999994,Uncategorised, 
24-May-19,-352.07,260271687,,AUTOMATIC DRAWING,265099138748141 MARTIN AVERY AND BARNES ,-5369.769999999994,Other Income, 
27-May-19,-1972.84,260271687,,TRANSFER DEBIT,977323634037486 THOMPSON-CASTANEDA ,-7342.609999999994,Financial, 
29-May-19,-120.81,260271687,,INTER-BANK CREDIT,Johnson Eaton and Santos,-7463.419999999995,Financial, 
01-Jun-19,-502.93,260271687,,TRANSFER DEBIT,755810805022061 SMITH JOHNSON AND CASTRO ,-7966.349999999995,Financial, 
04-Jun-19,681.6,260271687,,INTER-BANK CREDIT,Jensen Powell and Wright,-7284.7499999999945,Bills, 
05-Jun-19,-1199.49,260271687,,INTER-BANK CREDIT,31277451185494 HOPKINS PLC ,-8484.239999999994,Bills, 
05-Jun-19,583.1,260271687,,INTER-BANK CREDIT,Smith-Martin,-7901.139999999994,Uncategorised, 
08-Jun-19,-883.16,260271687,,TRANSFER DEBIT,Pennington Pearson and Brooks,-8784.299999999994,Uncategorised, 
09-Jun-19,591.36,260271687,,INTER-BANK CREDIT,Burgess Miller and Murphy,-8192.939999999993,Uncategorised, 
12-Jun-19,-115.31,260271687,,INTER-BANK CREDIT,Hart Rodriguez and Ward,-8308.249999999993,Bills, 
15-Jun-19,1596.91,260271687,,INTER-BANK CREDIT,Davis Gordon and Hill,-6711.339999999993,Financial, 
15-Jun-19,1802.69,260271687,,INTER-BANK CREDIT,530084439110433 MULLINS ROGERS AND CASTILLO ,-4908.649999999992,Other Income, 
15-Jun-19,1040.44,260271687,,INTER-BANK CREDIT,596822074127751 SANTIAGO BENSON AND GARRETT ,-3868.2099999999923,Other Income, 
17-Jun-19,918.97,260271687,,INTER-BANK CREDIT,Gomez and Sons,-2949.2399999999925,Financial, 
20-Jun-19,1478.11,260271687,,AUTOMATIC DRAWING,145468573358755 SCHWARTZ-OLIVER ,-1471.1299999999926,Financial, 
23-Jun-19,-1020.01,260271687,,AUTOMATIC DRAWING,368516918428409 PEREZ WAGNER AND TATE ,-2491.1399999999926,Uncategorised, 
23-Jun-19,-1897.23,260271687,,INTER-BANK CREDIT,Kelley Hunter and Haley,-4388.369999999993,Uncategorised, 
26-Jun-19,1054.04,260271687,,TRANSFER DEBIT,363967652639899 MUNOZ INC ,-3334.3299999999927,Other Income, 
27-Jun-19,-253.13,260271687,,AUTOMATIC DRAWING,Warren-Harrison,-3587.4599999999928,Other Income, 
30-Jun-19,459.42,260271687,,INTER-BANK CREDIT,885555128784788 BALDWIN-THOMPSON ,-3128.0399999999927,Bills, 
03-Jul-19,1166.43,260271687,,INTER-BANK CREDIT,Ross Mills and James,-1961.6099999999926,Financial, 
04-Jul-19,-475.35,260271687,,TRANSFER DEBIT,Hobbs-Perry,-2436.9599999999928,Bills, 
04-Jul-19,-1243.63,260271687,,TRANSFER DEBIT,Gross Group,-3680.589999999993,Uncategorised, 
07-Jul-19,-144.39,260271687,,AUTOMATIC DRAWING,8724418897277 FERRELL-HAYDEN ,-3824.9799999999927,Bills, 
07-Jul-19,-724.74,260271687,,INTER-BANK CREDIT,97537709155913 AGUILAR FOSTER AND REESE ,-4549.719999999993,Other Income, 
07-Jul-19,-1670.04,260271687,,INTER-BANK CREDIT,Hickman Ltd,-6219.759999999993,Financial, 
09-Jul-19,-903.71,260271687,,AUTOMATIC DRAWING,Johnston Martinez and White,-7123.469999999993,Uncategorised, 
11-Jul-19,1213.55,260271687,,INTER-BANK CREDIT,Marshall and Sons,-5909.919999999993,Financial, 
13-Jul-19,-1523.9,260271687,,AUTOMATIC DRAWING,440635499781096 WALKER LANE AND LONG ,-7433.819999999992,Other Income, 
14-Jul-19,-271.4,260271687,,TRANSFER DEBIT,Wolf-Rollins,-7705.219999999992,Bills, 
15-Jul-19,-1873.89,260271687,,TRANSFER DEBIT,Kirk Ltd,-9579.109999999991,Bills, 
18-Jul-19,1408.76,260271687,,INTER-BANK CREDIT,163677313872748 ORR-GORDON ,-8170.349999999991,Other Income, 
19-Jul-19,-765.51,260271687,,INTER-BANK CREDIT,909702590367254 REYES-MCCARTHY ,-8935.859999999991,Financial, 
20-Jul-19,-319.39,260271687,,AUTOMATIC DRAWING,365229353474495 CASTANEDA LEON AND JOHNSON ,-9255.24999999999,Financial, 
22-Jul-19,-1192.99,260271687,,TRANSFER DEBIT,Escobar Group,-10448.23999999999,Uncategorised, 
25-Jul-19,-298.33,260271687,,INTER-BANK CREDIT,835277689051525 ERICKSON AND SONS ,-10746.56999999999,Financial, 
28-Jul-19,27.22,260271687,,AUTOMATIC DRAWING,Hendricks-Hall,-10719.349999999991,Financial, 
30-Jul-19,1738.44,260271687,,INTER-BANK CREDIT,123178517428799 YOUNG WOODS AND HUNTER ,-8980.90999999999,Financial, 
01-Aug-19,-1375.35,260271687,,INTER-BANK CREDIT,Smith-Adams,-10356.259999999991,Financial, 
02-Aug-19,-44.08,260271687,,INTER-BANK CREDIT,739261819427200 JACOBS-CARSON ,-10400.339999999991,Other Income, 
05-Aug-19,-193.6,260271687,,AUTOMATIC DRAWING,Austin Huffman and Watson,-10593.939999999991,Uncategorised, 
05-Aug-19,-1023.24,260271687,,TRANSFER DEBIT,Montgomery Inc,-11617.179999999991,Other Income, 
05-Aug-19,1799.91,260271687,,INTER-BANK CREDIT,Harris LLC,-9817.269999999991,Bills, 
07-Aug-19,-1525.26,260271687,,AUTOMATIC DRAWING,433964368461697 MARTINEZ SERRANO AND SIMON ,-11342.529999999992,Financial, 
08-Aug-19,-1132.19,260271687,,TRANSFER DEBIT,984200441538171 MILLER INC ,-12474.719999999992,Bills, 
08-Aug-19,-606.97,260271687,,TRANSFER DEBIT,Young LLC,-13081.689999999991,Bills, 
11-Aug-19,-1883.29,260271687,,INTER-BANK CREDIT,Montoya PLC,-14964.979999999992,Financial, 
14-Aug-19,831.65,260271687,,INTER-BANK CREDIT,Perez Dominguez and Edwards,-14133.329999999993,Financial, 
14-Aug-19,49.33,260271687,,INTER-BANK CREDIT,283052149487428 BARRETT HERMAN AND JOHNSTON ,-14083.999999999993,Bills, 
14-Aug-19,-1726.2,260271687,,INTER-BANK CREDIT,Avila PLC,-15810.199999999993,Uncategorised, 
16-Aug-19,-639.32,260271687,,INTER-BANK CREDIT,877110856458206 RIVERA LTD ,-16449.519999999993,Other Income, 
18-Aug-19,-408.34,260271687,,AUTOMATIC DRAWING,132931202745803 MCCOY WILSON AND MULLEN ,-16857.859999999993,Bills, 
19-Aug-19,716.31,260271687,,INTER-BANK CREDIT,Williams Inc,-16141.549999999994,Other Income, 
21-Aug-19,709.49,260271687,,AUTOMATIC DRAWING,125311618273267 BUCKLEY MCGUIRE AND OROZCO ,-15432.059999999994,Uncategorised, 
21-Aug-19,-1300.66,260271687,,INTER-BANK CREDIT,567466112059555 CLARK PATTERSON AND SHELTON ,-16732.719999999994,Uncategorised, 
21-Aug-19,1532.75,260271687,,INTER-BANK CREDIT,Willis-Byrd,-15199.969999999994,Other Income, 
24-Aug-19,-846.3,260271687,,INTER-BANK CREDIT,Flores-Singh,-16046.269999999993,Other Income, 
24-Aug-19,-1715.97,260271687,,TRANSFER DEBIT,361006250900563 NEWMAN-JONES ,-17762.239999999994,Uncategorised, 
26-Aug-19,284.47,260271687,,INTER-BANK CREDIT,537865712292786 GEORGE-HOFFMAN ,-17477.769999999993,Financial, 
29-Aug-19,1747.34,260271687,,INTER-BANK CREDIT,717432302937980 TURNER-LOPEZ ,-15730.429999999993,Other Income, 
30-Aug-19,-1833.04,260271687,,INTER-BANK CREDIT,61911022515350 FRANCIS LTD ,-17563.469999999994,Other Income, 
01-Sep-19,-1189.65,260271687,,INTER-BANK CREDIT,Holmes Inc,-18753.119999999995,Bills, 
02-Sep-19,1276.79,260271687,,INTER-BANK CREDIT,451293933145467 RILEY INC ,-17476.329999999994,Uncategorised, 
05-Sep-19,-1018.23,260271687,,TRANSFER DEBIT,851740456318936 OCONNELL LLC ,-18494.559999999994,Other Income, 
08-Sep-19,1168.8,260271687,,AUTOMATIC DRAWING,Jackson-Archer,-17325.759999999995,Uncategorised, 
08-Sep-19,-1539.25,260271687,,TRANSFER DEBIT,458259500541784 THOMAS PETERSON AND BLACK ,-18865.009999999995,Financial, 
09-Sep-19,-370.21,260271687,,INTER-BANK CREDIT,412678806431084 CAMPBELL LTD ,-19235.219999999994,Bills, 
11-Sep-19,-177.93,260271687,,TRANSFER DEBIT,Rivas and Sons,-19413.149999999994,Uncategorised, 
12-Sep-19,-804.43,260271687,,INTER-BANK CREDIT,Heath Ltd,-20217.579999999994,Uncategorised, 
13-Sep-19,-1346.92,260271687,,TRANSFER DEBIT,26133533949399 SHAW-REESE ,-21564.499999999993,Financial, 
16-Sep-19,-1635.03,260271687,,AUTOMATIC DRAWING,Jimenez Group,-23199.52999999999,Uncategorised, 
18-Sep-19,-1329.01,260271687,,INTER-BANK CREDIT,588783983217416 JAMES-MARTINEZ ,-24528.53999999999,Financial, 
18-Sep-19,762.83,260271687,,TRANSFER DEBIT,Brooks PLC,-23765.70999999999,Uncategorised, 
20-Sep-19,1807.41,260271687,,AUTOMATIC DRAWING,Finley Webb and Rojas,-21958.29999999999,Other Income, 
22-Sep-19,1085.5,260271687,,INTER-BANK CREDIT,25184363491311 KIM AND SONS ,-20872.79999999999,Financial, 
22-Sep-19,1524.4,260271687,,INTER-BANK CREDIT,Wallace and Sons,-19348.399999999987,Bills, 
22-Sep-19,-1180.3,260271687,,TRANSFER DEBIT,Johnson Williams and Sims,-20528.699999999986,Uncategorised, 
22-Sep-19,1902.5,260271687,,INTER-BANK CREDIT,466646019920607 REED STOKES AND HENDERSON ,-18626.199999999986,Financial, 
23-Sep-19,281.34,260271687,,INTER-BANK CREDIT,374838002012177 REYES SHELTON AND BELL ,-18344.859999999986,Uncategorised, 
25-Sep-19,-1481.78,260271687,,INTER-BANK CREDIT,Buck LLC,-19826.639999999985,Bills, 
28-Sep-19,1794.4,260271687,,INTER-BANK CREDIT,Raymond Ltd,-18032.239999999983,Uncategorised, 
01-Oct-19,-468.21,260271687,,AUTOMATIC DRAWING,529717729476239 GRIFFIN INC ,-18500.449999999983,Financial, 
02-Oct-19,669.77,260271687,,AUTOMATIC DRAWING,Carney Knight and Blake,-17830.679999999982,Bills, 
05-Oct-19,426.46,260271687,,INTER-BANK CREDIT,Kelly and Sons,-17404.219999999983,Other Income, 
06-Oct-19,1824.55,260271687,,INTER-BANK CREDIT,Tate Hicks and Chapman,-15579.669999999984,Financial, 
06-Oct-19,1731.34,260271687,,INTER-BANK CREDIT,50331732268208 FERNANDEZ AND SONS ,-13848.329999999984,Uncategorised, 
07-Oct-19,-979.36,260271687,,INTER-BANK CREDIT,209724377518298 MILLER-SIMS ,-14827.689999999984,Bills, 
09-Oct-19,-771.32,260271687,,TRANSFER DEBIT,Bautista Smith and Bates,-15599.009999999984,Bills, 
12-Oct-19,1915.57,260271687,,INTER-BANK CREDIT,720349538333685 CASTRO-LEONARD ,-13683.439999999984,Bills, 
12-Oct-19,0.32,260271687,,AUTOMATIC DRAWING,Brooks PLC,-13683.119999999984,Other Income, 
14-Oct-19,1347.22,260271687,,TRANSFER DEBIT,Sawyer-Robinson,-12335.899999999985,Bills, 
17-Oct-19,817.92,260271687,,TRANSFER DEBIT,Hill-Hale,-11517.979999999985,Financial, 
18-Oct-19,366.17,260271687,,AUTOMATIC DRAWING,848065440996344 SCHROEDER-THORNTON ,-11151.809999999985,Bills, 
18-Oct-19,-1496.1,260271687,,INTER-BANK CREDIT,146651901097393 KIM-LOWE ,-12647.909999999985,Other Income, 
21-Oct-19,-1865.69,260271687,,AUTOMATIC DRAWING,172420514448881 RODRIGUEZ PLC ,-14513.599999999986,Bills, 
24-Oct-19,1058.12,260271687,,AUTOMATIC DRAWING,Bowman and Sons,-13455.479999999985,Other Income, 
25-Oct-19,1912.48,260271687,,AUTOMATIC DRAWING,29389152924417 MORAN AND SONS ,-11542.999999999985,Other Income, 
25-Oct-19,-1747.03,260271687,,INTER-BANK CREDIT,Colon Scott and Chavez,-13290.029999999986,Financial, 
26-Oct-19,1781.85,260271687,,INTER-BANK CREDIT,75424661142978 JACKSON RAMIREZ AND WRIGHT ,-11508.179999999986,Financial, 
28-Oct-19,-1392.51,260271687,,INTER-BANK CREDIT,Neal Thomas and Patterson,-12900.689999999986,Other Income, 
30-Oct-19,337.04,260271687,,AUTOMATIC DRAWING,829384474647423 YOUNG-WARNER ,-12563.649999999985,Bills, 
02-Nov-19,1142.11,260271687,,TRANSFER DEBIT,Osborn-Welch,-11421.539999999985,Uncategorised, 
04-Nov-19,59.18,260271687,,INTER-BANK CREDIT,Davis Alexander and Nelson,-11362.359999999984,Other Income, 
05-Nov-19,-1656.87,260271687,,TRANSFER DEBIT,Vazquez Inc,-13019.229999999985,Bills, 
08-Nov-19,56.48,260271687,,AUTOMATIC DRAWING,Morton-Osborn,-12962.749999999985,Uncategorised, 
10-Nov-19,-1651.14,260271687,,TRANSFER DEBIT,Reyes-Dawson,-14613.889999999985,Uncategorised, 
12-Nov-19,1146.03,260271687,,TRANSFER DEBIT,Johnson Group,-13467.859999999984,Uncategorised, 
13-Nov-19,-1447.56,260271687,,INTER-BANK CREDIT,Clark-Waller,-14915.419999999984,Other Income, 
16-Nov-19,-1227.01,260271687,,AUTOMATIC DRAWING,Gomez Group,-16142.429999999984,Uncategorised, 
19-Nov-19,-666.67,260271687,,AUTOMATIC DRAWING,495545534373972 AVILA EDWARDS AND STRICKLAND ,-16809.099999999984,Financial, 
21-Nov-19,1020.94,260271687,,INTER-BANK CREDIT,Coffey White and Lawrence,-15788.159999999983,Other Income, 
22-Nov-19,-1294.5,260271687,,INTER-BANK CREDIT,365201741884212 SANDERS FOSTER AND HARRIS ,-17082.65999999998,Financial, 
22-Nov-19,1667.82,260271687,,INTER-BANK CREDIT,Lucas Davis and Arnold,-15414.839999999982,Uncategorised, 
22-Nov-19,1046.21,260271687,,TRANSFER DEBIT,Murphy and Sons,-14368.629999999983,Financial, 
22-Nov-19,-1106.01,260271687,,INTER-BANK CREDIT,907981297868766 LEE-HILL ,-15474.639999999983,Bills, 
23-Nov-19,164.04,260271687,,AUTOMATIC DRAWING,Salazar Stafford and Barnes,-15310.599999999982,Bills, 
26-Nov-19,706.53,260271687,,TRANSFER DEBIT,Christensen-Mack,-14604.069999999982,Other Income, 
27-Nov-19,-149.82,260271687,,AUTOMATIC DRAWING,900058892957568 WINTERS LEWIS AND CRANE ,-14753.889999999981,Other Income, 
28-Nov-19,-1238.69,260271687,,INTER-BANK CREDIT,Rose-Brown,-15992.579999999982,Financial, 
01-Dec-19,-409.52,260271687,,TRANSFER DEBIT,659911046143165 DAVIS AND SONS ,-16402.09999999998,Other Income, 
02-Dec-19,-1320.11,260271687,,INTER-BANK CREDIT,Davis-Jackson,-17722.20999999998,Financial, 
02-Dec-19,1879.0,260271687,,INTER-BANK CREDIT,585893237782297 CAIN-LOPEZ ,-15843.209999999981,Bills, 
05-Dec-19,-1490.18,260271687,,TRANSFER DEBIT,770108772654321 TAYLOR LTD ,-17333.38999999998,Financial, 
07-Dec-19,-1872.81,260271687,,AUTOMATIC DRAWING,726165894879533 LEWIS AND SONS ,-19206.199999999983,Financial, 
08-Dec-19,-1199.09,260271687,,INTER-BANK CREDIT,Roberts Ltd,-20405.289999999983,Financial, 
11-Dec-19,641.87,260271687,,INTER-BANK CREDIT,Smith and Sons,-19763.419999999984,Financial, 
13-Dec-19,856.92,260271687,,AUTOMATIC DRAWING,Zimmerman PLC,-18906.499999999985,Uncategorised, 
15-Dec-19,-1274.59,260271687,,TRANSFER DEBIT,301849250104490 ROCHA NOLAN AND PATEL ,-20181.089999999986,Other Income, 
18-Dec-19,224.22,260271687,,TRANSFER DEBIT,866271348278088 LEE SANDERS AND DAVID ,-19956.869999999984,Bills, 
21-Dec-19,899.55,260271687,,AUTOMATIC DRAWING,694913039571117 MOORE-ROACH ,-19057.319999999985,Other Income, 
22-Dec-19,-341.16,260271687,,INTER-BANK CREDIT,64571895529839 QUINN PLC ,-19398.479999999985,Bills, 
25-Dec-19,-1217.54,260271687,,TRANSFER DEBIT,305988391369004 RAMOS MATHEWS AND ZHANG ,-20616.019999999986,Uncategorised, 
28-Dec-19,-391.79,260271687,,TRANSFER DEBIT,Miller-Wiggins,-21007.809999999987,Financial, 
30-Dec-19,1802.71,260271687,,INTER-BANK CREDIT,Smith PLC,-19205.099999999988,Financial, 
31-Dec-19,-1820.77,260271687,,INTER-BANK CREDIT,979224344912292 WAGNER-VELEZ ,-21025.869999999988,Bills, 
01-Jan-20,994.44,260271687,,INTER-BANK CREDIT,894833372999576 CROSS MARQUEZ AND SMITH ,-20031.42999999999,Other Income, 
04-Jan-20,-1554.81,260271687,,INTER-BANK CREDIT,721455800947194 LOVE LTD ,-21586.23999999999,Bills, 
06-Jan-20,203.93,260271687,,INTER-BANK CREDIT,Floyd Smith and Ali,-21382.30999999999,Uncategorised, 
09-Jan-20,1424.44,260271687,,TRANSFER DEBIT,Gilmore LLC,-19957.86999999999,Financial, 
10-Jan-20,-1202.8,260271687,,AUTOMATIC DRAWING,Branch-Thompson,-21160.66999999999,Uncategorised, 
13-Jan-20,-293.15,260271687,,INTER-BANK CREDIT,845197260523253 HINES GROUP ,-21453.819999999992,Uncategorised, 
16-Jan-20,-1086.47,260271687,,INTER-BANK CREDIT,189051245916772 WELCH PLC ,-22540.289999999994,Uncategorised, 
17-Jan-20,-1544.09,260271687,,INTER-BANK CREDIT,Hayes PLC,-24084.379999999994,Other Income, 
18-Jan-20,129.91,260271687,,AUTOMATIC DRAWING,Frazier-Hall,-23954.469999999994,Financial, 
21-Jan-20,488.51,260271687,,TRANSFER DEBIT,277289107152579 SMITH OROZCO AND JACKSON ,-23465.959999999995,Financial, 
21-Jan-20,1452.09,260271687,,AUTOMATIC DRAWING,200510682404835 DUNLAP-PETERS ,-22013.869999999995,Uncategorised, 
23-Jan-20,-1667.73,260271687,,TRANSFER DEBIT,607779471603090 SULLIVAN NUNEZ AND FREY ,-23681.599999999995,Other Income, 
26-Jan-20,-375.43,260271687,,INTER-BANK CREDIT,Alexander Larson and Martinez,-24057.029999999995,Other Income, 
29-Jan-20,1863.28,260271687,,INTER-BANK CREDIT,Conrad-Gordon,-22193.749999999996,Other Income, 
30-Jan-20,-318.6,260271687,,AUTOMATIC DRAWING,587123104927217 WASHINGTON LLC ,-22512.349999999995,Bills, 
02-Feb-20,4.43,260271687,,INTER-BANK CREDIT,Guerrero PLC,-22507.919999999995,Uncategorised, 
02-Feb-20,-1676.19,260271687,,TRANSFER DEBIT,Adkins LLC,-24184.109999999993,Bills, 
02-Feb-20,1513.04,260271687,,AUTOMATIC DRAWING,Alexander LLC,-22671.069999999992,Financial, 
05-Feb-20,1143.41,260271687,,INTER-BANK CREDIT,708850921929534 PETERSON-WIGGINS ,-21527.659999999993,Bills, 
06-Feb-20,-456.05,260271687,,TRANSFER DEBIT,Nelson LLC,-21983.709999999992,Financial, 
07-Feb-20,1184.29,260271687,,AUTOMATIC DRAWING,Taylor Thompson and Wong,-20799.41999999999,Other Income, 
07-Feb-20,460.59,260271687,,TRANSFER DEBIT,617401320732189 DANIELS SMITH AND CRAWFORD ,-20338.82999999999,Bills, 
10-Feb-20,1637.92,260271687,,INTER-BANK CREDIT,Perez-Pope,-18700.90999999999,Uncategorised, 
11-Feb-20,-1826.09,260271687,,AUTOMATIC DRAWING,Santos-Luna,-20526.99999999999,Bills, 
13-Feb-20,-177.74,260271687,,AUTOMATIC DRAWING,Parker Diaz and Wilcox,-20704.73999999999,Other Income, 
14-Feb-20,-1451.34,260271687,,INTER-BANK CREDIT,62832082432151 ENGLISH JOHNS AND ESTRADA ,-22156.07999999999,Uncategorised, 
15-Feb-20,1662.71,260271687,,INTER-BANK CREDIT,Jensen Suarez and May,-20493.36999999999,Uncategorised, 
18-Feb-20,-1933.81,260271687,,TRANSFER DEBIT,993178424685039 HILL-SMITH ,-22427.179999999993,Uncategorised, 
19-Feb-20,147.46,260271687,,TRANSFER DEBIT,715924013669601 DAVIS SPENCER AND MORRIS ,-22279.719999999994,Bills, 
20-Feb-20,1411.38,260271687,,INTER-BANK CREDIT,Oliver Scott and French,-20868.339999999993,Uncategorised, 
20-Feb-20,-91.21,260271687,,INTER-BANK CREDIT,Nelson-Booth,-20959.549999999992,Other Income, 
22-Feb-20,769.06,260271687,,INTER-BANK CREDIT,Reynolds-White,-20190.48999999999,Bills, 
24-Feb-20,-1041.12,260271687,,AUTOMATIC DRAWING,17218956353172 KELLY LTD ,-21231.60999999999,Uncategorised, 
25-Feb-20,216.04,260271687,,AUTOMATIC DRAWING,177579532971612 YOUNG LLC ,-21015.56999999999,Other Income, 
26-Feb-20,371.58,260271687,,TRANSFER DEBIT,Gutierrez-Reynolds,-20643.989999999987,Uncategorised, 
29-Feb-20,577.41,260271687,,INTER-BANK CREDIT,447027931300845 FRANCO-SMITH ,-20066.579999999987,Uncategorised, 
03-Mar-20,-1593.72,260271687,,INTER-BANK CREDIT,959281820170779 CAREY MILLER AND HALL ,-21660.29999999999,Bills, 
05-Mar-20,-503.3,260271687,,AUTOMATIC DRAWING,Rivas Morales and Smith,-22163.599999999988,Financial, 
08-Mar-20,255.47,260271687,,TRANSFER DEBIT,139052498430052 BELL PHELPS AND CASTRO ,-21908.129999999986,Financial, 
08-Mar-20,-1440.9,260271687,,INTER-BANK CREDIT,399068516501334 NOLAN-BLACK ,-23349.029999999988,Uncategorised, 
10-Mar-20,-1650.26,260271687,,AUTOMATIC DRAWING,151098233269853 COX SANCHEZ AND GILBERT ,-24999.289999999986,Financial, 
10-Mar-20,-799.04,260271687,,TRANSFER DEBIT,Mcclain-Holt,-25798.329999999987,Uncategorised, 
13-Mar-20,1391.52,260271687,,TRANSFER DEBIT,Rodriguez Group,-24406.809999999987,Uncategorised, 
16-Mar-20,-716.21,260271687,,INTER-BANK CREDIT,412812843018841 HARRIS-YOUNG ,-25123.019999999986,Bills, 
17-Mar-20,-1593.35,260271687,,INTER-BANK CREDIT,Richardson-Bass,-26716.369999999984,Uncategorised, 
18-Mar-20,-326.42,260271687,,INTER-BANK CREDIT,Lambert Group,-27042.789999999983,Uncategorised, 
18-Mar-20,-836.2,260271687,,INTER-BANK CREDIT,632818204387842 SMITH BARNES AND CLARK ,-27878.989999999983,Uncategorised, 
18-Mar-20,-1692.47,260271687,,INTER-BANK CREDIT,445418646477914 RAMSEY WILSON AND WARD ,-29571.459999999985,Bills, 
18-Mar-20,-1249.42,260271687,,INTER-BANK CREDIT,Jackson Murray and Abbott,-30820.879999999983,Other Income, 
18-Mar-20,81.79,260271687,,INTER-BANK CREDIT,609965557243820 MEYER LTD ,-30739.089999999982,Bills, 
19-Mar-20,1256.07,260271687,,INTER-BANK CREDIT,Haley Richard and Woods,-29483.019999999982,Financial, 
20-Mar-20,919.06,260271687,,TRANSFER DEBIT,Wilson and Sons,-28563.95999999998,Financial, 
21-Mar-20,-1268.8,260271687,,INTER-BANK CREDIT,Cook Reed and Brown,-29832.75999999998,Bills, 
22-Mar-20,1347.41,260271687,,INTER-BANK CREDIT,Luna LLC,-28485.34999999998,Financial, 
24-Mar-20,1530.7,260271687,,TRANSFER DEBIT,Benjamin Jackson and Carrillo,-26954.64999999998,Financial, 
27-Mar-20,1579.99,260271687,,INTER-BANK CREDIT,130741794994711 SHEPHERD-SAMPSON ,-25374.659999999978,Uncategorised, 
28-Mar-20,-1441.52,260271687,,TRANSFER DEBIT,Bruce-Clark,-26816.17999999998,Other Income, 
28-Mar-20,813.17,260271687,,INTER-BANK CREDIT,Cortez Sanders and Spencer,-26003.00999999998,Uncategorised, 
28-Mar-20,1939.75,260271687,,INTER-BANK CREDIT,Daniel Fuentes and Allison,-24063.25999999998,Financial, 
28-Mar-20,-1679.9,260271687,,INTER-BANK CREDIT,Burns-Warren,-25743.15999999998,Bills, 
31-Mar-20,590.29,260271687,,AUTOMATIC DRAWING,Love Quinn and Ramirez,-25152.86999999998,Bills, 
03-Apr-20,1568.15,260271687,,AUTOMATIC DRAWING,537737158849920 SCOTT MARTINEZ AND TRUJILLO ,-23584.71999999998,Financial, 
04-Apr-20,1190.01,260271687,,TRANSFER DEBIT,252165320208737 FULLER MAHONEY AND JOHNSON ,-22394.70999999998,Uncategorised, 
05-Apr-20,1353.71,260271687,,AUTOMATIC DRAWING,629282477337027 PHILLIPS DENNIS AND ROBLES ,-21040.99999999998,Other Income, 
07-Apr-20,690.93,260271687,,TRANSFER DEBIT,Herman Group,-20350.06999999998,Bills, 
08-Apr-20,1308.8,260271687,,INTER-BANK CREDIT,Potts-Giles,-19041.269999999982,Bills, 
11-Apr-20,7.14,260271687,,AUTOMATIC DRAWING,590262856936888 BROWN THOMAS AND REID ,-19034.129999999983,Bills, 
12-Apr-20,-176.34,260271687,,INTER-BANK CREDIT,157288280160830 JEFFERSON-HARPER ,-19210.469999999983,Uncategorised, 
12-Apr-20,-556.48,260271687,,INTER-BANK CREDIT,Wallace-Castro,-19766.949999999983,Financial, 
13-Apr-20,-1424.82,260271687,,AUTOMATIC DRAWING,50989478754885 THORNTON-GAINES ,-21191.769999999982,Bills, 
14-Apr-20,616.69,260271687,,INTER-BANK CREDIT,745526799239743 HERNANDEZ LTD ,-20575.079999999984,Other Income, 
14-Apr-20,-1182.93,260271687,,AUTOMATIC DRAWING,850793835789393 RODGERS LTD ,-21758.009999999984,Financial, 
15-Apr-20,-1217.84,260271687,,AUTOMATIC DRAWING,Morales Williams and Adams,-22975.849999999984,Bills, 
15-Apr-20,-1176.72,260271687,,TRANSFER DEBIT,763552608406450 RAMIREZ-BROOKS ,-24152.569999999985,Financial, 
18-Apr-20,-826.15,260271687,,INTER-BANK CREDIT,Todd Inc,-24978.719999999987,Bills, 
20-Apr-20,342.83,260271687,,INTER-BANK CREDIT,374550309380246 ROWE MEDINA AND GARCIA ,-24635.889999999985,Uncategorised, 
20-Apr-20,-495.18,260271687,,INTER-BANK CREDIT,Molina Carter and English,-25131.069999999985,Other Income, 
22-Apr-20,1543.78,260271687,,INTER-BANK CREDIT,Hancock-Benson,-23587.289999999986,Financial, 
25-Apr-20,-833.12,260271687,,AUTOMATIC DRAWING,Kirby Kelley and Larson,-24420.409999999985,Other Income, 
26-Apr-20,-756.01,260271687,,INTER-BANK CREDIT,Pugh-Francis,-25176.419999999984,Uncategorised, 
29-Apr-20,1292.73,260271687,,AUTOMATIC DRAWING,White-Weber,-23883.689999999984,Financial, 
30-Apr-20,-1379.67,260271687,,INTER-BANK CREDIT,808782126524378 RAMIREZ PLC ,-25263.359999999986,Bills, 
03-May-20,208.5,260271687,,INTER-BANK CREDIT,Myers-Mclean,-25054.859999999986,Uncategorised, 
05-May-20,-554.78,260271687,,INTER-BANK CREDIT,Peterson and Sons,-25609.639999999985,Bills, 
05-May-20,1423.28,260271687,,AUTOMATIC DRAWING,290361022962223 SCHROEDER-BROWN ,-24186.359999999986,Uncategorised, 
06-May-20,-326.78,260271687,,INTER-BANK CREDIT,Stark Fisher and Lopez,-24513.139999999985,Uncategorised, 
06-May-20,1753.59,260271687,,TRANSFER DEBIT,946320252054758 HAMILTON PLC ,-22759.549999999985,Financial, 
08-May-20,1623.52,260271687,,INTER-BANK CREDIT,951120980935412 LAM GROUP ,-21136.029999999984,Uncategorised, 
11-May-20,-492.67,260271687,,AUTOMATIC DRAWING,Little Ltd,-21628.699999999983,Bills, 
13-May-20,-1075.46,260271687,,INTER-BANK CREDIT,Sandoval LLC,-22704.15999999998,Bills, 
13-May-20,-419.12,260271687,,INTER-BANK CREDIT,698488279349196 PADILLA CHAPMAN AND MCKINNEY ,-23123.27999999998,Uncategorised, 
16-May-20,25.08,260271687,,INTER-BANK CREDIT,547991408591268 RAY-WILLIAMS ,-23098.19999999998,Other Income, 
19-May-20,295.11,260271687,,INTER-BANK CREDIT,Jones PLC,-22803.08999999998,Financial, 
19-May-20,550.92,260271687,,AUTOMATIC DRAWING,674333268444505 MARTIN JOHNSON AND MCDOWELL ,-22252.16999999998,Financial, 
22-May-20,387.69,260271687,,TRANSFER DEBIT,857938712228818 STRONG JACKSON AND LEE ,-21864.47999999998,Financial, 
22-May-20,1253.45,260271687,,INTER-BANK CREDIT,Li Joyce and Garcia,-20611.02999999998,Financial, 
25-May-20,501.3,260271687,,AUTOMATIC DRAWING,Cooper-Peters,-20109.72999999998,Financial, 
27-May-20,1364.93,260271687,,INTER-BANK CREDIT,528495741763208 AGUILAR-STEELE ,-18744.79999999998,Uncategorised, 
30-May-20,-1696.19,260271687,,AUTOMATIC DRAWING,Moore-Mcpherson,-20440.98999999998,Bills, 
02-Jun-20,-793.69,260271687,,INTER-BANK CREDIT,Downs Smith and Jordan,-21234.67999999998,Bills, 
05-Jun-20,1179.26,260271687,,AUTOMATIC DRAWING,133865816339370 MCCARTHY NICHOLS AND BATES ,-20055.41999999998,Financial, 
06-Jun-20,1168.26,260271687,,INTER-BANK CREDIT,Baldwin Group,-18887.15999999998,Uncategorised, 
08-Jun-20,-965.51,260271687,,INTER-BANK CREDIT,431839171734218 ALLEN SHELTON AND NEWTON ,-19852.66999999998,Other Income, 
08-Jun-20,-1653.11,260271687,,INTER-BANK CREDIT,Guzman Fisher and Baker,-21505.77999999998,Bills, 
08-Jun-20,-241.47,260271687,,INTER-BANK CREDIT,Howard Lewis and Rowe,-21747.24999999998,Other Income, 
08-Jun-20,-921.45,260271687,,AUTOMATIC DRAWING,Huffman King and Wilson,-22668.699999999983,Financial, 
10-Jun-20,340.03,260271687,,TRANSFER DEBIT,Gonzalez-Ryan,-22328.669999999984,Other Income, 
13-Jun-20,-1908.56,260271687,,TRANSFER DEBIT,Chapman-Williams,-24237.229999999985,Financial, 
14-Jun-20,259.52,260271687,,TRANSFER DEBIT,Phillips-Bryant,-23977.709999999985,Bills, 
16-Jun-20,1522.67,260271687,,INTER-BANK CREDIT,909370311467738 KING GROUP ,-22455.039999999986,Financial, 
17-Jun-20,775.21,260271687,,INTER-BANK CREDIT,Lucero and Sons,-21679.829999999987,Other Income, 
17-Jun-20,-1718.9,260271687,,INTER-BANK CREDIT,Sanchez PLC,-23398.72999999999,Bills, 
18-Jun-20,-1829.59,260271687,,INTER-BANK CREDIT,Ayers-Johnson,-25228.31999999999,Uncategorised, 
19-Jun-20,1006.63,260271687,,INTER-BANK CREDIT,734258548597131 ROSE HARTMAN AND MILLER ,-24221.689999999988,Financial, 
22-Jun-20,1359.79,260271687,,INTER-BANK CREDIT,Mitchell Williams and Trevino,-22861.899999999987,Uncategorised, 
25-Jun-20,-230.33,260271687,,AUTOMATIC DRAWING,White LLC,-23092.22999999999,Uncategorised, 
27-Jun-20,1102.94,260271687,,INTER-BANK CREDIT,Green Roth and Johnson,-21989.28999999999,Other Income, 
30-Jun-20,546.84,260271687,,AUTOMATIC DRAWING,500241045047600 JENKINS PERKINS AND OLSEN ,-21442.44999999999,Bills, 
02-Jul-20,182.13,260271687,,AUTOMATIC DRAWING,Lynch Martin and Martinez,-21260.31999999999,Other Income, 
02-Jul-20,1251.68,260271687,,INTER-BANK CREDIT,Bishop-Smith,-20008.63999999999,Bills, 
05-Jul-20,1447.55,260271687,,AUTOMATIC DRAWING,413729659548574 WALLACE-HARVEY ,-18561.08999999999,Other Income, 
06-Jul-20,-1608.22,260271687,,AUTOMATIC DRAWING,923689068843388 CANNON BRUCE AND SMITH ,-20169.30999999999,Other Income, 
07-Jul-20,162.12,260271687,,INTER-BANK CREDIT,Baker and Sons,-20007.18999999999,Bills, 
10-Jul-20,716.01,260271687,,AUTOMATIC DRAWING,631667004142958 KING LLC ,-19291.179999999993,Other Income, 
12-Jul-20,41.5,260271687,,INTER-BANK CREDIT,Cole LLC,-19249.679999999993,Bills, 
14-Jul-20,-1933.76,260271687,,TRANSFER DEBIT,697837777070035 YATES LTD ,-21183.43999999999,Bills, 
17-Jul-20,-1008.3,260271687,,AUTOMATIC DRAWING,101773005809685 JONES-CLARK ,-22191.73999999999,Uncategorised, 
19-Jul-20,298.78,260271687,,INTER-BANK CREDIT,Mckinney Inc,-21892.959999999992,Financial, 
20-Jul-20,-1563.22,260271687,,INTER-BANK CREDIT,956214271567977 GREENE-KERR ,-23456.179999999993,Financial, 
22-Jul-20,148.31,260271687,,AUTOMATIC DRAWING,Smith Molina and Graham,-23307.86999999999,Bills, 
24-Jul-20,-420.85,260271687,,TRANSFER DEBIT,Carpenter Ltd,-23728.71999999999,Bills, 
24-Jul-20,379.62,260271687,,INTER-BANK CREDIT,Martin-Stewart,-23349.09999999999,Uncategorised, 
26-Jul-20,-562.5,260271687,,TRANSFER DEBIT,767616410059688 HAMILTON-MILLER ,-23911.59999999999,Other Income, 
28-Jul-20,143.8,260271687,,INTER-BANK CREDIT,418504260003893 FLORES ROWLAND AND JONES ,-23767.799999999992,Bills, 
28-Jul-20,804.55,260271687,,INTER-BANK CREDIT,255813452341260 MCCARTHY-ROSS ,-22963.249999999993,Uncategorised, 
31-Jul-20,-1490.46,260271687,,INTER-BANK CREDIT,217210312426861 BARNETT INC ,-24453.709999999992,Bills, 
01-Aug-20,1744.69,260271687,,INTER-BANK CREDIT,129474685002094 HARPER INC ,-22709.019999999993,Uncategorised, 
01-Aug-20,-743.56,260271687,,INTER-BANK CREDIT,506632466042493 HARPER INC ,-23452.579999999994,Bills, 
04-Aug-20,1025.55,260271687,,INTER-BANK CREDIT,Graham Group,-22427.029999999995,Uncategorised, 
07-Aug-20,-424.44,260271687,,AUTOMATIC DRAWING,Jackson Lee and Cross,-22851.469999999994,Bills, 
10-Aug-20,646.36,260271687,,INTER-BANK CREDIT,Perez-Cohen,-22205.109999999993,Financial, 
12-Aug-20,201.57,260271687,,AUTOMATIC DRAWING,624166994366632 RUSSELL SIMS AND HARDY ,-22003.539999999994,Other Income, 
15-Aug-20,1197.04,260271687,,INTER-BANK CREDIT,Moore Anderson and Smith,-20806.499999999993,Bills, 
18-Aug-20,473.38,260271687,,AUTOMATIC DRAWING,354813979964919 RAMIREZ PORTER AND PARSONS ,-20333.11999999999,Bills, 
19-Aug-20,-138.26,260271687,,TRANSFER DEBIT,242952241183170 LOVE-MAYO ,-20471.37999999999,Bills, 
20-Aug-20,-722.39,260271687,,INTER-BANK CREDIT,Jacobson PLC,-21193.76999999999,Other Income, 
21-Aug-20,-1624.68,260271687,,INTER-BANK CREDIT,Howard LLC,-22818.44999999999,Uncategorised, 
23-Aug-20,118.08,260271687,,AUTOMATIC DRAWING,Medina LLC,-22700.369999999988,Uncategorised, 
26-Aug-20,843.43,260271687,,AUTOMATIC DRAWING,390047700252434 HICKS PLC ,-21856.939999999988,Bills, 
26-Aug-20,963.84,260271687,,INTER-BANK CREDIT,Garza Ltd,-20893.099999999988,Uncategorised, 
28-Aug-20,-341.16,260271687,,INTER-BANK CREDIT,Castaneda Dunn and Walters,-21234.259999999987,Bills, 
31-Aug-20,38.17,260271687,,TRANSFER DEBIT,Solis Pham and Chan,-21196.08999999999,Bills, 
31-Aug-20,-1872.04,260271687,,AUTOMATIC DRAWING,Johnson Harrington and Bryant,-23068.12999999999,Other Income, 
31-Aug-20,-718.71,260271687,,TRANSFER DEBIT,652544210484864 SANFORD-WILSON ,-23786.83999999999,Other Income, 
03-Sep-20,854.13,260271687,,TRANSFER DEBIT,934343936245402 FORD MURPHY AND TAYLOR ,-22932.70999999999,Uncategorised, 
03-Sep-20,-1759.28,260271687,,AUTOMATIC DRAWING,Saunders Mendoza and Stewart,-24691.989999999987,Uncategorised, 
03-Sep-20,-493.28,260271687,,INTER-BANK CREDIT,Lynn Group,-25185.269999999986,Uncategorised, 
03-Sep-20,-1755.28,260271687,,INTER-BANK CREDIT,931964850904770 PARKS-STANLEY ,-26940.549999999985,Uncategorised, 
06-Sep-20,-49.72,260271687,,INTER-BANK CREDIT,Santos-Goodwin,-26990.269999999986,Other Income, 
09-Sep-20,-171.38,260271687,,TRANSFER DEBIT,Gomez-Jordan,-27161.649999999987,Uncategorised, 
10-Sep-20,1943.14,260271687,,TRANSFER DEBIT,Hess PLC,-25218.509999999987,Other Income, 
12-Sep-20,615.84,260271687,,INTER-BANK CREDIT,314090677866 SMITH-DENNIS ,-24602.669999999987,Other Income, 
13-Sep-20,-542.37,260271687,,INTER-BANK CREDIT,581574374462723 DAVIS-PHILLIPS ,-25145.039999999986,Uncategorised, 
15-Sep-20,885.5,260271687,,TRANSFER DEBIT,Mann-Johnson,-24259.539999999986,Other Income, 
18-Sep-20,562.73,260271687,,INTER-BANK CREDIT,116458073326288 ROTH-FITZPATRICK ,-23696.809999999987,Financial, 
18-Sep-20,-1472.76,260271687,,INTER-BANK CREDIT,Beltran LLC,-25169.569999999985,Financial, 
19-Sep-20,81.98,260271687,,INTER-BANK CREDIT,104052838835821 BAKER LTD ,-25087.589999999986,Bills, 
20-Sep-20,214.26,260271687,,INTER-BANK CREDIT,Martin-Cortez,-24873.329999999987,Other Income, 
20-Sep-20,1726.92,260271687,,TRANSFER DEBIT,Garcia Peterson and Green,-23146.40999999999,Other Income, 
23-Sep-20,-377.58,260271687,,INTER-BANK CREDIT,Hughes and Sons,-23523.98999999999,Other Income, 
26-Sep-20,-1026.46,260271687,,INTER-BANK CREDIT,683535521825684 YOUNG STARK AND PERRY ,-24550.44999999999,Bills, 
26-Sep-20,200.39,260271687,,AUTOMATIC DRAWING,757211563831567 DOMINGUEZ LTD ,-24350.05999999999,Bills, 
27-Sep-20,-54.57,260271687,,AUTOMATIC DRAWING,Hicks Brady and Contreras,-24404.62999999999,Financial, 
29-Sep-20,222.57,260271687,,INTER-BANK CREDIT,3490852246805 PORTER-PERRY ,-24182.05999999999,Bills, 
02-Oct-20,355.42,260271687,,TRANSFER DEBIT,813934997661712 PAGE-GOMEZ ,-23826.639999999992,Uncategorised, 
05-Oct-20,1918.2,260271687,,INTER-BANK CREDIT,Warner-Martinez,-21908.43999999999,Financial, 
06-Oct-20,-362.69,260271687,,AUTOMATIC DRAWING,698354304820371 PATEL-FLEMING ,-22271.12999999999,Other Income, 
06-Oct-20,509.96,260271687,,INTER-BANK CREDIT,Baldwin-Powell,-21761.16999999999,Bills, 
06-Oct-20,-1573.26,260271687,,INTER-BANK CREDIT,334013452931452 PORTER AND SONS ,-23334.42999999999,Uncategorised, 
09-Oct-20,1386.37,260271687,,AUTOMATIC DRAWING,74458906418899 RYAN-THOMPSON ,-21948.05999999999,Financial, 
09-Oct-20,-679.83,260271687,,INTER-BANK CREDIT,Freeman Ochoa and Phillips,-22627.889999999992,Uncategorised, 
09-Oct-20,-901.88,260271687,,INTER-BANK CREDIT,940924068813206 WILSON MORRIS AND MAY ,-23529.769999999993,Other Income, 
12-Oct-20,495.85,260271687,,TRANSFER DEBIT,664907740520868 JOHNSON AND SONS ,-23033.919999999995,Financial, 
14-Oct-20,-1439.7,260271687,,INTER-BANK CREDIT,Smith-Mata,-24473.619999999995,Uncategorised, 
16-Oct-20,873.41,260271687,,INTER-BANK CREDIT,266401848558030 HOWARD-ESCOBAR ,-23600.209999999995,Uncategorised, 
16-Oct-20,-1661.61,260271687,,TRANSFER DEBIT,886207519637140 CRANE WHITE AND MARTINEZ ,-25261.819999999996,Financial, 
18-Oct-20,1805.51,260271687,,AUTOMATIC DRAWING,Allen Baldwin and Phillips,-23456.309999999998,Financial, 
21-Oct-20,1556.23,260271687,,INTER-BANK CREDIT,Walter-Cole,-21900.079999999998,Other Income, 
23-Oct-20,-419.97,260271687,,INTER-BANK CREDIT,Stevens-Baker,-22320.05,Financial, 
24-Oct-20,-802.92,260271687,,INTER-BANK CREDIT,166807065099864 REED PLC ,-23122.969999999998,Other Income, 
25-Oct-20,1238.33,260271687,,INTER-BANK CREDIT,93441774380207 WILLIAMS BECKER AND BROWN ,-21884.64,Financial, 
27-Oct-20,1692.45,260271687,,TRANSFER DEBIT,380828930130766 SALAZAR-CONNER ,-20192.19,Financial, 
29-Oct-20,445.26,260271687,,INTER-BANK CREDIT,Johnson Ward and Gonzales,-19746.93,Uncategorised, 
30-Oct-20,752.46,260271687,,INTER-BANK CREDIT,Frazier Wright and Dennis,-18994.47,Other Income, 
30-Oct-20,-746.08,260271687,,AUTOMATIC DRAWING,203007374928375 SPARKS-WEBER ,-19740.550000000003,Financial, 
01-Nov-20,-1898.83,260271687,,TRANSFER DEBIT,Lin-Hanson,-21639.380000000005,Financial, 
03-Nov-20,1839.28,260271687,,AUTOMATIC DRAWING,289954506607950 PHILLIPS AND SONS ,-19800.100000000006,Bills, 
05-Nov-20,595.83,260271687,,TRANSFER DEBIT,735624750811316 COLLINS-HUTCHINSON ,-19204.270000000004,Financial, 
07-Nov-20,1221.32,260271687,,INTER-BANK CREDIT,Lee-Cohen,-17982.950000000004,Uncategorised, 
07-Nov-20,-1274.32,260271687,,TRANSFER DEBIT,709838965275106 ANTHONY GONZALEZ AND JOHNSON ,-19257.270000000004,Financial, 
09-Nov-20,108.53,260271687,,INTER-BANK CREDIT,698620971214917 MCDANIEL-TURNER ,-19148.740000000005,Other Income, 
10-Nov-20,429.75,260271687,,AUTOMATIC DRAWING,Herrera Inc,-18718.990000000005,Uncategorised, 
11-Nov-20,1734.97,260271687,,AUTOMATIC DRAWING,845395915872933 CLARK PATEL AND LEE ,-16984.020000000004,Financial, 
14-Nov-20,1513.3,260271687,,INTER-BANK CREDIT,Ross Bowers and King,-15470.720000000005,Financial, 
14-Nov-20,-31.52,260271687,,AUTOMATIC DRAWING,375506106278270 PEREZ-HUNT ,-15502.240000000005,Uncategorised, 
14-Nov-20,-0.29,260271687,,INTER-BANK CREDIT,Lawrence Schwartz and Lawson,-15502.530000000006,Financial, 
17-Nov-20,-57.5,260271687,,INTER-BANK CREDIT,974761092817171 SCHULTZ-ONEAL ,-15560.030000000006,Financial, 
17-Nov-20,1155.54,260271687,,TRANSFER DEBIT,49506537762080 REESE THOMPSON AND PARKS ,-14404.490000000005,Uncategorised, 
19-Nov-20,-110.86,260271687,,INTER-BANK CREDIT,591263199942242 BROWN PEREZ AND GILBERT ,-14515.350000000006,Financial, 
22-Nov-20,44.77,260271687,,INTER-BANK CREDIT,2921444062165 RIVERA MATA AND RUSSELL ,-14470.580000000005,Uncategorised, 
24-Nov-20,307.92,260271687,,INTER-BANK CREDIT,Lee and Sons,-14162.660000000005,Other Income, 
26-Nov-20,-1459.27,260271687,,TRANSFER DEBIT,Mejia Inc,-15621.930000000006,Uncategorised, 
29-Nov-20,-1501.06,260271687,,TRANSFER DEBIT,Lee Campbell and Bailey,-17122.990000000005,Financial, 
30-Nov-20,258.13,260271687,,INTER-BANK CREDIT,Weber Ltd,-16864.860000000004,Bills, 
02-Dec-20,-989.05,260271687,,TRANSFER DEBIT,14839280029707 TRAN-LAWRENCE ,-17853.910000000003,Bills, 
03-Dec-20,-872.95,260271687,,TRANSFER DEBIT,Bryant-Ramsey,-18726.860000000004,Financial, 
06-Dec-20,-1280.02,260271687,,AUTOMATIC DRAWING,Gray Ltd,-20006.880000000005,Bills, 
09-Dec-20,-1571.2,260271687,,TRANSFER DEBIT,Jennings and Sons,-21578.080000000005,Uncategorised, 
09-Dec-20,2.68,260271687,,TRANSFER DEBIT,Wallace Branch and Taylor,-21575.400000000005,Uncategorised, 
12-Dec-20,-1460.5,260271687,,INTER-BANK CREDIT,Anderson Group,-23035.900000000005,Uncategorised, 
12-Dec-20,1744.55,260271687,,TRANSFER DEBIT,Villarreal Shields and Holloway,-21291.350000000006,Bills, 
13-Dec-20,616.28,260271687,,INTER-BANK CREDIT,Nelson Wood and Robinson,-20675.070000000007,Other Income, 
13-Dec-20,-422.5,260271687,,INTER-BANK CREDIT,443045086436511 BELL GROUP ,-21097.570000000007,Bills, 
16-Dec-20,-1565.49,260271687,,AUTOMATIC DRAWING,Solis Moreno and Wilson,-22663.06000000001,Bills, 
17-Dec-20,-1168.42,260271687,,AUTOMATIC DRAWING,Martinez Gutierrez and Martin,-23831.48000000001,Financial, 
18-Dec-20,-1974.58,260271687,,INTER-BANK CREDIT,Lane Lee and Thomas,-25806.060000000012,Financial, 
20-Dec-20,966.18,260271687,,INTER-BANK CREDIT,414473504879069 VELASQUEZ MATTHEWS AND HILL ,-24839.880000000012,Other Income, 
23-Dec-20,44.07,260271687,,INTER-BANK CREDIT,802773513842520 BUCK BROWN AND LANE ,-24795.810000000012,Bills, 
25-Dec-20,-1165.12,260271687,,INTER-BANK CREDIT,Freeman-Frye,-25960.93000000001,Financial, 
25-Dec-20,417.06,260271687,,TRANSFER DEBIT,470047637614751 HARRISON-ALLEN ,-25543.87000000001,Uncategorised, 
25-Dec-20,454.84,260271687,,INTER-BANK CREDIT,65437253053803 ANDERSON BEASLEY AND BROWN ,-25089.03000000001,Bills, 
27-Dec-20,1474.12,260271687,,TRANSFER DEBIT,917142328448003 JAMES-ANDERSON ,-23614.91000000001,Other Income, 
27-Dec-20,305.17,260271687,,INTER-BANK CREDIT,Miller Group,-23309.740000000013,Bills, 
30-Dec-20,-138.23,260271687,,AUTOMATIC DRAWING,434059992652092 LONG-MOODY ,-23447.970000000012,Bills, 
31-Dec-20,-504.18,260271687,,TRANSFER DEBIT,Clark Garcia and Matthews,-23952.150000000012,Uncategorised, 
02-Jan-21,-1376.53,260271687,,INTER-BANK CREDIT,409574914273812 RODRIGUEZ LTD ,-25328.68000000001,Uncategorised, 
02-Jan-21,-1749.93,260271687,,INTER-BANK CREDIT,Turner-Moses,-27078.61000000001,Other Income, 
04-Jan-21,53.31,260271687,,TRANSFER DEBIT,830752495667158 ARNOLD AND SONS ,-27025.30000000001,Uncategorised, 
06-Jan-21,1770.64,260271687,,TRANSFER DEBIT,667373950352609 LAMBERT INC ,-25254.66000000001,Uncategorised, 
06-Jan-21,1059.33,260271687,,TRANSFER DEBIT,Perez Mckinney and Snow,-24195.33000000001,Financial, 
09-Jan-21,-1129.88,260271687,,AUTOMATIC DRAWING,Morris-Reyes,-25325.21000000001,Bills, 
09-Jan-21,-1973.7,260271687,,AUTOMATIC DRAWING,Stephens Contreras and Sanders,-27298.91000000001,Financial, 
12-Jan-21,1270.28,260271687,,AUTOMATIC DRAWING,930859621209433 MORA LLC ,-26028.630000000012,Bills, 
14-Jan-21,144.43,260271687,,AUTOMATIC DRAWING,Hodges Wu and Carrillo,-25884.20000000001,Other Income, 
17-Jan-21,1910.8,260271687,,AUTOMATIC DRAWING,Bowers-Shepherd,-23973.400000000012,Other Income, 
17-Jan-21,170.89,260271687,,INTER-BANK CREDIT,Luna and Sons,-23802.510000000013,Financial, 
17-Jan-21,-66.11,260271687,,TRANSFER DEBIT,Ruiz-Davis,-23868.620000000014,Other Income, 
18-Jan-21,-1341.7,260271687,,TRANSFER DEBIT,50390592514350 SIMMONS GROUP ,-25210.320000000014,Bills, 
20-Jan-21,-1604.5,260271687,,TRANSFER DEBIT,Bishop Gray and Roberts,-26814.820000000014,Bills, 
20-Jan-21,-1686.9,260271687,,INTER-BANK CREDIT,149601086670267 JONES LTD ,-28501.720000000016,Uncategorised, 
23-Jan-21,-213.18,260271687,,AUTOMATIC DRAWING,830961235205813 BENNETT WILLIAMS AND HUNT ,-28714.900000000016,Bills, 
24-Jan-21,68.39,260271687,,INTER-BANK CREDIT,Hernandez Group,-28646.510000000017,Uncategorised, 
