Bank Account,Date,Narrative,Debit,Credit,Balance,Categories,Serial
971502153350,02/01/2018,Powell Miller and Dominguez,361.37,,3654.8399999999997,ATM, 
971502153350,04/01/2018,Martin Group,,1500.55,2154.29,ATM, 
971502153350,07/01/2018,Wood Ltd,,559.65,1594.6399999999999,ATM, 
971502153350,10/01/2018,Brown and Sons,506.61,,2101.25,PAYMENT, 
971502153350,10/01/2018,855367978073094 BRAY-BECK ,589.12,,2690.37,POS, 
971502153350,13/01/2018,Combs-Chan,,1538.46,1151.9099999999999,ATM, 
971502153350,14/01/2018,Serrano Ltd,,213.45,938.4599999999998,OTHER, 
971502153350,15/01/2018,Perez-Davis,146.83,,1085.2899999999997,PAYMENT, 
971502153350,16/01/2018,779666032354102 CAMPBELL-RYAN ,,183.82,901.4699999999998,PAYMENT, 
971502153350,17/01/2018,343345604085 CRUZ-BURNS ,,1324.98,-423.5100000000002,PAYMENT, 
971502153350,17/01/2018,173921519030227 HARDIN-SCHROEDER ,541.72,,118.20999999999981,PAYMENT, 
971502153350,20/01/2018,140874581418022 RAMIREZ LTD ,203.56,,321.7699999999998,PAYMENT, 
971502153350,23/01/2018,843211326765051 COOPER AND SONS ,391.71,,713.4799999999998,POS, 
971502153350,25/01/2018,Armstrong Davis and Robinson,588.42,,1301.8999999999996,PAYMENT, 
971502153350,26/01/2018,Hall Hammond and Wilson,1418.66,,2720.5599999999995,ATM, 
971502153350,27/01/2018,Smith Richard and Martin,,1439.9,1280.6599999999994,ATM, 
971502153350,28/01/2018,Oneal-Wagner,,458.69,821.9699999999993,OTHER, 
971502153350,28/01/2018,Lowe Francis and Wade,657.93,,1479.8999999999992,OTHER, 
971502153350,31/01/2018,53642906971553 ROWE INC ,1606.33,,3086.229999999999,OTHER, 
971502153350,01/02/2018,Chandler Gonzalez and Carrillo,,997.38,2088.849999999999,OTHER, 
971502153350,03/02/2018,404316141647018 JENNINGS-ONEILL ,1655.78,,3744.629999999999,POS, 
971502153350,05/02/2018,Baker Bartlett and Watson,,517.43,3227.1999999999994,OTHER, 
971502153350,07/02/2018,Hartman Santana and Briggs,,1210.13,2017.0699999999993,POS, 
971502153350,08/02/2018,Johnson Roberts and Coleman,211.96,,2229.0299999999993,OTHER, 
971502153350,09/02/2018,Austin-Schmidt,1941.97,,4170.999999999999,OTHER, 
971502153350,12/02/2018,Walker Hansen and Owens,,1943.17,2227.829999999999,ATM, 
971502153350,12/02/2018,790637474349271 CABRERA-ROBERTS ,1390.71,,3618.539999999999,POS, 
971502153350,13/02/2018,458596377291537 KING PEREZ AND SMITH ,1210.7,,4829.239999999999,ATM, 
971502153350,16/02/2018,926372795904001 WRIGHT-MAXWELL ,1805.0,,6634.239999999999,OTHER, 
971502153350,16/02/2018,Phillips-Gray,,1320.54,5313.699999999999,ATM, 
971502153350,19/02/2018,Morgan and Sons,,831.79,4481.909999999999,POS, 
971502153350,20/02/2018,502050180607834 LOPEZ PLC ,1192.17,,5674.079999999999,ATM, 
971502153350,23/02/2018,371333082537070 BARTON JONES AND SPENCER ,672.94,,6347.019999999999,OTHER, 
971502153350,23/02/2018,285356828502457 COHEN AND SONS ,,686.29,5660.729999999999,OTHER, 
971502153350,26/02/2018,Atkins LLC,,774.15,4886.579999999999,POS, 
971502153350,27/02/2018,551202181824436 CLARK-HORN ,1712.85,,6599.4299999999985,ATM, 
971502153350,28/02/2018,525809244155211 HALEY INC ,527.63,,7127.059999999999,POS, 
971502153350,01/03/2018,611229536851396 BROWN CUNNINGHAM AND PETERSON ,,1413.6,5713.459999999999,OTHER, 
971502153350,02/03/2018,678202620000368 ELLIS-HARVEY ,,306.35,5407.109999999999,POS, 
971502153350,05/03/2018,683029359677957 ADAMS GROUP ,1709.45,,7116.559999999999,PAYMENT, 
971502153350,05/03/2018,746507659528467 PATRICK AND SONS ,470.38,,7586.939999999999,POS, 
971502153350,07/03/2018,Hess Group,,1376.75,6210.189999999999,PAYMENT, 
971502153350,09/03/2018,469091096741036 ROSARIO LLC ,,1033.49,5176.699999999999,POS, 
971502153350,09/03/2018,354341452919781 FARLEY-WONG ,,730.78,4445.919999999999,POS, 
971502153350,09/03/2018,Schmidt-Baker,,244.53,4201.389999999999,ATM, 
971502153350,10/03/2018,Waters Gomez and Johnson,,515.67,3685.7199999999993,OTHER, 
971502153350,10/03/2018,Smith Group,,1364.12,2321.5999999999995,OTHER, 
971502153350,10/03/2018,Nash Group,,1410.95,910.6499999999994,POS, 
971502153350,12/03/2018,Alvarado Group,250.43,,1161.0799999999995,PAYMENT, 
971502153350,13/03/2018,453574349825598 ANDERSON WHEELER AND CHARLES ,1272.38,,2433.4599999999996,POS, 
971502153350,15/03/2018,Pena-Hamilton,,1134.15,1299.3099999999995,POS, 
971502153350,15/03/2018,Moreno Romero and Stokes,235.06,,1534.3699999999994,OTHER, 
971502153350,15/03/2018,618185379683561 HANEY-DOUGLAS ,,1113.27,421.09999999999945,OTHER, 
971502153350,17/03/2018,Taylor Rivas and Dixon,956.21,,1377.3099999999995,ATM, 
971502153350,17/03/2018,842461261872290 SMITH AND SONS ,,411.84,965.4699999999996,PAYMENT, 
971502153350,20/03/2018,358711152758038 HAMPTON FLYNN AND MCCALL ,,948.49,16.979999999999563,PAYMENT, 
971502153350,20/03/2018,Lopez Arnold and Peters,,1491.82,-1474.8400000000004,OTHER, 
971502153350,23/03/2018,473229677237499 RUSSELL SHEPARD AND WYATT ,277.88,,-1196.9600000000005,OTHER, 
971502153350,23/03/2018,Richardson-Wilson,1381.53,,184.56999999999948,OTHER, 
971502153350,26/03/2018,42548917409859 BROOKS-CAMERON ,1487.18,,1671.7499999999995,POS, 
971502153350,28/03/2018,Edwards-Hicks,434.94,,2106.6899999999996,PAYMENT, 
971502153350,31/03/2018,Hansen-Davis,,1010.81,1095.8799999999997,ATM, 
971502153350,03/04/2018,Hull-George,206.37,,1302.2499999999995,OTHER, 
971502153350,05/04/2018,Werner-Anderson,280.93,,1583.1799999999996,ATM, 
971502153350,05/04/2018,487854957710763 GREEN AND SONS ,,1863.08,-279.9000000000003,PAYMENT, 
971502153350,07/04/2018,544797593417305 REESE AND SONS ,,1739.66,-2019.5600000000004,ATM, 
971502153350,09/04/2018,555982806636016 GONZALEZ-LUTZ ,1534.48,,-485.0800000000004,POS, 
971502153350,10/04/2018,977506445071203 RAMSEY-LEON ,177.63,,-307.4500000000004,POS, 
971502153350,11/04/2018,Johnson LLC,,1534.57,-1842.0200000000004,POS, 
971502153350,11/04/2018,Bass Gay and Hale,1682.89,,-159.13000000000034,POS, 
971502153350,11/04/2018,Perez PLC,345.38,,186.24999999999966,ATM, 
971502153350,11/04/2018,Williams Lopez and Brown,1264.38,,1450.6299999999997,PAYMENT, 
971502153350,14/04/2018,Hill Johnston and Harmon,1523.62,,2974.2499999999995,ATM, 
971502153350,17/04/2018,124307462301358 COLE-SMITH ,,889.61,2084.6399999999994,POS, 
971502153350,18/04/2018,Garcia-Williams,292.57,,2377.2099999999996,ATM, 
971502153350,18/04/2018,Lynch Booker and Hamilton,,1068.5,1308.7099999999996,OTHER, 
971502153350,21/04/2018,Walters Pearson and Porter,36.07,,1344.7799999999995,ATM, 
971502153350,24/04/2018,987443175867355 HANSEN BARKER AND WONG ,509.64,,1854.4199999999996,ATM, 
971502153350,25/04/2018,275912849627591 BRYANT-FRANK ,,856.08,998.3399999999996,POS, 
971502153350,26/04/2018,Bernard-Pruitt,657.9,,1656.2399999999996,OTHER, 
971502153350,29/04/2018,870037021678327 COMBS GROUP ,307.26,,1963.4999999999995,POS, 
971502153350,02/05/2018,344453720593942 PRESTON-MCINTOSH ,,280.55,1682.9499999999996,OTHER, 
971502153350,05/05/2018,139971191243097 EVANS BERGER AND ELLIS ,1708.45,,3391.3999999999996,ATM, 
971502153350,08/05/2018,499815967734024 HOFFMAN WEST AND GONZALES ,,325.37,3066.0299999999997,OTHER, 
971502153350,11/05/2018,Snyder Dennis and Harris,,469.19,2596.8399999999997,OTHER, 
971502153350,12/05/2018,762789522686431 GONZALEZ-RASMUSSEN ,730.57,,3327.41,OTHER, 
971502153350,15/05/2018,564572254842602 BYRD-WILKINSON ,,793.85,2533.56,POS, 
971502153350,16/05/2018,Phillips Ltd,558.81,,3092.37,PAYMENT, 
971502153350,17/05/2018,Jones-Fox,,1712.8,1379.57,PAYMENT, 
971502153350,19/05/2018,299647362943278 KERR-KEITH ,,1386.04,-6.470000000000027,ATM, 
971502153350,22/05/2018,Walker-Gonzalez,1766.61,,1760.1399999999999,OTHER, 
971502153350,22/05/2018,870253662392013 JOHNSON MADDEN AND MORALES ,,156.94,1603.1999999999998,ATM, 
971502153350,25/05/2018,315128119382043 ANDERSON-BROWN ,1828.4,,3431.6,PAYMENT, 
971502153350,27/05/2018,709184186349242 BARKER DELGADO AND MARTIN ,1533.43,,4965.03,ATM, 
971502153350,29/05/2018,294423848900119 WALKER BOYER AND AGUILAR ,,477.09,4487.94,ATM, 
971502153350,30/05/2018,Glover Sanford and Pena,,224.11,4263.83,POS, 
971502153350,31/05/2018,Sanders and Sons,,555.31,3708.52,PAYMENT, 
971502153350,03/06/2018,449283575029347 HAYES GROUP ,1862.72,,5571.24,OTHER, 
971502153350,03/06/2018,858105993388279 MYERS INC ,,1596.39,3974.8499999999995,PAYMENT, 
971502153350,05/06/2018,552946082735722 WILLIAMS INC ,,1897.85,2076.9999999999995,POS, 
971502153350,07/06/2018,Mcdonald Group,1871.22,,3948.2199999999993,PAYMENT, 
971502153350,08/06/2018,Long Lindsey and Vang,1346.87,,5295.089999999999,ATM, 
971502153350,09/06/2018,Fields Group,189.81,,5484.9,POS, 
971502153350,12/06/2018,922143688281286 KING INC ,,1980.82,3504.08,POS, 
971502153350,15/06/2018,395599184687988 BONILLA-JACOBS ,,181.48,3322.6,POS, 
971502153350,15/06/2018,Hayes Walker and Garcia,,1255.47,2067.13,ATM, 
971502153350,17/06/2018,Young-Montgomery,1747.46,,3814.59,ATM, 
971502153350,17/06/2018,Baker-Jimenez,362.82,,4177.41,OTHER, 
971502153350,20/06/2018,390125392295798 DAVIS-BELL ,,662.39,3515.02,OTHER, 
971502153350,22/06/2018,838197414942426 GREEN AND SONS ,1767.95,,5282.97,ATM, 
971502153350,23/06/2018,298578325253848 GREGORY INC ,927.7,,6210.67,OTHER, 
971502153350,23/06/2018,305405409309050 SEXTON-TURNER ,,1899.99,4310.68,PAYMENT, 
971502153350,24/06/2018,245883577059378 WELCH LTD ,1897.54,,6208.22,POS, 
971502153350,24/06/2018,Brown PLC,1691.83,,7900.05,ATM, 
971502153350,27/06/2018,Howard-Barton,1497.97,,9398.02,OTHER, 
971502153350,30/06/2018,Garcia Roberts and Rodriguez,,1465.27,7932.75,POS, 
971502153350,01/07/2018,Carter Group,,695.44,7237.3099999999995,OTHER, 
971502153350,02/07/2018,Pacheco Meza and Booker,,1124.27,6113.039999999999,PAYMENT, 
971502153350,02/07/2018,Mckee PLC,,1233.67,4879.369999999999,POS, 
971502153350,04/07/2018,Bowen-Anderson,,685.67,4193.699999999999,POS, 
971502153350,06/07/2018,Blackwell Gilbert and Owens,591.88,,4785.579999999999,ATM, 
971502153350,08/07/2018,74667942837073 ADAMS CROSBY AND JOHNSON ,,1693.78,3091.7999999999993,ATM, 
971502153350,09/07/2018,50067543344073 LOPEZ-GLASS ,,566.23,2525.5699999999993,POS, 
971502153350,09/07/2018,Baxter-Gonzalez,1602.25,,4127.82,OTHER, 
971502153350,11/07/2018,Morris Group,891.0,,5018.82,OTHER, 
971502153350,12/07/2018,388253938896779 HALL HALE AND JOSEPH ,,351.44,4667.38,ATM, 
971502153350,12/07/2018,Greene Group,,752.78,3914.6000000000004,PAYMENT, 
971502153350,12/07/2018,Kelley Vaughn and Robertson,,1065.11,2849.4900000000007,ATM, 
971502153350,15/07/2018,383581900233195 VALDEZ-KNIGHT ,,1905.84,943.6500000000008,OTHER, 
971502153350,15/07/2018,Malone Inc,,1299.41,-355.7599999999993,ATM, 
971502153350,17/07/2018,642409925840332 JONES PLC ,1825.65,,1469.8900000000008,PAYMENT, 
971502153350,17/07/2018,Alvarado Group,,1809.78,-339.8899999999992,PAYMENT, 
971502153350,19/07/2018,Everett Group,,1611.06,-1950.9499999999991,ATM, 
971502153350,21/07/2018,856569211107619 MILLER LLC ,325.7,,-1625.249999999999,PAYMENT, 
971502153350,24/07/2018,389380039884703 TODD-WU ,744.47,,-880.7799999999991,OTHER, 
971502153350,25/07/2018,Torres Snyder and Robinson,,896.45,-1777.229999999999,OTHER, 
971502153350,27/07/2018,Thompson Group,837.4,,-939.8299999999991,OTHER, 
971502153350,28/07/2018,Merritt Mckenzie and Ruiz,520.17,,-419.6599999999992,PAYMENT, 
971502153350,31/07/2018,Blackwell-Johnson,,1320.13,-1739.7899999999993,POS, 
971502153350,31/07/2018,Carter Brown and Cervantes,382.65,,-1357.1399999999994,ATM, 
971502153350,03/08/2018,608509493416390 WRIGHT LLC ,,49.33,-1406.4699999999993,PAYMENT, 
971502153350,04/08/2018,720639160544376 HOWE JOHNSON AND COLLINS ,482.22,,-924.2499999999993,OTHER, 
971502153350,06/08/2018,353852230779937 TUCKER-ROSS ,612.61,,-311.6399999999993,OTHER, 
971502153350,07/08/2018,795219620049967 RHODES NEWMAN AND SCOTT ,,1769.98,-2081.6199999999994,OTHER, 
971502153350,08/08/2018,603299136727308 EVANS AND SONS ,,1674.91,-3756.5299999999997,PAYMENT, 
971502153350,08/08/2018,615242593775815 LONG GROUP ,1768.7,,-1987.8299999999997,OTHER, 
971502153350,10/08/2018,Myers Chavez and Rose,,1762.08,-3749.91,OTHER, 
971502153350,12/08/2018,Herrera Paul and Miller,583.1,,-3166.81,OTHER, 
971502153350,13/08/2018,Chavez Perkins and Nicholson,,1412.37,-4579.18,OTHER, 
971502153350,16/08/2018,Santos Ltd,,1207.68,-5786.860000000001,PAYMENT, 
971502153350,17/08/2018,Silva Inc,389.19,,-5397.670000000001,OTHER, 
971502153350,20/08/2018,30343754857481 SANCHEZ-KELLY ,,1688.51,-7086.180000000001,ATM, 
971502153350,23/08/2018,Matthews-Walsh,877.83,,-6208.350000000001,PAYMENT, 
971502153350,26/08/2018,Lee PLC,,851.98,-7060.330000000002,POS, 
971502153350,27/08/2018,784163472998032 QUINN GONZALES AND MOSS ,,670.42,-7730.750000000002,POS, 
971502153350,29/08/2018,Johnson Aguilar and Castaneda,,1912.1,-9642.850000000002,ATM, 
971502153350,01/09/2018,266064041588528 CLAY-JOHNSON ,,621.5,-10264.350000000002,OTHER, 
971502153350,01/09/2018,Mueller-Grimes,1256.17,,-9008.180000000002,ATM, 
971502153350,03/09/2018,49622470306341 NICHOLS ROBERTSON AND BROWN ,1543.46,,-7464.720000000002,POS, 
971502153350,05/09/2018,Ferguson Jones and Valentine,,1644.74,-9109.460000000003,PAYMENT, 
971502153350,06/09/2018,Jones-Jones,1627.51,,-7481.950000000003,ATM, 
971502153350,06/09/2018,878765250055980 SMITH-MANN ,,815.56,-8297.510000000002,ATM, 
971502153350,09/09/2018,Stewart and Sons,862.87,,-7434.640000000002,ATM, 
971502153350,09/09/2018,Rivera-Kirby,,1399.67,-8834.310000000001,PAYMENT, 
971502153350,09/09/2018,727720088939502 HOPKINS OBRIEN AND WALTERS ,,1271.09,-10105.400000000001,OTHER, 
971502153350,09/09/2018,Merritt-Phillips,,516.28,-10621.680000000002,POS, 
971502153350,09/09/2018,95983783791074 CASTANEDA LTD ,1228.52,,-9393.160000000002,ATM, 
971502153350,11/09/2018,445142659005247 BARNES-JORDAN ,,1787.36,-11180.520000000002,OTHER, 
971502153350,11/09/2018,Callahan and Sons,,1709.03,-12889.550000000003,PAYMENT, 
971502153350,13/09/2018,Stevens-Butler,1573.26,,-11316.290000000003,POS, 
971502153350,15/09/2018,Henry Anderson and King,748.63,,-10567.660000000003,PAYMENT, 
971502153350,15/09/2018,515845619755217 SMITH OCONNOR AND SUTTON ,,1745.29,-12312.950000000004,PAYMENT, 
971502153350,16/09/2018,893369897705909 JONES-PARRISH ,567.18,,-11745.770000000004,ATM, 
971502153350,16/09/2018,Mcintyre Ltd,1560.5,,-10185.270000000004,ATM, 
971502153350,19/09/2018,999525444440670 JORDAN-DAVENPORT ,88.98,,-10096.290000000005,POS, 
971502153350,22/09/2018,646675844623645 HERNANDEZ PORTER AND YOUNG ,,289.09,-10385.380000000005,PAYMENT, 
971502153350,23/09/2018,639777528432788 COOPER LLC ,,1011.26,-11396.640000000005,PAYMENT, 
971502153350,26/09/2018,Lewis Evans and Hamilton,958.92,,-10437.720000000005,PAYMENT, 
971502153350,27/09/2018,Allen-Lopez,,463.63,-10901.350000000004,POS, 
971502153350,28/09/2018,Walsh-Bentley,453.55,,-10447.800000000005,POS, 
971502153350,30/09/2018,Murray LLC,1793.66,,-8654.140000000005,PAYMENT, 
971502153350,02/10/2018,Martinez Barnett and Thomas,,229.24,-8883.380000000005,POS, 
971502153350,05/10/2018,360282445403345 HATFIELD-ANDERSON ,1209.97,,-7673.410000000004,POS, 
971502153350,05/10/2018,Campbell-Morris,,683.09,-8356.500000000004,OTHER, 
971502153350,05/10/2018,Miller Ltd,1444.71,,-6911.790000000004,POS, 
971502153350,06/10/2018,Calhoun-Osborne,,1438.96,-8350.750000000004,PAYMENT, 
971502153350,07/10/2018,Walker PLC,1533.17,,-6817.580000000004,OTHER, 
971502153350,10/10/2018,445982886729995 AGUILAR WALKER AND BROOKS ,,1814.16,-8631.740000000003,POS, 
971502153350,10/10/2018,Fleming LLC,,1566.35,-10198.090000000004,ATM, 
971502153350,12/10/2018,990158177707500 WHITE KIDD AND WOLFE ,,9.53,-10207.620000000004,OTHER, 
971502153350,12/10/2018,714733497653211 PETERSON GROUP ,,83.62,-10291.240000000005,OTHER, 
971502153350,15/10/2018,French Inc,47.14,,-10244.100000000006,OTHER, 
971502153350,16/10/2018,318567510387426 HARRELL SANFORD AND THOMPSON ,1863.27,,-8380.830000000005,PAYMENT, 
971502153350,17/10/2018,Garcia Dunn and Hendrix,1863.91,,-6516.9200000000055,POS, 
971502153350,18/10/2018,Woods Inc,24.98,,-6491.940000000006,OTHER, 
971502153350,21/10/2018,388366163736574 GREEN RUIZ AND JENNINGS ,,909.11,-7401.050000000006,OTHER, 
971502153350,22/10/2018,924983541635806 HARPER INC ,,935.98,-8337.030000000006,POS, 
971502153350,23/10/2018,720570710621484 BALDWIN AND SONS ,,1485.31,-9822.340000000006,POS, 
971502153350,24/10/2018,29861211531238 RODRIGUEZ PLC ,842.28,,-8980.060000000005,ATM, 
971502153350,24/10/2018,Gonzales-Floyd,237.61,,-8742.450000000004,POS, 
971502153350,24/10/2018,34746227645967 RAMIREZ LLC ,,508.95,-9251.400000000005,PAYMENT, 
971502153350,27/10/2018,Davis-Saunders,,1864.78,-11116.180000000006,OTHER, 
971502153350,27/10/2018,Pierce Reilly and Vargas,,845.27,-11961.450000000006,ATM, 
971502153350,29/10/2018,528252818374940 ROBERTS PHILLIPS AND CERVANTES ,960.85,,-11000.600000000006,OTHER, 
971502153350,30/10/2018,Dudley-Oconnor,1936.19,,-9064.410000000005,ATM, 
971502153350,31/10/2018,Moreno Ltd,,601.31,-9665.720000000005,OTHER, 
971502153350,01/11/2018,Mcknight-Schultz,,1193.03,-10858.750000000005,ATM, 
971502153350,02/11/2018,572447410405433 HENSLEY PLC ,1258.47,,-9600.280000000006,PAYMENT, 
971502153350,05/11/2018,Mclean-Lam,,363.39,-9963.670000000006,PAYMENT, 
971502153350,05/11/2018,Klein Reid and Martinez,507.89,,-9455.780000000006,ATM, 
971502153350,08/11/2018,614404372819641 BOOKER-SCOTT ,,870.52,-10326.300000000007,ATM, 
971502153350,08/11/2018,Davis LLC,512.81,,-9813.490000000007,OTHER, 
971502153350,09/11/2018,Williams and Sons,1276.0,,-8537.490000000007,PAYMENT, 
971502153350,11/11/2018,524467255033559 NEWMAN-GREGORY ,,350.1,-8887.590000000007,OTHER, 
971502153350,11/11/2018,658191367538889 TURNER PLC ,,485.26,-9372.850000000008,ATM, 
971502153350,12/11/2018,576342232594315 WADE RIVERA AND FULLER ,419.1,,-8953.750000000007,POS, 
971502153350,13/11/2018,Long PLC,97.12,,-8856.630000000006,POS, 
971502153350,13/11/2018,Daniels Inc,1150.18,,-7706.450000000006,OTHER, 
971502153350,16/11/2018,854064797191239 BONILLA GROUP ,1747.12,,-5959.330000000006,ATM, 
971502153350,16/11/2018,Levine Group,,431.67,-6391.000000000006,OTHER, 
971502153350,17/11/2018,Anderson Garcia and Jenkins,1609.16,,-4781.8400000000065,PAYMENT, 
971502153350,20/11/2018,28273164806806 MILLER LTD ,629.15,,-4152.690000000007,ATM, 
971502153350,21/11/2018,16802307126936 RODRIGUEZ-MEYER ,,765.54,-4918.230000000007,PAYMENT, 
971502153350,22/11/2018,736237356036 WASHINGTON-KENNEDY ,,1550.91,-6469.140000000007,POS, 
971502153350,22/11/2018,451091274899486 COLE-HUFFMAN ,,491.3,-6960.440000000007,PAYMENT, 
971502153350,25/11/2018,765261103941144 RODRIGUEZ-BROWN ,1355.7,,-5604.740000000007,ATM, 
971502153350,25/11/2018,921348188293653 SCOTT GROUP ,,475.59,-6080.330000000007,PAYMENT, 
971502153350,27/11/2018,Walker Anderson and Charles,,1931.58,-8011.910000000007,PAYMENT, 
971502153350,30/11/2018,359261869991001 HOPKINS GROUP ,1903.5,,-6108.410000000007,POS, 
971502153350,02/12/2018,694202965591029 MCKINNEY-TRAVIS ,,1021.23,-7129.640000000007,ATM, 
971502153350,02/12/2018,892980409492806 MCDANIEL RICHARDS AND VALDEZ ,,407.29,-7536.930000000007,POS, 
971502153350,04/12/2018,62969066812106 JOHNSON PETERSON AND RICHARDSON ,,804.6,-8341.530000000006,POS, 
971502153350,04/12/2018,Stark-Keith,,595.91,-8937.440000000006,OTHER, 
971502153350,04/12/2018,654548099825779 ALLEN-BENDER ,1652.54,,-7284.900000000006,OTHER, 
971502153350,05/12/2018,508898285632258 BLACK MEYERS AND MCKINNEY ,,207.86,-7492.760000000006,PAYMENT, 
971502153350,07/12/2018,756560421453224 PARKER-JOHNSON ,594.15,,-6898.610000000006,PAYMENT, 
971502153350,08/12/2018,Clark Mullen and Montgomery,92.21,,-6806.400000000006,OTHER, 
971502153350,10/12/2018,Dunlap Williams and Gregory,,994.54,-7800.940000000006,POS, 
971502153350,10/12/2018,860797704839664 EDWARDS PLC ,290.88,,-7510.060000000006,ATM, 
971502153350,10/12/2018,Allen LLC,,899.29,-8409.350000000006,PAYMENT, 
971502153350,10/12/2018,355299305963986 WEST JACKSON AND ERICKSON ,1035.99,,-7373.360000000006,PAYMENT, 
971502153350,10/12/2018,Owens Ltd,782.01,,-6591.350000000006,POS, 
971502153350,11/12/2018,857154689806936 WILLIAMS BENSON AND GOMEZ ,,390.67,-6982.020000000006,POS, 
971502153350,14/12/2018,462105927555733 SUTTON GUTIERREZ AND HUANG ,,1532.41,-8514.430000000006,POS, 
971502153350,15/12/2018,Holmes Ltd,1974.21,,-6540.220000000006,PAYMENT, 
971502153350,16/12/2018,950399896615122 ONEAL SMITH AND NELSON ,369.64,,-6170.580000000005,OTHER, 
971502153350,16/12/2018,237883925773715 RODRIGUEZ-RODRIGUEZ ,851.02,,-5319.560000000005,OTHER, 
971502153350,17/12/2018,Bass and Sons,1437.13,,-3882.430000000005,ATM, 
971502153350,19/12/2018,222772102627371 GRAY JAMES AND PAYNE ,,1697.16,-5579.590000000005,ATM, 
971502153350,19/12/2018,892690318404141 BOONE GROUP ,1160.45,,-4419.140000000005,ATM, 
971502153350,20/12/2018,750614075079831 ROSARIO ARMSTRONG AND LINDSEY ,,1743.31,-6162.450000000004,PAYMENT, 
971502153350,21/12/2018,Khan-Ramos,,1160.8,-7323.250000000005,OTHER, 
971502153350,22/12/2018,Gordon Cameron and Mullins,1450.08,,-5873.170000000005,ATM, 
971502153350,23/12/2018,92692269796989 CLARKE-WILLIAMS ,1173.06,,-4700.110000000004,OTHER, 
971502153350,25/12/2018,Robinson-Marsh,732.85,,-3967.2600000000043,ATM, 
971502153350,25/12/2018,926043595709935 SPARKS RUIZ AND MOORE ,,154.73,-4121.990000000004,OTHER, 
971502153350,27/12/2018,797487641654736 MARTIN BROWN AND GARRETT ,1170.85,,-2951.1400000000044,POS, 
971502153350,29/12/2018,202126084651715 SCHROEDER LLC ,,446.94,-3398.0800000000045,OTHER, 
971502153350,01/01/2019,Wood-Rivera,406.25,,-2991.8300000000045,OTHER, 
971502153350,03/01/2019,811956791535704 BARTON LTD ,,491.67,-3483.5000000000045,POS, 
971502153350,06/01/2019,Austin and Sons,,1914.83,-5398.3300000000045,ATM, 
971502153350,09/01/2019,Young Paul and Ward,1119.15,,-4279.180000000004,ATM, 
971502153350,12/01/2019,311046053288548 WILSON PLC ,1453.56,,-2825.620000000004,ATM, 
971502153350,15/01/2019,709381250541574 BENNETT-MARTINEZ ,542.07,,-2283.550000000004,OTHER, 
971502153350,15/01/2019,351666871128921 VEGA JOHNSON AND DEAN ,479.86,,-1803.6900000000037,PAYMENT, 
971502153350,17/01/2019,Melton and Sons,1366.26,,-437.4300000000037,POS, 
971502153350,17/01/2019,Burton Brooks and Smith,530.46,,93.02999999999633,POS, 
971502153350,17/01/2019,Fleming Salinas and Carrillo,1871.13,,1964.1599999999964,ATM, 
971502153350,20/01/2019,Livingston-Smith,1764.33,,3728.489999999996,PAYMENT, 
971502153350,20/01/2019,480505652467556 BALL LTD ,,1496.92,2231.569999999996,OTHER, 
971502153350,22/01/2019,Gonzales-White,1921.1,,4152.669999999996,OTHER, 
971502153350,24/01/2019,518716171780563 JOHNSON-CAMPBELL ,829.3,,4981.969999999997,ATM, 
971502153350,24/01/2019,Powers and Sons,,680.55,4301.419999999996,POS, 
971502153350,24/01/2019,594009096376711 FOSTER FROST AND KELLY ,1331.28,,5632.699999999996,POS, 
971502153350,25/01/2019,Johnson Munoz and Johnson,,1682.25,3950.449999999996,POS, 
971502153350,25/01/2019,576083941578160 DUNCAN NELSON AND HANNA ,564.25,,4514.699999999996,PAYMENT, 
971502153350,25/01/2019,106165379369853 ACEVEDO INC ,,1205.72,3308.979999999996,POS, 
971502153350,27/01/2019,837675824575481 PINEDA ANDERSON AND NGUYEN ,,1571.73,1737.249999999996,PAYMENT, 
971502153350,29/01/2019,Rubio-Cline,1498.73,,3235.979999999996,OTHER, 
971502153350,31/01/2019,Herrera Donovan and Arellano,1205.39,,4441.369999999996,ATM, 
971502153350,03/02/2019,846680297085399 WALTERS WARD AND FLETCHER ,,1562.25,2879.1199999999963,ATM, 
971502153350,04/02/2019,Randall and Sons,1609.28,,4488.399999999996,ATM, 
971502153350,05/02/2019,541906161957593 MYERS ANDERSON AND ANDREWS ,,1488.95,2999.449999999996,ATM, 
971502153350,06/02/2019,Charles-Keith,,794.96,2204.489999999996,OTHER, 
971502153350,08/02/2019,Petersen-Cooper,390.8,,2595.2899999999963,PAYMENT, 
971502153350,10/02/2019,Golden Solomon and Johnson,74.12,,2669.409999999996,ATM, 
971502153350,11/02/2019,Stewart Mendez and Hopkins,,784.4,1885.0099999999961,ATM, 
971502153350,12/02/2019,522040716217588 CRAIG-CHURCH ,,1250.05,634.9599999999962,OTHER, 
971502153350,14/02/2019,Johnson Ltd,,1022.94,-387.9800000000039,OTHER, 
971502153350,14/02/2019,649119289615357 ALLEN-NELSON ,716.63,,328.6499999999961,OTHER, 
971502153350,14/02/2019,Cunningham Group,1923.16,,2251.8099999999963,ATM, 
971502153350,14/02/2019,996198349781827 LOPEZ-MORENO ,357.13,,2608.9399999999964,PAYMENT, 
971502153350,16/02/2019,Schneider PLC,,1486.24,1122.6999999999964,ATM, 
971502153350,17/02/2019,Martinez-Ayala,,604.42,518.2799999999964,POS, 
971502153350,17/02/2019,787344966694786 FERGUSON-GALLOWAY ,,1390.16,-871.8800000000036,PAYMENT, 
971502153350,19/02/2019,Powell Ltd,,1402.03,-2273.9100000000035,OTHER, 
971502153350,20/02/2019,322840061213755 JENKINS PLC ,1163.73,,-1110.1800000000035,OTHER, 
971502153350,20/02/2019,710602812175051 FRANCIS-KNOX ,206.22,,-903.9600000000034,OTHER, 
971502153350,20/02/2019,15393194833203 WATSON LTD ,,976.8,-1880.7600000000034,POS, 
971502153350,20/02/2019,447305873315624 BROWN-DAVIS ,1542.77,,-337.9900000000034,POS, 
971502153350,22/02/2019,Martinez LLC,1475.4,,1137.4099999999967,OTHER, 
971502153350,24/02/2019,771750552031565 ARROYO-LUCAS ,,1822.81,-685.4000000000033,PAYMENT, 
971502153350,26/02/2019,694495806642005 KELLEY VAZQUEZ AND SPENCER ,,1519.04,-2204.4400000000032,ATM, 
971502153350,01/03/2019,431971062822250 ROBERSON-LEE ,,1766.02,-3970.460000000003,OTHER, 
971502153350,04/03/2019,750133075146296 HOLLAND-WILSON ,1372.86,,-2597.600000000003,OTHER, 
971502153350,07/03/2019,71071708708069 HERNANDEZ PITTMAN AND FREEMAN ,,1284.99,-3882.590000000003,PAYMENT, 
971502153350,07/03/2019,532463084319343 LEE FAULKNER AND DAVIS ,,1204.37,-5086.960000000003,OTHER, 
971502153350,10/03/2019,Dillon Duffy and Parker,,960.19,-6047.150000000003,POS, 
971502153350,11/03/2019,Adams Jennings and Edwards,53.61,,-5993.540000000004,OTHER, 
971502153350,13/03/2019,735945036296988 MORGAN MORALES AND CASTILLO ,,1244.62,-7238.1600000000035,PAYMENT, 
971502153350,13/03/2019,377214779937244 TAYLOR ROLLINS AND JOHNSON ,,1738.46,-8976.620000000003,ATM, 
971502153350,15/03/2019,Cooper Williams and Glover,,1174.24,-10150.860000000002,POS, 
971502153350,17/03/2019,94331985758294 CHRISTENSEN THOMPSON AND RAY ,1143.72,,-9007.140000000003,PAYMENT, 
971502153350,17/03/2019,873184426692676 GREEN TRAN AND HILL ,,1765.67,-10772.810000000003,ATM, 
971502153350,20/03/2019,Gilmore-Smith,,1044.13,-11816.940000000002,PAYMENT, 
971502153350,21/03/2019,Brown-Sanchez,,1114.82,-12931.760000000002,POS, 
971502153350,23/03/2019,Hart Inc,,311.92,-13243.680000000002,POS, 
971502153350,26/03/2019,130198264141862 STEWART PENA AND MCCARTHY ,799.81,,-12443.870000000003,PAYMENT, 
971502153350,28/03/2019,574232848871636 FERGUSON GROUP ,1505.39,,-10938.480000000003,OTHER, 
971502153350,29/03/2019,Burke Mitchell and Robbins,,1511.38,-12449.860000000004,PAYMENT, 
971502153350,31/03/2019,Snyder Liu and Carpenter,1876.8,,-10573.060000000005,POS, 
971502153350,31/03/2019,483840071161607 JAMES LLC ,,563.99,-11137.050000000005,POS, 
971502153350,01/04/2019,Gutierrez Rivera and Luna,307.45,,-10829.600000000004,ATM, 
971502153350,02/04/2019,625695787660063 RAY WILSON AND SAWYER ,,499.15,-11328.750000000004,PAYMENT, 
971502153350,03/04/2019,Norton Rodriguez and Kelly,,1124.19,-12452.940000000004,POS, 
971502153350,03/04/2019,675901083247270 CRAWFORD CARRILLO AND STEVENSON ,,1111.23,-13564.170000000004,POS, 
971502153350,06/04/2019,Thompson-Rodriguez,1594.33,,-11969.840000000004,ATM, 
971502153350,09/04/2019,Schaefer-Johnson,1164.64,,-10805.200000000004,PAYMENT, 
971502153350,09/04/2019,957463933079141 NELSON GILES AND LEVY ,406.32,,-10398.880000000005,OTHER, 
971502153350,10/04/2019,Bailey Marshall and Nielsen,,364.35,-10763.230000000005,OTHER, 
971502153350,11/04/2019,Novak Green and Hendricks,1152.38,,-9610.850000000006,ATM, 
971502153350,13/04/2019,382077642097937 MALONE-BURNS ,115.33,,-9495.520000000006,POS, 
971502153350,16/04/2019,5963064656783 JENKINS-BROWN ,,412.07,-9907.590000000006,OTHER, 
971502153350,18/04/2019,360925229239319 TUCKER TRAN AND WILLIAMSON ,,86.72,-9994.310000000005,ATM, 
971502153350,18/04/2019,719685530423832 VILLARREAL-JACOBS ,1768.52,,-8225.790000000005,OTHER, 
971502153350,21/04/2019,16310786280531 HUDSON ALVAREZ AND BENDER ,558.56,,-7667.230000000005,OTHER, 
971502153350,23/04/2019,424318699967547 ANDERSON HOLLOWAY AND FARMER ,,929.71,-8596.940000000006,PAYMENT, 
971502153350,24/04/2019,Snyder-Townsend,722.95,,-7873.990000000006,PAYMENT, 
971502153350,27/04/2019,280485703489495 HICKS-RODRIGUEZ ,379.22,,-7494.770000000006,ATM, 
971502153350,29/04/2019,Kelly-Roach,154.96,,-7339.810000000006,ATM, 
971502153350,30/04/2019,628858233610197 VAZQUEZ-WRIGHT ,554.34,,-6785.470000000006,PAYMENT, 
971502153350,02/05/2019,383782516068874 HOFFMAN GREENE AND WILSON ,,1723.26,-8508.730000000005,POS, 
971502153350,03/05/2019,186527620823996 ROBERTS LTD ,,1387.68,-9896.410000000005,OTHER, 
971502153350,06/05/2019,558561467423956 FLEMING AND SONS ,,1546.73,-11443.140000000005,PAYMENT, 
971502153350,08/05/2019,Clark Haynes and Sullivan,583.71,,-10859.430000000004,OTHER, 
971502153350,09/05/2019,Roberson LLC,,1034.94,-11894.370000000004,POS, 
971502153350,09/05/2019,Welch Gonzales and Norman,,1309.2,-13203.570000000005,POS, 
971502153350,09/05/2019,Rosales-Walker,362.89,,-12840.680000000006,ATM, 
971502153350,10/05/2019,894417878486122 PINEDA PLC ,638.42,,-12202.260000000006,OTHER, 
971502153350,13/05/2019,949576738950952 MOORE-NELSON ,,604.41,-12806.670000000006,OTHER, 
971502153350,15/05/2019,884750025108285 FERGUSON LARSON AND MARKS ,,319.73,-13126.400000000005,OTHER, 
971502153350,15/05/2019,Aguilar Taylor and Riley,1688.14,,-11438.260000000006,ATM, 
971502153350,17/05/2019,719020965647875 DAVIS AND SONS ,907.61,,-10530.650000000005,PAYMENT, 
971502153350,17/05/2019,Turner LLC,1463.86,,-9066.790000000005,POS, 
971502153350,17/05/2019,364007523063572 SUTTON SCHULTZ AND PHILLIPS ,802.77,,-8264.020000000004,ATM, 
971502153350,18/05/2019,Leonard Glass and Robertson,1202.24,,-7061.780000000004,POS, 
971502153350,19/05/2019,637234227639868 WILLIAMS AND SONS ,1501.21,,-5560.570000000004,OTHER, 
971502153350,19/05/2019,399769474890257 GILBERT OLSON AND RICE ,756.58,,-4803.990000000004,POS, 
971502153350,22/05/2019,Marshall-Oliver,,295.47,-5099.460000000005,ATM, 
971502153350,22/05/2019,556245285777609 ROSS INC ,,1918.14,-7017.600000000005,PAYMENT, 
971502153350,24/05/2019,86149985188946 LAWSON-SWANSON ,,1383.49,-8401.090000000006,ATM, 
971502153350,25/05/2019,828933517166133 HAMILTON AND SONS ,109.98,,-8291.110000000006,ATM, 
971502153350,25/05/2019,131602962769736 ZUNIGA GROUP ,,1167.5,-9458.610000000006,OTHER, 
971502153350,25/05/2019,790634772199282 GIBSON-ABBOTT ,1489.64,,-7968.970000000006,POS, 
971502153350,28/05/2019,751641533055451 GOODWIN PLC ,,69.89,-8038.860000000006,POS, 
971502153350,31/05/2019,796546200216643 PORTER LLC ,,1132.26,-9171.120000000006,ATM, 
971502153350,03/06/2019,313012539201444 FORD GROUP ,,1708.07,-10879.190000000006,OTHER, 
971502153350,05/06/2019,395067484916964 CARTER-YANG ,,440.35,-11319.540000000006,POS, 
971502153350,05/06/2019,258552991332122 ANDREWS PLC ,915.72,,-10403.820000000007,POS, 
971502153350,05/06/2019,Rice and Sons,1672.63,,-8731.190000000006,OTHER, 
971502153350,05/06/2019,Hall Group,,624.58,-9355.770000000006,PAYMENT, 
971502153350,06/06/2019,382601120729475 SULLIVAN JACKSON AND TAYLOR ,,532.12,-9887.890000000007,POS, 
971502153350,07/06/2019,121725193056298 NAVARRO FRYE AND WHITE ,1419.67,,-8468.220000000007,PAYMENT, 
971502153350,09/06/2019,Thomas PLC,,1954.06,-10422.280000000006,OTHER, 
971502153350,10/06/2019,Molina LLC,,1287.81,-11710.090000000006,PAYMENT, 
971502153350,10/06/2019,818138272838749 MCDONALD MENDOZA AND CALLAHAN ,,1203.07,-12913.160000000005,ATM, 
971502153350,12/06/2019,126539357586348 JONES STEPHENS AND SMITH ,454.34,,-12458.820000000005,PAYMENT, 
971502153350,13/06/2019,May Inc,,1009.78,-13468.600000000006,OTHER, 
971502153350,14/06/2019,Kelly-Wilson,,448.22,-13916.820000000005,POS, 
971502153350,14/06/2019,550820797274143 CHAPMAN PLC ,435.93,,-13480.890000000005,OTHER, 
971502153350,15/06/2019,728575300047001 BAKER MICHAEL AND ROBLES ,,1622.16,-15103.050000000005,PAYMENT, 
971502153350,16/06/2019,Ballard Gomez and Lopez,,255.93,-15358.980000000005,OTHER, 
971502153350,16/06/2019,Walker LLC,,313.86,-15672.840000000006,OTHER, 
971502153350,18/06/2019,Wiggins-Williams,1096.27,,-14576.570000000005,POS, 
971502153350,20/06/2019,893432746448857 WILLIAMS-ACEVEDO ,1437.04,,-13139.530000000006,PAYMENT, 
971502153350,22/06/2019,165678468804998 TAYLOR-PATTERSON ,910.35,,-12229.180000000006,ATM, 
971502153350,24/06/2019,334411873623305 MORALES-SANCHEZ ,,719.7,-12948.880000000006,PAYMENT, 
971502153350,27/06/2019,983436465288366 SALAZAR-MCDONALD ,,827.16,-13776.040000000006,ATM, 
971502153350,30/06/2019,Brown Inc,1695.66,,-12080.380000000006,ATM, 
971502153350,01/07/2019,Green-Macdonald,454.75,,-11625.630000000006,PAYMENT, 
971502153350,03/07/2019,33160792449620 ANDERSON AND SONS ,530.55,,-11095.080000000007,ATM, 
971502153350,06/07/2019,802686412072400 AYERS-GONZALEZ ,,1157.77,-12252.850000000008,ATM, 
971502153350,07/07/2019,Scott Ltd,,517.5,-12770.350000000008,OTHER, 
971502153350,09/07/2019,Lozano Ltd,831.27,,-11939.080000000007,PAYMENT, 
971502153350,10/07/2019,19947012430432 FISHER AND SONS ,1617.25,,-10321.830000000007,POS, 
971502153350,11/07/2019,917008634464026 GRAHAM AND SONS ,,1534.78,-11856.610000000008,OTHER, 
971502153350,13/07/2019,903511264006738 EDWARDS-ROACH ,1944.01,,-9912.600000000008,ATM, 
971502153350,16/07/2019,Parker-Reeves,,1135.17,-11047.770000000008,OTHER, 
971502153350,17/07/2019,573550179079617 WRIGHT-NUNEZ ,1702.21,,-9345.560000000009,POS, 
971502153350,18/07/2019,230645204248587 TAYLOR HUGHES AND BARKER ,970.24,,-8375.320000000009,OTHER, 
971502153350,18/07/2019,903392172828741 HENRY LTD ,245.57,,-8129.750000000009,PAYMENT, 
971502153350,18/07/2019,Riggs Wilkerson and Combs,1599.67,,-6530.080000000009,POS, 
971502153350,18/07/2019,Tyler Williams and Alexander,,1414.1,-7944.180000000009,OTHER, 
971502153350,21/07/2019,190887530369254 DAWSON-RAMIREZ ,,486.26,-8430.44000000001,PAYMENT, 
971502153350,22/07/2019,128333403436766 SMITH GROUP ,,1213.12,-9643.560000000009,OTHER, 
971502153350,23/07/2019,Cordova-Johnson,,1107.01,-10750.570000000009,PAYMENT, 
971502153350,24/07/2019,758681460632914 WAGNER LLC ,,434.55,-11185.120000000008,POS, 
971502153350,24/07/2019,666489900431623 KNIGHT-MENDEZ ,612.01,,-10573.110000000008,OTHER, 
971502153350,26/07/2019,371444361463826 SIMMONS-PEREZ ,365.03,,-10208.080000000007,OTHER, 
971502153350,29/07/2019,738181646223556 TAYLOR DOMINGUEZ AND SANTIAGO ,1202.88,,-9005.200000000008,OTHER, 
971502153350,30/07/2019,Jones-Cannon,997.45,,-8007.750000000008,PAYMENT, 
971502153350,31/07/2019,Johnson-Lopez,1738.33,,-6269.420000000008,ATM, 
971502153350,02/08/2019,Walker Peck and Carney,,580.63,-6850.050000000008,OTHER, 
971502153350,05/08/2019,88265125669328 TERRELL-SNYDER ,273.87,,-6576.1800000000085,PAYMENT, 
971502153350,06/08/2019,Mullins-Fitzpatrick,,682.88,-7259.060000000009,PAYMENT, 
971502153350,09/08/2019,Floyd Group,47.44,,-7211.620000000009,OTHER, 
971502153350,10/08/2019,Murray-Andrews,,1010.58,-8222.20000000001,OTHER, 
971502153350,11/08/2019,485935798941934 KIM-UNDERWOOD ,,649.49,-8871.69000000001,ATM, 
971502153350,14/08/2019,Smith Ltd,1465.79,,-7405.90000000001,PAYMENT, 
971502153350,16/08/2019,Shannon LLC,,260.87,-7666.7700000000095,OTHER, 
971502153350,18/08/2019,791791911648100 GUZMAN MOORE AND LEE ,1551.71,,-6115.0600000000095,ATM, 
971502153350,20/08/2019,Villanueva-Clark,449.82,,-5665.24000000001,ATM, 
971502153350,20/08/2019,Ferguson-Webb,1484.23,,-4181.010000000009,OTHER, 
971502153350,21/08/2019,Lopez Group,,1606.7,-5787.710000000009,POS, 
971502153350,22/08/2019,Anderson-Carney,382.8,,-5404.910000000009,PAYMENT, 
971502153350,24/08/2019,312806704188832 JACKSON-STEPHENS ,1835.82,,-3569.0900000000092,PAYMENT, 
971502153350,27/08/2019,Mcmillan-Smith,,897.89,-4466.98000000001,PAYMENT, 
971502153350,27/08/2019,265468481471989 WOODS SANCHEZ AND MCCLURE ,,1215.24,-5682.220000000009,ATM, 
971502153350,30/08/2019,White-Ramos,,1875.82,-7558.040000000009,OTHER, 
971502153350,31/08/2019,Horton-Wheeler,,1239.21,-8797.25000000001,POS, 
971502153350,01/09/2019,161124073415856 PRATT LTD ,1478.28,,-7318.970000000009,ATM, 
971502153350,03/09/2019,466058444377778 TAYLOR VALDEZ AND HART ,,324.08,-7643.050000000009,PAYMENT, 
971502153350,03/09/2019,Jackson Simon and Lopez,,547.82,-8190.870000000009,OTHER, 
971502153350,05/09/2019,Rodgers-Wilson,184.25,,-8006.620000000009,PAYMENT, 
971502153350,08/09/2019,955573199407581 RIOS LTD ,,1516.73,-9523.35000000001,ATM, 
971502153350,09/09/2019,485965285233962 CURTIS LLC ,,323.74,-9847.09000000001,PAYMENT, 
971502153350,09/09/2019,785608347019495 SILVA MITCHELL AND MONTES ,,906.17,-10753.26000000001,POS, 
971502153350,10/09/2019,Lee Tucker and Snyder,,875.21,-11628.470000000008,OTHER, 
971502153350,13/09/2019,347919934966540 WHITNEY QUINN AND MORRISON ,,1736.09,-13364.560000000009,POS, 
971502153350,14/09/2019,Poole-Evans,,841.26,-14205.820000000009,POS, 
971502153350,15/09/2019,Lee and Sons,1606.99,,-12598.830000000009,OTHER, 
971502153350,17/09/2019,Fleming Group,,1511.16,-14109.990000000009,ATM, 
971502153350,19/09/2019,418465348569069 HESS INC ,1598.78,,-12511.210000000008,POS, 
971502153350,19/09/2019,661674102510701 YATES PLC ,,1574.7,-14085.910000000009,OTHER, 
971502153350,21/09/2019,Owens Ltd,60.6,,-14025.310000000009,PAYMENT, 
971502153350,22/09/2019,689177982475426 GONZALEZ-SMITH ,1318.64,,-12706.67000000001,PAYMENT, 
971502153350,22/09/2019,74361576395529 VAUGHN-JOHNSON ,1445.0,,-11261.67000000001,OTHER, 
971502153350,22/09/2019,235594917070748 RODRIGUEZ LTD ,,1734.11,-12995.78000000001,POS, 
971502153350,22/09/2019,318812716893307 WHITE AND SONS ,373.87,,-12621.910000000009,POS, 
971502153350,24/09/2019,Smith Harris and Johnson,1294.8,,-11327.11000000001,PAYMENT, 
971502153350,24/09/2019,181234244704811 BALL-MILLS ,891.91,,-10435.20000000001,PAYMENT, 
971502153350,27/09/2019,343774341924232 MCCULLOUGH MILLER AND LEE ,1094.04,,-9341.16000000001,OTHER, 
971502153350,28/09/2019,768661405498172 HERNANDEZ-BARBER ,,1908.19,-11249.350000000011,OTHER, 
971502153350,28/09/2019,Walters Wilson and Myers,,1454.77,-12704.120000000012,ATM, 
971502153350,01/10/2019,Mitchell-Herring,675.86,,-12028.260000000011,POS, 
971502153350,03/10/2019,733751554506839 BAUTISTA-LEWIS ,323.47,,-11704.790000000012,PAYMENT, 
971502153350,04/10/2019,Deleon Cortez and Nelson,,500.1,-12204.890000000012,POS, 
971502153350,05/10/2019,368678098791116 LAMBERT AND SONS ,885.07,,-11319.820000000012,PAYMENT, 
971502153350,06/10/2019,523806363457155 ELLISON-UNDERWOOD ,,1224.54,-12544.360000000011,ATM, 
971502153350,08/10/2019,491328439879797 SOLIS-MATHEWS ,1297.72,,-11246.640000000012,ATM, 
971502153350,09/10/2019,Valdez-Blackwell,1850.6,,-9396.040000000012,OTHER, 
971502153350,09/10/2019,116117494978054 BAKER-CARLSON ,,227.1,-9623.140000000012,PAYMENT, 
971502153350,11/10/2019,Lang Ltd,,393.76,-10016.900000000012,POS, 
971502153350,14/10/2019,Hill Ltd,,1350.54,-11367.440000000013,ATM, 
971502153350,17/10/2019,866962662790008 WADE-SHELTON ,155.2,,-11212.240000000013,POS, 
971502153350,19/10/2019,444804347597638 WADE JENSEN AND JOHNSON ,1198.27,,-10013.970000000012,ATM, 
971502153350,19/10/2019,Banks-Smith,774.94,,-9239.030000000012,POS, 
971502153350,22/10/2019,Cox-Anderson,,130.68,-9369.710000000012,POS, 
971502153350,22/10/2019,Pierce Group,,625.09,-9994.800000000012,PAYMENT, 
971502153350,25/10/2019,Lucas-Lee,,904.0,-10898.800000000012,OTHER, 
971502153350,25/10/2019,Jones Torres and Copeland,,1289.57,-12188.370000000012,OTHER, 
971502153350,28/10/2019,881111882373618 WEST HENDERSON AND KING ,,1889.33,-14077.700000000012,OTHER, 
971502153350,29/10/2019,494429543158005 AUSTIN LLC ,226.8,,-13850.900000000012,PAYMENT, 
971502153350,29/10/2019,790079610006492 JOHNSON LLC ,166.4,,-13684.500000000013,ATM, 
971502153350,29/10/2019,Newton Mason and Martinez,25.33,,-13659.170000000013,OTHER, 
971502153350,31/10/2019,666585039311617 PERKINS-WILKINSON ,70.35,,-13588.820000000012,PAYMENT, 
971502153350,31/10/2019,Cobb-Greene,755.56,,-12833.260000000013,PAYMENT, 
971502153350,01/11/2019,Chen Inc,,1743.95,-14577.210000000014,ATM, 
971502153350,03/11/2019,852811741486464 RIVERS-HORN ,1526.4,,-13050.810000000014,OTHER, 
971502153350,06/11/2019,758866677876831 RAMIREZ-HARDY ,1827.12,,-11223.690000000013,PAYMENT, 
971502153350,06/11/2019,955072502303366 RICHARDSON LLC ,1456.54,,-9767.150000000012,ATM, 
971502153350,08/11/2019,885490215140785 COLE PLC ,779.9,,-8987.250000000013,OTHER, 
971502153350,09/11/2019,648042912532207 JENKINS CLARK AND HARRIS ,,1245.5,-10232.750000000013,ATM, 
971502153350,10/11/2019,Nash Wright and Oneill,930.29,,-9302.460000000014,ATM, 
971502153350,11/11/2019,753599884997419 PHAM-GONZALEZ ,,1752.85,-11055.310000000014,POS, 
971502153350,14/11/2019,985827079560807 AGUILAR-SULLIVAN ,254.55,,-10800.760000000015,POS, 
971502153350,16/11/2019,Griffith Group,,1182.64,-11983.400000000014,POS, 
971502153350,17/11/2019,3824260558190 CLEMENTS-FOSTER ,1589.04,,-10394.360000000015,POS, 
971502153350,19/11/2019,Cobb-Turner,1562.47,,-8831.890000000016,POS, 
971502153350,20/11/2019,414164790765092 MARTIN JOHNSON AND JACKSON ,,1281.98,-10113.870000000015,PAYMENT, 
971502153350,20/11/2019,Cannon-Carter,,200.97,-10314.840000000015,PAYMENT, 
971502153350,20/11/2019,638577079552058 BARNES PLC ,,49.54,-10364.380000000016,PAYMENT, 
971502153350,21/11/2019,Webb Martin and Harrington,941.0,,-9423.380000000016,POS, 
971502153350,24/11/2019,Johnson Johnson and Blackburn,,526.44,-9949.820000000016,POS, 
971502153350,27/11/2019,Yang and Sons,,595.9,-10545.720000000016,PAYMENT, 
971502153350,30/11/2019,Gonzalez Ltd,,424.86,-10970.580000000016,PAYMENT, 
971502153350,03/12/2019,Simpson-Buck,474.82,,-10495.760000000017,POS, 
971502153350,06/12/2019,661959334367013 ACOSTA-JOHNSON ,768.64,,-9727.120000000017,POS, 
971502153350,09/12/2019,892664147171567 YOUNG MILLS AND WHITE ,,1670.63,-11397.750000000018,ATM, 
971502153350,10/12/2019,Young Howard and Hill,,1894.73,-13292.480000000018,OTHER, 
971502153350,11/12/2019,Boone Lewis and Schneider,,1214.43,-14506.910000000018,PAYMENT, 
971502153350,12/12/2019,751453660049086 WHEELER TURNER AND ABBOTT ,1161.58,,-13345.330000000018,ATM, 
971502153350,14/12/2019,305141484206794 MCFARLAND-DOMINGUEZ ,642.19,,-12703.140000000018,OTHER, 
971502153350,14/12/2019,648047831920641 WILLIAMS-GIBSON ,723.99,,-11979.150000000018,POS, 
971502153350,15/12/2019,Nelson-Hutchinson,1918.69,,-10060.460000000017,ATM, 
971502153350,18/12/2019,Thomas Taylor and Smith,1709.42,,-8351.040000000017,ATM, 
971502153350,19/12/2019,520508721107395 JEFFERSON AND SONS ,20.93,,-8330.110000000017,ATM, 
971502153350,20/12/2019,Martinez-Sutton,188.5,,-8141.610000000017,POS, 
971502153350,21/12/2019,498360908820462 WRIGHT GROUP ,,175.59,-8317.200000000017,ATM, 
971502153350,22/12/2019,Lin LLC,1219.79,,-7097.410000000017,ATM, 
971502153350,24/12/2019,259595355181865 JONES-PENA ,,1006.48,-8103.890000000018,ATM, 
971502153350,26/12/2019,Garrett-Simmons,,849.98,-8953.870000000017,ATM, 
971502153350,28/12/2019,Page Stein and Phillips,1562.51,,-7391.360000000017,OTHER, 
971502153350,28/12/2019,75219879179169 GOMEZ LTD ,,1599.94,-8991.300000000017,POS, 
971502153350,31/12/2019,Murphy-Reeves,1484.18,,-7507.120000000017,POS, 
971502153350,31/12/2019,436404954295639 SCHMIDT-BLACKWELL ,,1235.55,-8742.670000000016,POS, 
971502153350,31/12/2019,Bennett Walton and Griffin,1470.0,,-7272.670000000016,OTHER, 
971502153350,03/01/2020,Christensen-Sandoval,,866.31,-8138.980000000016,POS, 
971502153350,05/01/2020,668648541778225 THOMAS-NORRIS ,,1053.37,-9192.350000000017,ATM, 
971502153350,05/01/2020,Powers Burke and Wolf,433.24,,-8759.110000000017,OTHER, 
971502153350,08/01/2020,208291379145318 HOLLOWAY MILLER AND GARCIA ,731.78,,-8027.330000000017,PAYMENT, 
971502153350,10/01/2020,333873078598439 THOMAS PLC ,544.9,,-7482.430000000018,PAYMENT, 
971502153350,10/01/2020,189903004264050 BRADLEY-JOHNSON ,1906.32,,-5576.110000000018,OTHER, 
971502153350,12/01/2020,Martin-Harrison,1272.56,,-4303.5500000000175,PAYMENT, 
971502153350,12/01/2020,Williams Gonzalez and Stanley,1531.68,,-2771.870000000017,OTHER, 
971502153350,14/01/2020,Chapman Padilla and Rasmussen,230.28,,-2541.590000000017,PAYMENT, 
971502153350,14/01/2020,75330444415756 BARTON-BURTON ,,1673.21,-4214.8000000000175,OTHER, 
971502153350,16/01/2020,Harrington Ltd,,1828.45,-6043.250000000017,OTHER, 
971502153350,16/01/2020,17237095125021 HILL PLC ,,1625.18,-7668.430000000018,ATM, 
971502153350,17/01/2020,Lawson-Maddox,812.69,,-6855.740000000018,PAYMENT, 
971502153350,20/01/2020,593472880881843 FIGUEROA-MILES ,1181.88,,-5673.860000000018,POS, 
971502153350,22/01/2020,Long PLC,,151.79,-5825.650000000018,PAYMENT, 
971502153350,22/01/2020,Anderson Glass and Martinez,,1022.0,-6847.650000000018,OTHER, 
971502153350,25/01/2020,Walsh Franco and Wilkinson,,420.11,-7267.7600000000175,PAYMENT, 
971502153350,26/01/2020,Lynch-Curtis,1883.85,,-5383.910000000018,POS, 
971502153350,26/01/2020,Melton Johnson and Hall,142.2,,-5241.710000000018,POS, 
971502153350,28/01/2020,158429633755456 CHRISTENSEN VANG AND BRAY ,1181.66,,-4060.0500000000184,OTHER, 
971502153350,29/01/2020,Clayton Valdez and Peterson,,469.69,-4529.740000000018,ATM, 
971502153350,31/01/2020,2038598944220 BURKE-NGUYEN ,,682.0,-5211.740000000018,POS, 
971502153350,02/02/2020,771707278590389 PALMER PLC ,1034.58,,-4177.160000000018,POS, 
971502153350,02/02/2020,158475231607586 HARRIS-MILLER ,,538.71,-4715.870000000018,ATM, 
971502153350,04/02/2020,Oneill and Sons,,171.79,-4887.660000000018,PAYMENT, 
971502153350,04/02/2020,572841418066507 GREEN GROUP ,,501.78,-5389.440000000018,POS, 
971502153350,05/02/2020,Klein Sullivan and Jacobson,1494.1,,-3895.340000000018,ATM, 
971502153350,07/02/2020,703436202039834 CHAN INC ,,200.0,-4095.340000000018,PAYMENT, 
971502153350,08/02/2020,Lewis-Ingram,,1767.68,-5863.020000000018,OTHER, 
971502153350,11/02/2020,283454502780302 WALKER-COX ,,90.56,-5953.580000000018,PAYMENT, 
971502153350,11/02/2020,Fuller LLC,1202.26,,-4751.320000000018,POS, 
971502153350,14/02/2020,154794320398522 LESTER AND SONS ,1285.67,,-3465.650000000018,POS, 
971502153350,14/02/2020,Carter-Yang,,708.61,-4174.2600000000175,ATM, 
971502153350,17/02/2020,Coffey-Glass,1801.12,,-2373.1400000000176,PAYMENT, 
971502153350,19/02/2020,Hernandez-Murphy,1906.11,,-467.0300000000177,ATM, 
971502153350,22/02/2020,122920834304728 LEE ELLISON AND COLLINS ,1734.2,,1267.1699999999823,ATM, 
971502153350,25/02/2020,Pearson Lara and Johnson,,758.71,508.4599999999823,OTHER, 
971502153350,26/02/2020,Wood Group,1423.59,,1932.0499999999822,POS, 
971502153350,27/02/2020,221170244671503 MARSHALL-COX ,1819.57,,3751.619999999982,POS, 
971502153350,01/03/2020,Walker Navarro and Roman,1518.66,,5270.2799999999825,POS, 
971502153350,02/03/2020,Harvey Randolph and Foster,,450.56,4819.719999999982,OTHER, 
971502153350,04/03/2020,574435051785836 SUTTON RANGEL AND FOX ,27.72,,4847.439999999982,OTHER, 
971502153350,07/03/2020,583500100217956 PATEL INC ,,1412.41,3435.0299999999825,PAYMENT, 
971502153350,09/03/2020,Fernandez Kidd and Miller,,1603.33,1831.6999999999825,ATM, 
971502153350,10/03/2020,Lopez-Evans,,207.77,1623.9299999999826,PAYMENT, 
971502153350,12/03/2020,321555895538761 GARCIA LTD ,16.47,,1640.3999999999826,ATM, 
971502153350,13/03/2020,76133840607872 FRANKLIN-REED ,713.19,,2353.589999999983,PAYMENT, 
971502153350,14/03/2020,Callahan Wilson and Brown,1256.41,,3609.9999999999827,PAYMENT, 
971502153350,16/03/2020,277328443784582 DIAZ-GIBSON ,276.12,,3886.1199999999826,PAYMENT, 
971502153350,19/03/2020,Hernandez and Sons,,1568.79,2317.3299999999826,ATM, 
971502153350,20/03/2020,11497620681522 WU TAYLOR AND WALTON ,1154.96,,3472.2899999999827,OTHER, 
971502153350,20/03/2020,77659423713926 BARNES BARNETT AND WILCOX ,,27.11,3445.1799999999826,ATM, 
971502153350,20/03/2020,Brown Nichols and Hoffman,843.98,,4289.159999999983,PAYMENT, 
971502153350,20/03/2020,80721101887632 WOLFE LYNCH AND HARRISON ,,1656.75,2632.4099999999826,OTHER, 
971502153350,22/03/2020,225410836710810 JOHNSON PLC ,,521.15,2111.2599999999825,POS, 
971502153350,25/03/2020,Hughes Ltd,,175.65,1935.6099999999824,POS, 
971502153350,26/03/2020,403935382888074 HUNTER-ANDERSON ,481.95,,2417.559999999982,PAYMENT, 
971502153350,29/03/2020,960725873808439 WILSON-AYERS ,,1227.07,1190.4899999999823,OTHER, 
971502153350,01/04/2020,Warren Jackson and Price,,1623.18,-432.6900000000178,PAYMENT, 
971502153350,01/04/2020,383510073040358 NORTON SCOTT AND WEBB ,,521.41,-954.1000000000178,ATM, 
971502153350,02/04/2020,619293234763871 LOPEZ HARVEY AND BYRD ,,1146.77,-2100.8700000000176,PAYMENT, 
971502153350,02/04/2020,373667753460699 CHEN AND SONS ,,830.9,-2931.7700000000177,OTHER, 
971502153350,04/04/2020,Cross-Bowers,,551.38,-3483.150000000018,ATM, 
971502153350,07/04/2020,Mccormick-Rice,919.86,,-2563.2900000000177,POS, 
971502153350,09/04/2020,783064504152772 MCDONALD-MORRIS ,1938.33,,-624.9600000000178,PAYMENT, 
971502153350,09/04/2020,Lopez and Sons,733.6,,108.63999999998225,OTHER, 
971502153350,09/04/2020,230734578846 HOUSE-GORDON ,,295.59,-186.95000000001772,PAYMENT, 
971502153350,10/04/2020,656854869231407 CAMPBELL TAYLOR AND MARTIN ,,1415.7,-1602.6500000000178,ATM, 
971502153350,10/04/2020,Burns Inc,454.89,,-1147.760000000018,OTHER, 
971502153350,11/04/2020,236012457653871 HALL-RICHMOND ,8.27,,-1139.490000000018,OTHER, 
971502153350,12/04/2020,701553893102852 PATEL-LEE ,742.27,,-397.220000000018,PAYMENT, 
971502153350,14/04/2020,Brown-Davis,,171.83,-569.050000000018,PAYMENT, 
971502153350,14/04/2020,841664580968366 HAYES-MURPHY ,,1952.27,-2521.320000000018,PAYMENT, 
971502153350,14/04/2020,Mckinney and Sons,,1909.55,-4430.870000000018,OTHER, 
971502153350,16/04/2020,Lee-Reeves,1998.34,,-2432.530000000018,ATM, 
971502153350,17/04/2020,Mccoy-Gould,1780.55,,-651.980000000018,POS, 
971502153350,18/04/2020,266648510639244 MADDEN-WALKER ,,122.5,-774.480000000018,POS, 
971502153350,21/04/2020,Freeman Cobb and Green,,1241.84,-2016.320000000018,PAYMENT, 
971502153350,23/04/2020,991855425223319 LANE AND SONS ,,1.85,-2018.1700000000178,ATM, 
971502153350,24/04/2020,Meyers-Davis,,1866.24,-3884.410000000018,ATM, 
971502153350,27/04/2020,141320658286438 KLEIN PLC ,1658.69,,-2225.720000000018,ATM, 
971502153350,28/04/2020,Vasquez-Knapp,1117.23,,-1108.490000000018,PAYMENT, 
971502153350,29/04/2020,Thomas Richards and Morgan,813.67,,-294.820000000018,PAYMENT, 
971502153350,30/04/2020,663969934018682 VASQUEZ GROUP ,756.06,,461.23999999998193,PAYMENT, 
971502153350,30/04/2020,599842699638622 CARR-HOOVER ,10.04,,471.27999999998195,OTHER, 
971502153350,03/05/2020,Murray Ltd,,1973.76,-1502.480000000018,PAYMENT, 
971502153350,06/05/2020,699252474586753 JOHNSON-COLLIER ,574.81,,-927.670000000018,POS, 
971502153350,07/05/2020,Robinson PLC,,528.85,-1456.5200000000182,ATM, 
971502153350,08/05/2020,740595920576564 SHEPPARD LARSON AND REED ,,1492.1,-2948.620000000018,ATM, 
971502153350,09/05/2020,35188083865319 BRADLEY-WINTERS ,1970.85,,-977.7700000000182,PAYMENT, 
971502153350,10/05/2020,Jackson Payne and Smith,,137.47,-1115.2400000000182,OTHER, 
971502153350,12/05/2020,Scott Shields and Hawkins,457.57,,-657.6700000000183,PAYMENT, 
971502153350,15/05/2020,Lynn Ltd,1307.32,,649.6499999999817,ATM, 
971502153350,16/05/2020,Williams Mcconnell and Brown,,1504.02,-854.3700000000183,POS, 
971502153350,17/05/2020,231821755349704 ORTIZ DURAN AND MARTINEZ ,1020.39,,166.01999999998168,ATM, 
971502153350,20/05/2020,472679280942154 HERNANDEZ GROUP ,,1474.97,-1308.9500000000185,PAYMENT, 
971502153350,22/05/2020,Reilly Hancock and Ortiz,,1513.22,-2822.1700000000183,POS, 
971502153350,23/05/2020,92745246492034 KING HOBBS AND JIMENEZ ,1260.71,,-1561.4600000000182,OTHER, 
971502153350,24/05/2020,Bean Meyer and Scott,603.46,,-958.0000000000182,OTHER, 
971502153350,25/05/2020,Lee-Clarke,,35.78,-993.7800000000182,POS, 
971502153350,27/05/2020,388256653761678 CAMERON WATSON AND BLACK ,133.23,,-860.5500000000181,PAYMENT, 
971502153350,27/05/2020,227818649992940 SMITH INC ,1306.8,,446.2499999999818,ATM, 
971502153350,28/05/2020,Love-Avery,1047.82,,1494.0699999999817,POS, 
971502153350,29/05/2020,Kelly Smith and Garcia,,68.49,1425.5799999999817,OTHER, 
971502153350,31/05/2020,Evans Franklin and Smith,,1660.53,-234.95000000001824,PAYMENT, 
971502153350,03/06/2020,Peck-Chapman,1300.57,,1065.6199999999817,POS, 
971502153350,03/06/2020,813144707090850 MORAN AGUIRRE AND WELLS ,,1169.72,-104.10000000001833,POS, 
971502153350,05/06/2020,23731228692848 HARDIN ALLEN AND RAMOS ,,1315.74,-1419.8400000000183,ATM, 
971502153350,08/06/2020,934675494668601 MCCOY-ROTH ,,1640.44,-3060.2800000000184,PAYMENT, 
971502153350,11/06/2020,Rogers Bowman and Williams,,1301.4,-4361.6800000000185,POS, 
971502153350,12/06/2020,Branch PLC,,517.26,-4878.940000000019,PAYMENT, 
971502153350,15/06/2020,555591140868534 WILLIAMS BERRY AND COX ,1249.41,,-3629.530000000019,OTHER, 
971502153350,15/06/2020,Solomon Wilkins and Griffin,,939.7,-4569.230000000019,POS, 
971502153350,18/06/2020,623574407091840 WILLIAMS REID AND WILLIAMS ,,861.64,-5430.870000000019,OTHER, 
971502153350,18/06/2020,Duran-Bridges,859.97,,-4570.900000000019,OTHER, 
971502153350,19/06/2020,Case and Sons,,1999.92,-6570.820000000019,OTHER, 
971502153350,19/06/2020,983051320116011 BRIGGS-TURNER ,,1563.37,-8134.190000000019,POS, 
971502153350,19/06/2020,Newman-Rodriguez,,1685.36,-9819.55000000002,OTHER, 
971502153350,20/06/2020,87801311458026 BAKER-GRIFFIN ,725.91,,-9093.64000000002,POS, 
971502153350,23/06/2020,Mccoy-Reeves,1503.95,,-7589.69000000002,OTHER, 
971502153350,26/06/2020,Freeman Martinez and Shaffer,1034.71,,-6554.98000000002,OTHER, 
971502153350,26/06/2020,Vasquez Thomas and Johnson,,1166.86,-7721.840000000019,POS, 
971502153350,26/06/2020,146293385204070 MILLER-MCGEE ,362.92,,-7358.920000000019,PAYMENT, 
971502153350,29/06/2020,438339073667643 HAWKINS-WONG ,376.36,,-6982.5600000000195,ATM, 
971502153350,01/07/2020,39951382779669 COX BRAY AND POWELL ,,1435.1,-8417.66000000002,OTHER, 
971502153350,01/07/2020,Snyder-Hawkins,,1604.25,-10021.91000000002,OTHER, 
971502153350,01/07/2020,562524459591861 COHEN INC ,,1649.1,-11671.01000000002,ATM, 
971502153350,02/07/2020,Roach Montgomery and Strickland,,1278.72,-12949.73000000002,POS, 
971502153350,05/07/2020,Benson Ltd,777.23,,-12172.50000000002,OTHER, 
971502153350,05/07/2020,325851301815520 JOHNSTON GENTRY AND VASQUEZ ,1425.04,,-10747.460000000021,PAYMENT, 
971502153350,07/07/2020,162734574558246 HANSEN-GARCIA ,,681.47,-11428.93000000002,OTHER, 
971502153350,07/07/2020,75417952948536 ROWLAND PLC ,94.17,,-11334.76000000002,OTHER, 
971502153350,09/07/2020,Bautista Inc,,1621.65,-12956.41000000002,ATM, 
971502153350,10/07/2020,Phillips Reyes and Garcia,1092.79,,-11863.62000000002,PAYMENT, 
971502153350,10/07/2020,Pope Inc,,196.49,-12060.11000000002,OTHER, 
971502153350,10/07/2020,Chase Webster and Drake,1142.08,,-10918.03000000002,OTHER, 
971502153350,10/07/2020,Cuevas Crawford and Delgado,1728.09,,-9189.94000000002,PAYMENT, 
971502153350,10/07/2020,192731336972493 MCLEAN-WIGGINS ,,1649.52,-10839.460000000021,POS, 
971502153350,11/07/2020,345967616286892 SHAW CLARK AND BAKER ,349.95,,-10489.51000000002,POS, 
971502153350,12/07/2020,859058823622715 SMITH HANSON AND HUTCHINSON ,1374.13,,-9115.38000000002,ATM, 
971502153350,12/07/2020,522812228739359 MITCHELL MIRANDA AND RODRIGUEZ ,,1315.98,-10431.360000000019,POS, 
971502153350,12/07/2020,Fox-Clark,,1667.66,-12099.020000000019,ATM, 
971502153350,15/07/2020,Woodward Holt and Hunter,47.01,,-12052.010000000018,OTHER, 
971502153350,16/07/2020,315601352814368 WHEELER-REYNOLDS ,,753.81,-12805.820000000018,OTHER, 
971502153350,16/07/2020,Chang Houston and Fields,1588.56,,-11217.260000000018,PAYMENT, 
971502153350,16/07/2020,958310501656300 CANNON INC ,303.17,,-10914.090000000018,OTHER, 
971502153350,18/07/2020,Murillo PLC,,34.99,-10949.080000000018,POS, 
971502153350,18/07/2020,Torres-Patterson,280.61,,-10668.470000000018,POS, 
971502153350,18/07/2020,984323317216959 RYAN-HARVEY ,,1071.56,-11740.030000000017,PAYMENT, 
971502153350,21/07/2020,601068535628045 THOMPSON WILLIAMS AND PEARSON ,1524.23,,-10215.800000000017,OTHER, 
971502153350,22/07/2020,471972397674935 CLAY GROUP ,,311.16,-10526.960000000017,ATM, 
971502153350,22/07/2020,Garcia Ferguson and Martinez,,1034.22,-11561.180000000017,POS, 
971502153350,22/07/2020,199657998638396 HARPER GROUP ,231.65,,-11329.530000000017,ATM, 
971502153350,22/07/2020,150673603930075 MCKINNEY-TAYLOR ,,1346.1,-12675.630000000017,POS, 
971502153350,25/07/2020,Simpson Ltd,1714.52,,-10961.110000000017,PAYMENT, 
971502153350,27/07/2020,Hudson and Sons,1191.19,,-9769.920000000016,ATM, 
971502153350,28/07/2020,557517716237132 SCHMITT-SMITH ,,893.54,-10663.460000000017,POS, 
971502153350,28/07/2020,Holt Mcgrath and Savage,,931.28,-11594.740000000018,OTHER, 
971502153350,29/07/2020,319777335385302 LOPEZ LLC ,415.54,,-11179.200000000017,POS, 
971502153350,31/07/2020,671006578701638 GOMEZ-KNIGHT ,,1200.64,-12379.840000000017,OTHER, 
971502153350,31/07/2020,Williams Group,622.04,,-11757.800000000017,ATM, 
971502153350,03/08/2020,Cook Inc,634.93,,-11122.870000000017,ATM, 
971502153350,06/08/2020,652760166317902 ROSS-TORRES ,,428.94,-11551.810000000018,OTHER, 
971502153350,08/08/2020,740489198906901 MCDONALD GRAHAM AND JENSEN ,989.85,,-10561.960000000017,POS, 
971502153350,09/08/2020,341874808343572 REESE AND SONS ,,344.41,-10906.370000000017,POS, 
971502153350,12/08/2020,110615215477098 LEVY-COHEN ,,546.4,-11452.770000000017,PAYMENT, 
971502153350,15/08/2020,364867115145236 LEVY INC ,,210.05,-11662.820000000016,ATM, 
971502153350,15/08/2020,607420880779115 SMITH-RAMSEY ,46.72,,-11616.100000000017,PAYMENT, 
971502153350,16/08/2020,James-Newman,,317.14,-11933.240000000016,POS, 
971502153350,16/08/2020,Barber and Sons,1697.25,,-10235.990000000016,POS, 
971502153350,18/08/2020,431904641286164 CARSON-GARCIA ,,78.99,-10314.980000000016,OTHER, 
971502153350,18/08/2020,Robinson PLC,1527.2,,-8787.780000000015,PAYMENT, 
971502153350,18/08/2020,Fritz LLC,315.48,,-8472.300000000016,OTHER, 
971502153350,21/08/2020,Lopez-Rodriguez,455.93,,-8016.370000000015,OTHER, 
971502153350,23/08/2020,813787153592345 BYRD LLC ,,1688.71,-9705.080000000016,OTHER, 
971502153350,24/08/2020,489632655005580 SHAH-SMITH ,,595.38,-10300.460000000015,PAYMENT, 
971502153350,25/08/2020,236524537845498 LE-SANCHEZ ,25.51,,-10274.950000000015,ATM, 
971502153350,27/08/2020,946107113406728 BAKER-CUMMINGS ,,396.71,-10671.660000000014,OTHER, 
971502153350,27/08/2020,81546327558577 GRIMES LTD ,,1455.83,-12127.490000000014,POS, 
971502153350,29/08/2020,473274283025501 LEWIS MENDOZA AND VASQUEZ ,,1430.38,-13557.870000000014,PAYMENT, 
971502153350,30/08/2020,Pena Gonzalez and Cooley,611.98,,-12945.890000000014,POS, 
971502153350,01/09/2020,871933441667693 BRADLEY LLC ,1817.25,,-11128.640000000014,PAYMENT, 
971502153350,03/09/2020,Richardson-Bernard,472.05,,-10656.590000000015,ATM, 
971502153350,06/09/2020,Gonzalez Davis and Wright,,1062.87,-11719.460000000014,ATM, 
971502153350,08/09/2020,557279976565900 NOBLE-GRIFFITH ,1653.94,,-10065.520000000013,OTHER, 
971502153350,10/09/2020,191041085006512 ROBINSON MOSES AND FLORES ,999.74,,-9065.780000000013,OTHER, 
971502153350,11/09/2020,Bailey Perry and White,,1945.67,-11011.450000000013,PAYMENT, 
971502153350,11/09/2020,Carter PLC,1642.04,,-9369.410000000014,ATM, 
971502153350,14/09/2020,Wright-Cole,,1158.78,-10528.190000000015,PAYMENT, 
971502153350,14/09/2020,Medina-Parker,105.9,,-10422.290000000015,PAYMENT, 
971502153350,16/09/2020,Jones-Alexander,,1090.28,-11512.570000000016,ATM, 
971502153350,17/09/2020,560769819426897 HUDSON-TRAN ,839.29,,-10673.280000000017,POS, 
971502153350,20/09/2020,324361649547498 FREEMAN HARRIS AND CONRAD ,801.02,,-9872.260000000017,PAYMENT, 
971502153350,22/09/2020,Thompson Inc,,868.88,-10741.140000000016,OTHER, 
971502153350,25/09/2020,Bradley and Sons,,1946.79,-12687.930000000015,ATM, 
971502153350,26/09/2020,619291609853352 MCKENZIE AND SONS ,,1645.38,-14333.310000000016,PAYMENT, 
971502153350,26/09/2020,Ramirez-Lopez,,997.53,-15330.840000000017,PAYMENT, 
971502153350,26/09/2020,Hall Inc,408.23,,-14922.610000000017,PAYMENT, 
971502153350,27/09/2020,Calderon-Gregory,335.0,,-14587.610000000017,OTHER, 
971502153350,27/09/2020,93434794041440 MCGEE TURNER AND CONNER ,1292.53,,-13295.080000000016,ATM, 
971502153350,30/09/2020,562186241190594 HEATH AND SONS ,483.71,,-12811.370000000017,ATM, 
971502153350,30/09/2020,Howard-Cook,,999.5,-13810.870000000017,POS, 
971502153350,30/09/2020,575358180531918 NEWTON FIELDS AND SCOTT ,,528.26,-14339.130000000017,PAYMENT, 
971502153350,02/10/2020,693031555559603 HILL WILLIAMS AND SMITH ,,627.8,-14966.930000000017,OTHER, 
971502153350,03/10/2020,120127858587592 SMITH PORTER AND RUIZ ,,1369.85,-16336.780000000017,PAYMENT, 
971502153350,03/10/2020,Nelson LLC,,1492.98,-17829.760000000017,PAYMENT, 
971502153350,03/10/2020,Simmons Green and Hatfield,16.93,,-17812.830000000016,PAYMENT, 
971502153350,05/10/2020,651064931033000 LUNA-BROWN ,,354.49,-18167.320000000018,OTHER, 
971502153350,06/10/2020,908379618123917 RICHARDSON-ABBOTT ,392.2,,-17775.120000000017,POS, 
971502153350,08/10/2020,185620145301392 LONG LTD ,,386.03,-18161.150000000016,POS, 
971502153350,09/10/2020,Arnold PLC,1887.86,,-16273.290000000015,ATM, 
971502153350,12/10/2020,566825663366930 JOHNSON PAGE AND GREEN ,,1727.57,-18000.860000000015,PAYMENT, 
971502153350,12/10/2020,Lutz Parrish and Bennett,,558.12,-18558.980000000014,ATM, 
971502153350,13/10/2020,951558365111306 FISHER-WILLIAMS ,1508.58,,-17050.400000000016,PAYMENT, 
971502153350,16/10/2020,Wallace-Kidd,646.59,,-16403.810000000016,OTHER, 
971502153350,17/10/2020,832280874459275 DONOVAN SALAZAR AND WILLIAMS ,,439.6,-16843.410000000014,POS, 
971502153350,20/10/2020,Key Austin and Norman,942.93,,-15900.480000000014,OTHER, 
971502153350,20/10/2020,Duarte PLC,,1020.91,-16921.390000000014,ATM, 
971502153350,23/10/2020,Costa and Sons,1258.65,,-15662.740000000014,ATM, 
971502153350,25/10/2020,111853295949612 FULLER-SCHULTZ ,,450.65,-16113.390000000014,POS, 
971502153350,28/10/2020,654999798159701 CASTILLO-KNIGHT ,,971.46,-17084.850000000013,OTHER, 
971502153350,31/10/2020,708279188568883 BLEVINS RHODES AND WARD ,1031.35,,-16053.500000000013,POS, 
971502153350,01/11/2020,13860562150624 AYERS-NOBLE ,1986.35,,-14067.150000000012,OTHER, 
971502153350,01/11/2020,Burton Martinez and Miller,,1621.17,-15688.320000000012,POS, 
971502153350,02/11/2020,Clark Diaz and Bell,611.94,,-15076.380000000012,OTHER, 
971502153350,02/11/2020,Lee Group,1061.1,,-14015.280000000012,PAYMENT, 
971502153350,02/11/2020,476710018104245 SIMPSON AND SONS ,1257.23,,-12758.050000000012,ATM, 
971502153350,04/11/2020,563050916707270 JIMENEZ-ROBERTSON ,,320.88,-13078.930000000011,ATM, 
971502153350,04/11/2020,Welch Johnston and Harris,44.97,,-13033.960000000012,ATM, 
971502153350,07/11/2020,168819486941213 MARQUEZ-MCDONALD ,1951.59,,-11082.370000000012,ATM, 
971502153350,10/11/2020,Rasmussen LLC,,825.69,-11908.060000000012,POS, 
971502153350,10/11/2020,Moss-Reid,1283.93,,-10624.130000000012,POS, 
971502153350,12/11/2020,Kerr Sanford and Jones,,1970.38,-12594.510000000013,POS, 
971502153350,12/11/2020,927473444467415 BUTLER INC ,421.13,,-12173.380000000014,OTHER, 
971502153350,12/11/2020,Hood Inc,218.16,,-11955.220000000014,OTHER, 
971502153350,12/11/2020,728367019562270 TAYLOR MCLEAN AND MITCHELL ,1412.97,,-10542.250000000015,PAYMENT, 
971502153350,14/11/2020,969414394892900 SCOTT-FOSTER ,1153.0,,-9389.250000000015,OTHER, 
971502153350,16/11/2020,Floyd-Rodriguez,1088.5,,-8300.750000000015,OTHER, 
