Bank Account,Date,Narrative,Debit,Credit,Balance,Categories,Serial
179736617224,07/11/2015,Garcia Martin and Adams,,1413.45,-989.3100000000001,OTHER, 
179736617224,09/11/2015,681598886759384 ALLEN-ERICKSON ,925.13,,-64.18000000000006,PAYMENT, 
179736617224,10/11/2015,Phillips Watson and Ramos,343.11,,278.92999999999995,POS, 
179736617224,13/11/2015,Hardin Martin and Frazier,1904.48,,2183.41,OTHER, 
179736617224,13/11/2015,Chambers Ltd,1525.42,,3708.83,PAYMENT, 
179736617224,14/11/2015,11069441414725 THOMPSON-RODRIGUEZ ,90.21,,3799.04,POS, 
179736617224,16/11/2015,974827388843523 FOSTER INC ,,1386.7,2412.34,POS, 
179736617224,18/11/2015,Johnston Phillips and Barnes,,918.76,1493.5800000000002,PAYMENT, 
179736617224,19/11/2015,Gray-Gonzales,361.73,,1855.3100000000002,PAYMENT, 
179736617224,20/11/2015,Harris Russell and Mullins,619.32,,2474.63,PAYMENT, 
179736617224,20/11/2015,406513779684204 MAXWELL-PARKER ,1163.74,,3638.37,POS, 
179736617224,21/11/2015,345708305374887 ROBINSON-ZAVALA ,,170.9,3467.47,OTHER, 
179736617224,22/11/2015,Walker PLC,,1666.03,1801.4399999999998,POS, 
179736617224,24/11/2015,910349996670624 PECK-JACOBSON ,,1363.23,438.2099999999998,POS, 
179736617224,26/11/2015,Collins Watson and Ellis,,1330.24,-892.0300000000002,PAYMENT, 
179736617224,26/11/2015,Torres Buchanan and Meyer,,1483.72,-2375.75,PAYMENT, 
179736617224,28/11/2015,381640572406046 BAILEY LINDSEY AND LANDRY ,381.89,,-1993.8600000000001,ATM, 
179736617224,28/11/2015,Contreras-Barker,,855.26,-2849.12,ATM, 
179736617224,28/11/2015,625731450086634 HUGHES CLARKE AND CARTER ,,1167.65,-4016.77,PAYMENT, 
179736617224,29/11/2015,628783215271125 WALLER AND SONS ,,1353.27,-5370.04,POS, 
179736617224,01/12/2015,Harris Roberts and Valdez,877.4,,-4492.64,OTHER, 
179736617224,02/12/2015,Woods-Jones,,1970.81,-6463.450000000001,POS, 
179736617224,04/12/2015,215303586225719 HALL INC ,,1986.68,-8450.130000000001,ATM, 
179736617224,07/12/2015,Singh-Perez,972.48,,-7477.6500000000015,PAYMENT, 
179736617224,09/12/2015,8218717332321 LONG-MITCHELL ,1123.01,,-6354.640000000001,OTHER, 
179736617224,11/12/2015,179500687533760 JOYCE INC ,1810.45,,-4544.190000000001,ATM, 
179736617224,12/12/2015,Russell Fuentes and Waters,,742.29,-5286.480000000001,PAYMENT, 
179736617224,13/12/2015,Grimes Griffin and Boyer,,970.07,-6256.550000000001,PAYMENT, 
179736617224,13/12/2015,Weiss Chen and Liu,,497.15,-6753.700000000001,PAYMENT, 
179736617224,13/12/2015,Patel-Villanueva,1563.37,,-5190.330000000001,POS, 
179736617224,14/12/2015,378580279370942 RICHARDS-HANNA ,1077.65,,-4112.68,PAYMENT, 
179736617224,15/12/2015,274612759064881 CLARK-TORRES ,,257.66,-4370.34,ATM, 
179736617224,15/12/2015,Sutton Foster and Vega,408.62,,-3961.7200000000003,PAYMENT, 
179736617224,15/12/2015,213110921462783 CASTILLO-SHELTON ,1635.64,,-2326.08,POS, 
179736617224,15/12/2015,Moore-Johnson,,826.76,-3152.84,ATM, 
179736617224,16/12/2015,343902476540273 BRENNAN GROUP ,439.06,,-2713.78,ATM, 
179736617224,17/12/2015,424512263497293 COOK LLC ,1896.45,,-817.3300000000002,PAYMENT, 
179736617224,18/12/2015,416627289702872 ZIMMERMAN LAWSON AND GONZALEZ ,1370.24,,552.9099999999999,OTHER, 
179736617224,21/12/2015,Huff PLC,,1975.85,-1422.94,PAYMENT, 
179736617224,24/12/2015,Jimenez Foley and Roberson,,612.06,-2035.0,POS, 
179736617224,27/12/2015,810928258898999 WOLF AND SONS ,,1326.37,-3361.37,OTHER, 
179736617224,28/12/2015,843671308343691 ORTIZ JONES AND COOK ,,414.76,-3776.13,PAYMENT, 
179736617224,29/12/2015,570943240197046 SOSA PLC ,,291.16,-4067.29,OTHER, 
179736617224,31/12/2015,36656831734598 CERVANTES HICKS AND RODGERS ,,807.88,-4875.17,ATM, 
179736617224,01/01/2016,936960347643807 WATSON TAYLOR AND KNIGHT ,1340.44,,-3534.73,ATM, 
179736617224,02/01/2016,39982166642211 BLEVINS LLC ,,732.12,-4266.85,POS, 
179736617224,04/01/2016,299740359441839 BASS AND SONS ,,1003.65,-5270.5,ATM, 
179736617224,04/01/2016,Valdez PLC,710.38,,-4560.12,PAYMENT, 
179736617224,07/01/2016,Davis Wright and Lewis,,786.5,-5346.62,POS, 
179736617224,09/01/2016,339883468994801 GEORGE-WALKER ,18.92,,-5327.7,POS, 
179736617224,12/01/2016,727840662413164 JONES AND SONS ,1851.81,,-3475.89,POS, 
179736617224,13/01/2016,Dougherty Smith and Bradford,,1408.86,-4884.75,PAYMENT, 
179736617224,16/01/2016,Berger Reyes and Johnston,,457.99,-5342.74,ATM, 
179736617224,18/01/2016,335751148979832 WHITE AND SONS ,,955.95,-6298.69,ATM, 
179736617224,19/01/2016,Avila Fleming and Doyle,,1568.27,-7866.959999999999,PAYMENT, 
179736617224,19/01/2016,891144196266165 SALAS GROUP ,,280.38,-8147.339999999999,ATM, 
179736617224,20/01/2016,534004273150349 WASHINGTON EVANS AND WALKER ,,432.43,-8579.769999999999,PAYMENT, 
179736617224,21/01/2016,348182450116074 GARCIA-CHAVEZ ,,45.23,-8624.999999999998,ATM, 
179736617224,22/01/2016,Smith-Russell,1045.75,,-7579.249999999998,ATM, 
179736617224,23/01/2016,372570474993934 WASHINGTON PLC ,,627.6,-8206.849999999999,PAYMENT, 
179736617224,24/01/2016,Burnett-Nelson,1758.51,,-6448.339999999998,POS, 
179736617224,24/01/2016,799127291605342 MILLER-JIMENEZ ,,1191.21,-7639.549999999998,PAYMENT, 
179736617224,27/01/2016,702554470357482 ROBERTS INC ,1197.25,,-6442.299999999998,PAYMENT, 
179736617224,30/01/2016,509888680082385 MORRISON AND SONS ,,1280.42,-7722.719999999998,POS, 
179736617224,30/01/2016,Thomas-Garza,,247.63,-7970.3499999999985,PAYMENT, 
179736617224,02/02/2016,Mason Medina and Ortiz,553.36,,-7416.989999999999,ATM, 
179736617224,02/02/2016,524740587771496 WARD WILLIAMS AND HALL ,,196.36,-7613.3499999999985,PAYMENT, 
179736617224,05/02/2016,Sanders-Howard,97.82,,-7515.529999999999,POS, 
179736617224,08/02/2016,17910589663886 THOMPSON-SHARP ,879.7,,-6635.829999999999,POS, 
179736617224,11/02/2016,Caldwell Grant and Farley,342.25,,-6293.579999999999,OTHER, 
179736617224,14/02/2016,Adams PLC,,1458.67,-7752.249999999999,PAYMENT, 
179736617224,16/02/2016,582451860482040 WEBB PEREZ AND BRADLEY ,,1397.51,-9149.759999999998,POS, 
179736617224,18/02/2016,878970093242360 SMITH AND SONS ,1737.18,,-7412.579999999998,POS, 
179736617224,18/02/2016,Mccarthy-Hendrix,1717.76,,-5694.819999999998,ATM, 
179736617224,20/02/2016,Cabrera and Sons,726.37,,-4968.449999999998,OTHER, 
179736617224,21/02/2016,Gregory-Jackson,1694.5,,-3273.949999999998,PAYMENT, 
179736617224,23/02/2016,Knight Klein and Diaz,1573.12,,-1700.829999999998,OTHER, 
179736617224,24/02/2016,694153197241745 KELLEY INC ,,1480.7,-3181.529999999998,PAYMENT, 
179736617224,25/02/2016,162263267934989 HARRIS HAYES AND LARSEN ,645.71,,-2535.819999999998,OTHER, 
179736617224,27/02/2016,455550033798845 PARKER RILEY AND WHITAKER ,,40.29,-2576.109999999998,OTHER, 
179736617224,01/03/2016,Walter Aguilar and Howell,,1738.45,-4314.559999999998,OTHER, 
179736617224,04/03/2016,587187474877334 BRADLEY-HAWKINS ,,1386.3,-5700.859999999998,POS, 
179736617224,07/03/2016,77704896646883 BROOKS PLC ,933.96,,-4766.899999999998,ATM, 
179736617224,10/03/2016,Diaz LLC,819.74,,-3947.159999999998,ATM, 
179736617224,11/03/2016,821061923145677 FITZPATRICK AND SONS ,1371.68,,-2575.4799999999977,PAYMENT, 
179736617224,14/03/2016,226151676933231 HIGGINS LLC ,,521.57,-3097.049999999998,ATM, 
179736617224,15/03/2016,Hernandez LLC,1919.98,,-1177.069999999998,OTHER, 
179736617224,18/03/2016,Valenzuela-Cook,,1525.49,-2702.5599999999977,OTHER, 
179736617224,18/03/2016,932329709672763 HARRISON MORSE AND GARCIA ,923.51,,-1779.0499999999977,PAYMENT, 
179736617224,20/03/2016,Schaefer-Atkins,121.13,,-1657.9199999999978,OTHER, 
179736617224,22/03/2016,Campos Edwards and Matthews,,957.37,-2615.2899999999977,ATM, 
179736617224,25/03/2016,Barnes Inc,,375.15,-2990.439999999998,PAYMENT, 
179736617224,28/03/2016,223222704769601 TERRELL PLC ,1918.21,,-1072.2299999999977,POS, 
179736617224,30/03/2016,794348243742104 BLANKENSHIP LTD ,200.43,,-871.7999999999977,OTHER, 
179736617224,31/03/2016,Wright Parks and Gibson,,1760.58,-2632.3799999999974,PAYMENT, 
179736617224,02/04/2016,Lambert Velazquez and Mcmillan,,1038.49,-3670.869999999997,OTHER, 
179736617224,03/04/2016,Gray Martin and Thomas,,1349.93,-5020.799999999997,PAYMENT, 
179736617224,06/04/2016,772979836824184 WILLIS INC ,,1194.26,-6215.059999999998,OTHER, 
179736617224,09/04/2016,739102796693488 MOORE-HUANG ,159.08,,-6055.979999999998,POS, 
179736617224,11/04/2016,801771418553302 BROWN-GALLEGOS ,704.81,,-5351.169999999998,ATM, 
179736617224,12/04/2016,146785353381333 PHILLIPS LLC ,,863.07,-6214.239999999998,POS, 
179736617224,12/04/2016,678305491072449 MOORE PLC ,,1908.85,-8123.089999999998,POS, 
179736617224,13/04/2016,674026916891813 SMITH AND SONS ,1159.07,,-6964.019999999999,PAYMENT, 
179736617224,13/04/2016,Mcknight Allen and Carr,,786.9,-7750.919999999998,POS, 
179736617224,15/04/2016,Campos-Guzman,,1987.38,-9738.3,OTHER, 
179736617224,18/04/2016,Kelly-Dawson,,421.22,-10159.519999999999,ATM, 
179736617224,18/04/2016,Davenport-Preston,1249.19,,-8910.329999999998,OTHER, 
179736617224,18/04/2016,Trujillo-Dunlap,1279.03,,-7631.299999999998,OTHER, 
179736617224,19/04/2016,263851016470322 LARSEN-BOND ,,1432.05,-9063.349999999999,OTHER, 
179736617224,19/04/2016,500734305884037 LEONARD GROUP ,579.37,,-8483.979999999998,PAYMENT, 
179736617224,19/04/2016,Noble-Hicks,838.25,,-7645.729999999998,ATM, 
179736617224,21/04/2016,Cooper Pham and Montgomery,,440.05,-8085.779999999998,PAYMENT, 
179736617224,22/04/2016,374508509048326 ROBERTSON KING AND YOUNG ,1010.28,,-7075.499999999998,OTHER, 
179736617224,23/04/2016,577615372062434 MORGAN LTD ,,961.15,-8036.649999999998,PAYMENT, 
179736617224,23/04/2016,Rice-Miller,1461.76,,-6574.889999999998,ATM, 
179736617224,23/04/2016,652807841792540 BENNETT AND SONS ,291.03,,-6283.859999999998,OTHER, 
179736617224,24/04/2016,White-Leonard,,410.45,-6694.309999999998,OTHER, 
179736617224,26/04/2016,Young-Cooper,,1095.69,-7789.999999999998,PAYMENT, 
179736617224,29/04/2016,Roberts Group,1015.81,,-6774.189999999999,POS, 
179736617224,29/04/2016,508432281450854 HERNANDEZ PLC ,1697.55,,-5076.6399999999985,PAYMENT, 
179736617224,02/05/2016,633557419742425 JACKSON INC ,,1137.93,-6214.569999999999,PAYMENT, 
179736617224,04/05/2016,Johnson LLC,498.4,,-5716.169999999999,PAYMENT, 
179736617224,07/05/2016,277035039507545 COPELAND-BENTLEY ,,773.0,-6489.169999999999,POS, 
179736617224,07/05/2016,619613468755617 HENRY LLC ,1980.22,,-4508.949999999999,POS, 
179736617224,08/05/2016,712762867489754 ANDERSEN-WYATT ,220.75,,-4288.199999999999,OTHER, 
179736617224,08/05/2016,284291109630669 MANNING-BATES ,,323.45,-4611.649999999999,ATM, 
179736617224,09/05/2016,Norman-Collins,843.1,,-3768.549999999999,ATM, 
179736617224,11/05/2016,Price-Hutchinson,,918.19,-4686.739999999999,POS, 
179736617224,12/05/2016,217447078840573 DANIELS-CLARK ,,65.67,-4752.409999999999,ATM, 
179736617224,13/05/2016,568075974461036 FERNANDEZ GROUP ,,928.65,-5681.059999999999,ATM, 
179736617224,14/05/2016,Melton Lee and Carter,,1061.48,-6742.539999999999,POS, 
179736617224,15/05/2016,Warren-Harris,202.8,,-6539.739999999999,PAYMENT, 
179736617224,15/05/2016,491811767553650 SMITH-MARTINEZ ,1758.93,,-4780.809999999999,PAYMENT, 
179736617224,15/05/2016,Daniels PLC,109.73,,-4671.079999999999,OTHER, 
179736617224,15/05/2016,283743857623831 COOK GROUP ,,1924.98,-6596.0599999999995,PAYMENT, 
179736617224,18/05/2016,Brown-Mccoy,,1578.49,-8174.549999999999,OTHER, 
179736617224,19/05/2016,440139920339745 DAVIS GROUP ,1918.08,,-6256.469999999999,POS, 
179736617224,22/05/2016,Orozco-Robbins,1422.36,,-4834.11,ATM, 
179736617224,22/05/2016,Gomez Group,891.67,,-3942.4399999999996,ATM, 
179736617224,25/05/2016,Parker and Sons,,1745.48,-5687.92,POS, 
179736617224,26/05/2016,798477004461281 ANDERSON AND SONS ,,1424.96,-7112.88,ATM, 
179736617224,28/05/2016,Kemp Ltd,1654.54,,-5458.34,POS, 
179736617224,31/05/2016,75796532003307 WINTERS-CISNEROS ,,1721.51,-7179.85,ATM, 
179736617224,02/06/2016,Mcclain Inc,15.44,,-7164.410000000001,OTHER, 
179736617224,02/06/2016,Black and Sons,,569.82,-7734.2300000000005,POS, 
179736617224,02/06/2016,Giles Ltd,,1589.48,-9323.710000000001,PAYMENT, 
179736617224,04/06/2016,654746710066390 NASH-SHANNON ,1446.48,,-7877.230000000001,PAYMENT, 
179736617224,05/06/2016,Wallace-Carrillo,1456.32,,-6420.910000000002,PAYMENT, 
179736617224,06/06/2016,Garcia Robinson and Richardson,,657.8,-7078.710000000002,PAYMENT, 
179736617224,08/06/2016,Horne LLC,,531.1,-7609.810000000002,PAYMENT, 
179736617224,08/06/2016,178131250237714 NIXON INC ,,1884.74,-9494.550000000003,ATM, 
179736617224,08/06/2016,Reid Franklin and Thompson,18.33,,-9476.220000000003,PAYMENT, 
179736617224,08/06/2016,Cruz Gutierrez and Warner,1298.08,,-8178.140000000003,OTHER, 
179736617224,08/06/2016,Ritter-Boyd,,1980.0,-10158.140000000003,OTHER, 
179736617224,09/06/2016,Walter Sanchez and Johnston,598.3,,-9559.840000000004,PAYMENT, 
179736617224,11/06/2016,712787850626304 HAMILTON GROUP ,129.42,,-9430.420000000004,ATM, 
179736617224,12/06/2016,Smith-Andrews,,744.88,-10175.300000000003,ATM, 
179736617224,15/06/2016,532190032381930 PHELPS AND SONS ,594.06,,-9581.240000000003,PAYMENT, 
179736617224,15/06/2016,688785726113365 HEATH GROUP ,301.65,,-9279.590000000004,ATM, 
179736617224,16/06/2016,818116882664589 SANDERS PLC ,,940.34,-10219.930000000004,POS, 
179736617224,19/06/2016,202611044417078 DAVIES AND SONS ,,145.28,-10365.210000000005,OTHER, 
179736617224,20/06/2016,320645117258824 HOOPER-BOWEN ,1199.52,,-9165.690000000004,OTHER, 
179736617224,22/06/2016,40503661667660 CONLEY-AVILA ,,1032.16,-10197.850000000004,POS, 
179736617224,23/06/2016,Andrade Sims and Davis,,435.29,-10633.140000000005,OTHER, 
179736617224,26/06/2016,Shaw Williamson and Cook,804.96,,-9828.180000000004,PAYMENT, 
179736617224,29/06/2016,Vasquez Group,263.1,,-9565.080000000004,OTHER, 
179736617224,30/06/2016,Ross LLC,,1546.22,-11111.300000000003,OTHER, 
179736617224,01/07/2016,Taylor Group,197.31,,-10913.990000000003,POS, 
179736617224,04/07/2016,755644504957165 LUCERO BROOKS AND WHITE ,,1424.09,-12338.080000000004,OTHER, 
179736617224,05/07/2016,Reyes-Fisher,1346.67,,-10991.410000000003,ATM, 
179736617224,08/07/2016,Martinez Young and Banks,948.2,,-10043.210000000003,ATM, 
179736617224,08/07/2016,Mullins-Harris,,1811.66,-11854.870000000003,PAYMENT, 
179736617224,09/07/2016,Edwards Group,,75.03,-11929.900000000003,OTHER, 
179736617224,12/07/2016,Smith Ltd,230.86,,-11699.040000000003,ATM, 
179736617224,15/07/2016,Hatfield-Anderson,,183.91,-11882.950000000003,PAYMENT, 
179736617224,18/07/2016,970024027963010 MARTINEZ ONEAL AND WILLIAMS ,,173.07,-12056.020000000002,POS, 
179736617224,19/07/2016,858586944804436 JACKSON-CASE ,1118.19,,-10937.830000000002,POS, 
179736617224,22/07/2016,Rodriguez LLC,44.64,,-10893.190000000002,ATM, 
179736617224,23/07/2016,Rivera Trevino and Hall,,271.63,-11164.820000000002,PAYMENT, 
179736617224,26/07/2016,Guerrero Group,224.82,,-10940.000000000002,ATM, 
179736617224,28/07/2016,210975848662076 CHEN-ELLISON ,,51.2,-10991.200000000003,OTHER, 
179736617224,29/07/2016,Owens Martin and Wood,,624.25,-11615.450000000003,ATM, 
179736617224,30/07/2016,810887249147360 REEVES LLC ,,990.83,-12606.280000000002,OTHER, 
179736617224,31/07/2016,25753089289504 LEE INC ,1713.65,,-10892.630000000003,PAYMENT, 
179736617224,31/07/2016,84539688496442 AVERY LTD ,664.94,,-10227.690000000002,ATM, 
179736617224,02/08/2016,Barnett Foster and Garza,,1114.65,-11342.340000000002,POS, 
179736617224,02/08/2016,195573107505508 GAINES GROUP ,181.48,,-11160.860000000002,OTHER, 
179736617224,05/08/2016,Chapman LLC,1410.67,,-9750.190000000002,OTHER, 
179736617224,05/08/2016,151681006647213 RILEY INC ,1161.46,,-8588.730000000003,PAYMENT, 
179736617224,05/08/2016,861782048890165 PHILLIPS PLC ,1236.49,,-7352.240000000003,PAYMENT, 
179736617224,06/08/2016,826067935358590 SINGH DIXON AND KNIGHT ,671.65,,-6680.590000000004,PAYMENT, 
179736617224,06/08/2016,648410548446829 MASON SMITH AND MARTIN ,1222.87,,-5457.720000000004,ATM, 
179736617224,06/08/2016,Thompson-Cervantes,1103.6,,-4354.120000000004,PAYMENT, 
179736617224,08/08/2016,Michael Mccullough and Gomez,,1234.88,-5589.000000000005,POS, 
179736617224,10/08/2016,Berry-Taylor,,1418.01,-7007.010000000005,OTHER, 
179736617224,11/08/2016,887315327883185 GILBERT-HOGAN ,1657.55,,-5349.460000000005,ATM, 
179736617224,14/08/2016,686770479529439 WALSH LTD ,1390.69,,-3958.7700000000045,POS, 
179736617224,17/08/2016,962305891874627 JACKSON LTD ,,1859.15,-5817.920000000005,OTHER, 
179736617224,19/08/2016,Owens-Diaz,,1263.81,-7081.730000000005,POS, 
179736617224,19/08/2016,Hicks Gill and Walker,,1218.33,-8300.060000000005,ATM, 
179736617224,22/08/2016,14446771202434 BAKER GROUP ,1433.45,,-6866.610000000005,OTHER, 
179736617224,24/08/2016,Smith-Atkins,,1343.76,-8210.370000000004,ATM, 
179736617224,24/08/2016,358752846152753 RAMIREZ INC ,487.64,,-7722.730000000004,PAYMENT, 
179736617224,27/08/2016,459690155370765 ZIMMERMAN LTD ,1666.3,,-6056.430000000004,POS, 
179736617224,29/08/2016,Ward Hill and Tate,115.71,,-5940.720000000004,ATM, 
179736617224,29/08/2016,Lang-Santiago,,603.06,-6543.780000000004,PAYMENT, 
179736617224,29/08/2016,Thomas Hicks and Lopez,1675.67,,-4868.110000000004,OTHER, 
179736617224,30/08/2016,Brown-Smith,,1348.91,-6217.020000000004,PAYMENT, 
179736617224,01/09/2016,400798008477121 HAMPTON LTD ,285.85,,-5931.170000000004,PAYMENT, 
179736617224,01/09/2016,Chase-Fleming,339.82,,-5591.350000000004,PAYMENT, 
179736617224,04/09/2016,888972915822682 STONE INC ,1866.01,,-3725.340000000004,POS, 
179736617224,04/09/2016,726918023800042 ROMERO LTD ,,585.69,-4311.030000000004,PAYMENT, 
179736617224,05/09/2016,989139106894248 GARZA LTD ,,194.47,-4505.500000000005,ATM, 
179736617224,06/09/2016,825416727783022 MARTINEZ MCCOY AND JOHNSON ,270.2,,-4235.300000000005,POS, 
179736617224,09/09/2016,248763549552588 COLLIER PLC ,823.36,,-3411.9400000000046,POS, 
179736617224,12/09/2016,297192453336403 WALKER LTD ,1438.9,,-1973.0400000000045,OTHER, 
179736617224,15/09/2016,31702388246214 SMITH DUNCAN AND WHITE ,1817.46,,-155.58000000000447,POS, 
179736617224,18/09/2016,Mckay LLC,,786.07,-941.6500000000045,OTHER, 
179736617224,19/09/2016,Rose Brandt and Jordan,,530.35,-1472.0000000000045,PAYMENT, 
179736617224,20/09/2016,Ochoa and Sons,1550.52,,78.51999999999543,PAYMENT, 
179736617224,22/09/2016,Gibson-Cunningham,,1463.97,-1385.4500000000046,OTHER, 
179736617224,23/09/2016,570800280583270 SCOTT-BROWN ,,214.43,-1599.8800000000047,OTHER, 
179736617224,25/09/2016,809244932087052 HARVEY AND SONS ,40.14,,-1559.7400000000046,PAYMENT, 
179736617224,26/09/2016,Brown-Anderson,,1569.13,-3128.8700000000044,PAYMENT, 
179736617224,28/09/2016,570330460556968 ALEXANDER LLC ,1417.43,,-1711.4400000000044,POS, 
179736617224,01/10/2016,983238139263876 GARNER-PORTER ,561.64,,-1149.8000000000043,ATM, 
179736617224,02/10/2016,786739238663912 SHEPARD-SIMPSON ,1272.78,,122.9799999999957,OTHER, 
179736617224,03/10/2016,612800874035910 BLACKBURN WILLIAMS AND DAVIS ,482.55,,605.5299999999957,PAYMENT, 
179736617224,03/10/2016,960323641184920 DAVIS LLC ,,1161.12,-555.5900000000042,OTHER, 
179736617224,05/10/2016,755522718903237 RAMIREZ FISHER AND CARPENTER ,,1169.64,-1725.2300000000043,OTHER, 
179736617224,06/10/2016,Green-Bryant,667.32,,-1057.9100000000044,OTHER, 
179736617224,08/10/2016,738411242545101 REYES-JENKINS ,,1297.84,-2355.7500000000045,POS, 
179736617224,09/10/2016,Hill LLC,1484.65,,-871.1000000000045,PAYMENT, 
179736617224,10/10/2016,686271263759824 MCDANIEL-CRAWFORD ,,1530.99,-2402.0900000000047,POS, 
179736617224,11/10/2016,Hunter Mccall and Booker,1067.17,,-1334.9200000000046,PAYMENT, 
179736617224,12/10/2016,Kent Inc,,801.3,-2136.220000000005,OTHER, 
179736617224,15/10/2016,584648582871298 WILLIS LTD ,,984.55,-3120.770000000005,PAYMENT, 
179736617224,15/10/2016,Ramos-Johnson,108.66,,-3012.110000000005,ATM, 
179736617224,18/10/2016,389054845270198 HOPKINS THOMPSON AND MORALES ,83.26,,-2928.850000000005,POS, 
179736617224,21/10/2016,758449423386411 HOWE-HARMON ,1114.76,,-1814.090000000005,PAYMENT, 
179736617224,24/10/2016,Evans Williams and Hardy,70.35,,-1743.740000000005,ATM, 
179736617224,27/10/2016,Flores Rosales and Massey,1638.14,,-105.60000000000491,PAYMENT, 
179736617224,29/10/2016,Valdez-Ellis,1234.77,,1129.169999999995,OTHER, 
179736617224,01/11/2016,409516627114263 MILLER PLC ,,1200.73,-71.56000000000495,POS, 
179736617224,04/11/2016,Schultz Smith and Ward,,310.33,-381.89000000000493,OTHER, 
179736617224,07/11/2016,590717142017395 LOPEZ-PETERSON ,1895.78,,1513.889999999995,ATM, 
179736617224,08/11/2016,Baker and Sons,928.23,,2442.1199999999953,OTHER, 
179736617224,10/11/2016,Sanchez and Sons,,773.89,1668.2299999999955,PAYMENT, 
179736617224,11/11/2016,170184438496350 REEVES-GRAVES ,,389.73,1278.4999999999955,PAYMENT, 
179736617224,12/11/2016,208916265317409 ROSE-MORA ,1159.8,,2438.2999999999956,POS, 
179736617224,12/11/2016,487915329910942 CAIN SANTOS AND GREGORY ,1441.8,,3880.099999999996,ATM, 
179736617224,15/11/2016,407946546956508 WILLIAMS PLC ,922.27,,4802.369999999995,PAYMENT, 
179736617224,18/11/2016,93599505889869 BRADFORD EVANS AND BURKE ,897.65,,5700.019999999995,PAYMENT, 
179736617224,21/11/2016,551762585610090 FITZGERALD AND SONS ,,1109.55,4590.469999999995,OTHER, 
179736617224,24/11/2016,Richmond-Garcia,1329.23,,5919.699999999995,OTHER, 
179736617224,24/11/2016,Campbell PLC,499.65,,6419.349999999995,PAYMENT, 
179736617224,26/11/2016,Rivera-Bailey,,1907.1,4512.2499999999945,PAYMENT, 
179736617224,26/11/2016,Woods Gonzalez and Hill,,290.97,4221.279999999994,PAYMENT, 
179736617224,28/11/2016,Ramos and Sons,,947.12,3274.1599999999944,ATM, 
179736617224,29/11/2016,555033779509928 PARKER-JAMES ,934.41,,4208.569999999994,PAYMENT, 
179736617224,02/12/2016,Jones PLC,,1741.06,2467.5099999999943,OTHER, 
179736617224,05/12/2016,415324501212885 SMITH WINTERS AND CHAPMAN ,1780.01,,4247.519999999994,PAYMENT, 
179736617224,06/12/2016,764778023195431 MARSHALL GROUP ,,730.67,3516.849999999994,OTHER, 
179736617224,07/12/2016,Stewart Ltd,428.53,,3945.3799999999937,PAYMENT, 
179736617224,07/12/2016,991324318301097 CAMPBELL CROSS AND BURNS ,,1789.49,2155.889999999994,OTHER, 
179736617224,08/12/2016,Le PLC,,647.35,1508.539999999994,POS, 
179736617224,10/12/2016,Smith Ltd,1104.31,,2612.849999999994,ATM, 
179736617224,13/12/2016,804038116610149 GARCIA COHEN AND DONOVAN ,1946.37,,4559.219999999994,OTHER, 
179736617224,16/12/2016,633889025298046 HENDERSON WEEKS AND BOLTON ,1384.81,,5944.029999999993,PAYMENT, 
179736617224,16/12/2016,361669717094703 CHRISTIAN PLC ,,424.79,5519.239999999993,PAYMENT, 
179736617224,17/12/2016,Parker Davis and Potts,,1967.59,3551.6499999999933,PAYMENT, 
179736617224,17/12/2016,Grant-Coleman,,1975.67,1575.9799999999932,PAYMENT, 
179736617224,18/12/2016,934448108967133 HUGHES BARNETT AND HART ,,1255.09,320.8899999999933,OTHER, 
179736617224,20/12/2016,Love-Stone,302.01,,622.8999999999933,PAYMENT, 
179736617224,20/12/2016,314743840689467 COOK LLC ,928.94,,1551.8399999999933,PAYMENT, 
179736617224,23/12/2016,Hill-Smith,,417.21,1134.6299999999933,ATM, 
179736617224,26/12/2016,Thompson Ashley and Simpson,,1877.12,-742.4900000000066,PAYMENT, 
179736617224,29/12/2016,Sullivan LLC,,1980.28,-2722.770000000007,PAYMENT, 
179736617224,30/12/2016,217332036350721 WALTERS GROUP ,679.0,,-2043.7700000000068,ATM, 
179736617224,31/12/2016,735399973474132 SUAREZ WARD AND LOPEZ ,526.34,,-1517.4300000000067,POS, 
179736617224,02/01/2017,Collins PLC,,1597.1,-3114.5300000000066,POS, 
179736617224,04/01/2017,Morgan Smith and Warner,,1619.39,-4733.920000000006,ATM, 
179736617224,04/01/2017,703422113026050 FISCHER MORRIS AND KING ,473.08,,-4260.8400000000065,PAYMENT, 
179736617224,06/01/2017,486130395753413 WILLIAMS PLC ,,1741.45,-6002.290000000006,OTHER, 
179736617224,08/01/2017,Shepherd-Munoz,1119.42,,-4882.870000000006,POS, 
179736617224,11/01/2017,368383750360096 SMITH-PERRY ,,1219.8,-6102.670000000006,PAYMENT, 
179736617224,11/01/2017,Evans Sullivan and Johnson,,1833.92,-7936.5900000000065,POS, 
179736617224,13/01/2017,388563990670920 LOVE LTD ,,34.27,-7970.860000000007,POS, 
179736617224,14/01/2017,Clay Inc,,1850.65,-9821.510000000007,PAYMENT, 
179736617224,14/01/2017,Clayton-Jones,,287.1,-10108.610000000008,POS, 
179736617224,16/01/2017,Rose Jimenez and Smith,21.09,,-10087.520000000008,POS, 
179736617224,17/01/2017,371142216892420 LUTZ FAULKNER AND SMITH ,,1651.0,-11738.520000000008,ATM, 
179736617224,17/01/2017,Carr Cain and Richard,606.13,,-11132.390000000009,OTHER, 
179736617224,18/01/2017,Cole Arnold and Turner,,1438.37,-12570.76000000001,PAYMENT, 
179736617224,20/01/2017,481673368977347 RAMIREZ LITTLE AND KELLY ,30.26,,-12540.50000000001,POS, 
179736617224,21/01/2017,Perry Barnett and Clark,577.8,,-11962.70000000001,OTHER, 
179736617224,24/01/2017,Harvey Inc,,224.47,-12187.17000000001,PAYMENT, 
179736617224,24/01/2017,368168802712130 CARROLL-BOWMAN ,182.76,,-12004.410000000009,PAYMENT, 
179736617224,26/01/2017,Carter Wolf and Gray,,227.02,-12231.43000000001,POS, 
179736617224,28/01/2017,Byrd PLC,,1629.51,-13860.94000000001,OTHER, 
179736617224,30/01/2017,654796503451864 BLAIR LTD ,1132.62,,-12728.32000000001,OTHER, 
179736617224,01/02/2017,954953219773749 NELSON RODRIGUEZ AND ROBERTSON ,877.04,,-11851.28000000001,ATM, 
179736617224,02/02/2017,852421479910052 WELLS-SOTO ,,1918.79,-13770.07000000001,POS, 
179736617224,02/02/2017,113070789602515 MOONEY-HENDERSON ,1201.56,,-12568.510000000011,ATM, 
179736617224,02/02/2017,431800086191984 TANNER LLC ,,239.9,-12808.41000000001,OTHER, 
179736617224,03/02/2017,815397426664713 ROGERS GROUP ,,1229.81,-14038.22000000001,ATM, 
179736617224,03/02/2017,Turner Campbell and Hamilton,,415.47,-14453.69000000001,OTHER, 
179736617224,05/02/2017,256823416775793 PENA-LEONARD ,837.84,,-13615.85000000001,ATM, 
179736617224,08/02/2017,Clayton and Sons,,27.59,-13643.44000000001,PAYMENT, 
179736617224,10/02/2017,Lee-Rodriguez,511.65,,-13131.79000000001,POS, 
179736617224,12/02/2017,Maynard Ellis and Jones,616.9,,-12514.89000000001,PAYMENT, 
179736617224,15/02/2017,Sims Group,,30.83,-12545.72000000001,PAYMENT, 
179736617224,17/02/2017,846228697524807 GORDON-JIMENEZ ,1748.14,,-10797.58000000001,ATM, 
179736617224,17/02/2017,Turner Inc,,1836.85,-12634.430000000011,OTHER, 
179736617224,17/02/2017,595968484659580 JOHNSON-DELACRUZ ,1032.72,,-11601.710000000012,OTHER, 
179736617224,20/02/2017,Garrett-Thompson,201.19,,-11400.520000000011,POS, 
179736617224,22/02/2017,281516532508766 HALL DOMINGUEZ AND HARRIS ,,1737.39,-13137.91000000001,POS, 
179736617224,22/02/2017,Little-Castillo,894.52,,-12243.39000000001,PAYMENT, 
179736617224,22/02/2017,Kelly Schneider and Johnson,,1781.55,-14024.94000000001,ATM, 
179736617224,25/02/2017,44292305076256 WILLIAMSON-THOMPSON ,,628.9,-14653.84000000001,ATM, 
179736617224,26/02/2017,843886114976257 CAMPBELL LARA AND SILVA ,,1482.82,-16136.660000000009,ATM, 
179736617224,01/03/2017,681483611504370 CARTER-PENA ,1659.75,,-14476.910000000009,ATM, 
179736617224,03/03/2017,12038531864935 CHANG RIVERA AND BROWN ,84.13,,-14392.78000000001,ATM, 
179736617224,05/03/2017,352942883825621 RUSSO LTD ,1258.37,,-13134.41000000001,OTHER, 
179736617224,08/03/2017,Collins LLC,1140.96,,-11993.450000000012,PAYMENT, 
179736617224,11/03/2017,269733621461216 SCHROEDER-REESE ,320.67,,-11672.780000000012,OTHER, 
179736617224,13/03/2017,Young-Bryant,1803.41,,-9869.370000000012,POS, 
179736617224,13/03/2017,74695150578271 DAVIS AND SONS ,632.17,,-9237.200000000012,ATM, 
179736617224,15/03/2017,528079820291401 REID WASHINGTON AND CONTRERAS ,,1585.22,-10822.420000000011,OTHER, 
179736617224,18/03/2017,79170012931629 PATRICK LLC ,1981.74,,-8840.680000000011,POS, 
179736617224,18/03/2017,393427784126656 MAYNARD FLYNN AND JONES ,325.89,,-8514.790000000012,PAYMENT, 
179736617224,20/03/2017,66347557684958 ESTRADA GROUP ,1083.71,,-7431.080000000012,POS, 
179736617224,22/03/2017,652676677033138 GIBSON INC ,,1908.41,-9339.490000000013,PAYMENT, 
179736617224,23/03/2017,745800476981446 DIAZ LOWE AND HOPKINS ,1620.05,,-7719.440000000012,OTHER, 
179736617224,25/03/2017,169294450977188 LEWIS-SANDERS ,,1870.1,-9589.540000000012,ATM, 
179736617224,28/03/2017,358221784114334 EDWARDS-JOSEPH ,,358.97,-9948.510000000011,ATM, 
179736617224,29/03/2017,Perez Ltd,,1471.08,-11419.590000000011,POS, 
179736617224,29/03/2017,90357215632984 BENSON LTD ,565.5,,-10854.090000000011,PAYMENT, 
179736617224,29/03/2017,272979116669306 BROWN-GARCIA ,,603.02,-11457.110000000011,ATM, 
179736617224,31/03/2017,390591927608305 MCGUIRE SANTIAGO AND SNYDER ,,1892.26,-13349.370000000012,PAYMENT, 
179736617224,03/04/2017,Brooks Burnett and Smith,387.13,,-12962.240000000013,PAYMENT, 
179736617224,03/04/2017,812868730056192 PEARSON-FRY ,,666.39,-13628.630000000012,PAYMENT, 
179736617224,03/04/2017,Patterson-Hernandez,420.86,,-13207.770000000011,POS, 
179736617224,04/04/2017,674460435884925 MORALES AND SONS ,,227.86,-13435.630000000012,PAYMENT, 
179736617224,07/04/2017,220112444733967 LAM-ROJAS ,,1431.85,-14867.480000000012,ATM, 
179736617224,08/04/2017,Christian LLC,,1478.74,-16346.220000000012,POS, 
179736617224,09/04/2017,Smith Wade and Miller,,1406.32,-17752.54000000001,ATM, 
179736617224,09/04/2017,801872009374543 BOND MILLER AND MARTINEZ ,,1466.38,-19218.920000000013,OTHER, 
179736617224,09/04/2017,Delgado-Vargas,,823.62,-20042.54000000001,OTHER, 
179736617224,11/04/2017,370446936875528 CANTU GROUP ,,1561.98,-21604.52000000001,ATM, 
179736617224,11/04/2017,Ellis-Moore,1348.57,,-20255.95000000001,PAYMENT, 
179736617224,14/04/2017,44783989271352 PHILLIPS INC ,1813.84,,-18442.11000000001,POS, 
179736617224,17/04/2017,Fletcher Group,521.67,,-17920.440000000013,POS, 
179736617224,20/04/2017,Dunn-Coleman,1331.73,,-16588.710000000014,PAYMENT, 
179736617224,20/04/2017,Hensley Ltd,,406.43,-16995.140000000014,ATM, 
179736617224,20/04/2017,Sims Ltd,,1061.78,-18056.920000000013,POS, 
179736617224,22/04/2017,570289357846633 HOPKINS-GILMORE ,374.09,,-17682.830000000013,PAYMENT, 
179736617224,24/04/2017,Williams-Kirby,,1994.63,-19677.460000000014,PAYMENT, 
179736617224,24/04/2017,943141978478936 SMITH LTD ,1166.45,,-18511.010000000013,POS, 
179736617224,24/04/2017,572583398730514 KEMP PLC ,518.97,,-17992.04000000001,OTHER, 
179736617224,26/04/2017,261529851035208 ROGERS GROUP ,1236.04,,-16756.00000000001,PAYMENT, 
179736617224,29/04/2017,Smith Larsen and Garcia,,1533.2,-18289.20000000001,OTHER, 
179736617224,30/04/2017,Mccormick Hamilton and Roman,1020.07,,-17269.130000000012,PAYMENT, 
179736617224,02/05/2017,Walters-Simmons,170.32,,-17098.810000000012,POS, 
179736617224,04/05/2017,Martin Suarez and Rice,1332.19,,-15766.620000000012,OTHER, 
179736617224,05/05/2017,324184972474286 PERRY PETERSON AND MCGUIRE ,,1100.92,-16867.54000000001,ATM, 
179736617224,06/05/2017,234953087226795 MURRAY CAMPOS AND MCDANIEL ,,1816.27,-18683.810000000012,ATM, 
179736617224,06/05/2017,Gill-Gonzalez,,934.7,-19618.510000000013,ATM, 
179736617224,09/05/2017,Ward Group,,1861.55,-21480.060000000012,PAYMENT, 
179736617224,10/05/2017,Palmer LLC,1454.83,,-20025.23000000001,PAYMENT, 
179736617224,10/05/2017,19532256807027 JONES JARVIS AND PENA ,1309.11,,-18716.12000000001,ATM, 
179736617224,12/05/2017,723662760191905 LANG MAY AND MANN ,,1218.54,-19934.66000000001,OTHER, 
179736617224,12/05/2017,Gonzalez Fletcher and Scott,210.39,,-19724.27000000001,POS, 
179736617224,12/05/2017,758134437633607 GREEN MURPHY AND LOZANO ,439.28,,-19284.990000000013,ATM, 
179736617224,13/05/2017,508873520702555 SANDERS PLC ,,1684.71,-20969.70000000001,PAYMENT, 
179736617224,15/05/2017,988587977873095 RASMUSSEN-STANLEY ,,1641.53,-22611.23000000001,ATM, 
179736617224,15/05/2017,440842267162072 THORNTON ARELLANO AND REYES ,593.62,,-22017.61000000001,OTHER, 
179736617224,15/05/2017,710109671378783 BONILLA-SMITH ,1704.37,,-20313.240000000013,PAYMENT, 
179736617224,17/05/2017,Smith Flores and Kelley,716.97,,-19596.27000000001,POS, 
179736617224,20/05/2017,Pratt King and Johnson,1399.19,,-18197.080000000013,OTHER, 
179736617224,20/05/2017,214217353626947 WRIGHT AND SONS ,1940.87,,-16256.210000000014,OTHER, 
179736617224,21/05/2017,51586573826143 JUAREZ PLC ,872.62,,-15383.590000000013,PAYMENT, 
179736617224,21/05/2017,605993445890954 THOMPSON RUSSELL AND HICKS ,265.2,,-15118.390000000012,PAYMENT, 
179736617224,21/05/2017,Knight and Sons,365.49,,-14752.900000000012,OTHER, 
179736617224,23/05/2017,Whitaker Farmer and Mckinney,1537.06,,-13215.840000000013,ATM, 
179736617224,23/05/2017,Obrien Group,844.57,,-12371.270000000013,ATM, 
179736617224,24/05/2017,356064977560259 NUNEZ-CLARK ,,240.77,-12612.040000000014,POS, 
179736617224,27/05/2017,879460699281498 COHEN AND SONS ,,1778.72,-14390.760000000013,PAYMENT, 
179736617224,29/05/2017,Myers Williams and Zuniga,1533.37,,-12857.390000000014,ATM, 
179736617224,31/05/2017,Evans-Davis,,1258.22,-14115.610000000013,PAYMENT, 
179736617224,01/06/2017,135816271704101 FOWLER-WALTON ,983.95,,-13131.660000000013,PAYMENT, 
179736617224,02/06/2017,510249945496245 TRAN PLC ,1848.85,,-11282.810000000012,PAYMENT, 
179736617224,04/06/2017,925074884210750 STONE ROGERS AND NORTON ,,1239.66,-12522.470000000012,ATM, 
179736617224,07/06/2017,458985451917653 VASQUEZ-JENNINGS ,,1322.15,-13844.620000000012,PAYMENT, 
179736617224,09/06/2017,750146558827769 HILL DAVIS AND RIOS ,,9.97,-13854.590000000011,ATM, 
179736617224,10/06/2017,Berg LLC,,910.7,-14765.290000000012,PAYMENT, 
179736617224,11/06/2017,Downs Ramirez and Kane,965.11,,-13800.180000000011,ATM, 
179736617224,14/06/2017,602359626782558 WARD AND SONS ,1367.12,,-12433.060000000012,OTHER, 
179736617224,15/06/2017,Ramirez-Cameron,,228.84,-12661.900000000012,OTHER, 
179736617224,17/06/2017,Bird-Carney,1050.11,,-11611.790000000012,ATM, 
179736617224,19/06/2017,450422599656253 PEREZ-HARRISON ,,1367.79,-12979.580000000013,PAYMENT, 
179736617224,21/06/2017,Chen Acosta and Long,407.48,,-12572.100000000013,POS, 
179736617224,21/06/2017,228678238558965 JOHNSON AND SONS ,430.4,,-12141.700000000013,PAYMENT, 
179736617224,22/06/2017,Chambers Inc,160.6,,-11981.100000000013,ATM, 
179736617224,25/06/2017,257530025712652 SIMMONS-WARD ,552.05,,-11429.050000000014,ATM, 
179736617224,27/06/2017,Campbell Ltd,773.1,,-10655.950000000013,PAYMENT, 
179736617224,30/06/2017,839658940075825 ALLEN MORALES AND MOSLEY ,,1329.7,-11985.650000000014,OTHER, 
179736617224,30/06/2017,Bell PLC,1911.69,,-10073.960000000014,POS, 
179736617224,03/07/2017,Williams-Ellis,,744.32,-10818.280000000013,PAYMENT, 
179736617224,05/07/2017,Johnson Group,1162.71,,-9655.570000000014,ATM, 
179736617224,07/07/2017,811049439548254 DIXON-BROWN ,1853.29,,-7802.280000000014,PAYMENT, 
179736617224,08/07/2017,Yang-Abbott,89.79,,-7712.490000000014,PAYMENT, 
179736617224,10/07/2017,464770361912810 JIMENEZ-WRIGHT ,,407.13,-8119.620000000014,PAYMENT, 
179736617224,10/07/2017,Baker Sanders and Ramirez,1130.44,,-6989.180000000015,OTHER, 
179736617224,12/07/2017,Randall Group,1080.43,,-5908.750000000015,ATM, 
179736617224,13/07/2017,781345820682680 WILLIAMSON INC ,,731.91,-6640.660000000014,ATM, 
179736617224,15/07/2017,Simmons Inc,,1090.96,-7731.620000000014,PAYMENT, 
179736617224,15/07/2017,67603597111324 FRIEDMAN PLC ,,1536.69,-9268.310000000014,ATM, 
179736617224,17/07/2017,Mays Massey and Smith,1280.95,,-7987.360000000014,POS, 
179736617224,19/07/2017,Lee Fletcher and Klein,1225.47,,-6761.890000000014,POS, 
179736617224,22/07/2017,Mccarty-Rodriguez,,1309.2,-8071.090000000014,OTHER, 
179736617224,22/07/2017,Tyler-Smith,,38.66,-8109.750000000014,OTHER, 
179736617224,24/07/2017,345665726797427 ROBINSON-WHITE ,1585.76,,-6523.990000000013,ATM, 
179736617224,25/07/2017,958688619976056 HANSEN-WOODS ,1626.13,,-4897.860000000013,OTHER, 
179736617224,27/07/2017,753641452472758 WILLIAMS THOMPSON AND HARRIS ,,1851.93,-6749.790000000014,ATM, 
179736617224,30/07/2017,449229204895529 MORGAN ARMSTRONG AND ALVAREZ ,636.73,,-6113.060000000014,OTHER, 
179736617224,30/07/2017,592210506000072 SANCHEZ BROWN AND BROWN ,1323.17,,-4789.890000000014,POS, 
179736617224,31/07/2017,459847183834044 GUZMAN GROUP ,523.22,,-4266.670000000014,POS, 
179736617224,03/08/2017,309237540225600 WALLER PLC ,,672.8,-4939.470000000014,PAYMENT, 
179736617224,06/08/2017,Russell-Knight,1277.86,,-3661.610000000014,OTHER, 
179736617224,07/08/2017,957795041034764 BRYAN WARREN AND KNIGHT ,,1954.78,-5616.390000000014,POS, 
179736617224,09/08/2017,Miller Wright and Thomas,1254.4,,-4361.990000000014,OTHER, 
179736617224,11/08/2017,Baker Kemp and Johnson,,248.51,-4610.500000000015,ATM, 
179736617224,12/08/2017,544992878678210 THOMAS-HICKS ,800.25,,-3810.2500000000146,PAYMENT, 
179736617224,13/08/2017,899106632639904 HERRERA CRUZ AND THOMPSON ,356.29,,-3453.9600000000146,ATM, 
179736617224,16/08/2017,822342001457204 EDWARDS VANCE AND MONTOYA ,1690.5,,-1763.4600000000146,ATM, 
179736617224,18/08/2017,623960074685023 DAVIS KEITH AND WARREN ,,833.45,-2596.9100000000144,POS, 
179736617224,20/08/2017,516642031515942 YOUNG WATERS AND WOOD ,899.72,,-1697.1900000000144,ATM, 
179736617224,22/08/2017,752090815310482 LEWIS-DAVIS ,467.03,,-1230.1600000000144,ATM, 
179736617224,24/08/2017,Finley Taylor and Burnett,,494.68,-1724.8400000000145,OTHER, 
179736617224,24/08/2017,489026515610718 RICHARDSON-MARTINEZ ,1244.07,,-480.77000000001453,ATM, 
179736617224,24/08/2017,Walker-Peters,1966.18,,1485.4099999999855,ATM, 
179736617224,25/08/2017,935241418282642 SCHNEIDER CUNNINGHAM AND WHITE ,1392.74,,2878.1499999999855,PAYMENT, 
179736617224,27/08/2017,Baker Miller and Reed,1895.86,,4774.009999999986,POS, 
179736617224,28/08/2017,Brown Ward and Cline,386.32,,5160.329999999985,ATM, 
179736617224,29/08/2017,317279538125499 GREEN MACDONALD AND YOUNG ,1656.1,,6816.429999999986,OTHER, 
179736617224,31/08/2017,Hampton-Aguilar,,1840.25,4976.179999999986,POS, 
179736617224,01/09/2017,489901597227311 STEVENSON LLC ,664.0,,5640.179999999986,OTHER, 
179736617224,01/09/2017,842707372643845 HUNTER-GREGORY ,872.47,,6512.649999999986,PAYMENT, 
179736617224,01/09/2017,682254367372366 MCCULLOUGH LTD ,1457.7,,7970.349999999986,OTHER, 
179736617224,02/09/2017,533547822935988 MARTINEZ-HERNANDEZ ,1511.69,,9482.039999999986,OTHER, 
179736617224,02/09/2017,Graham Soto and Rosales,1865.46,,11347.499999999985,PAYMENT, 
179736617224,03/09/2017,Thomas and Sons,1893.31,,13240.809999999985,PAYMENT, 
179736617224,05/09/2017,Thompson-Shaw,1877.67,,15118.479999999985,POS, 
179736617224,08/09/2017,182160220733932 WILLIAMS PLC ,1327.95,,16446.429999999986,POS, 
179736617224,11/09/2017,466844386187347 MORRIS EDWARDS AND GRIFFIN ,980.94,,17427.369999999984,OTHER, 
179736617224,12/09/2017,219973366901651 BROWN-JOHNSON ,,759.27,16668.099999999984,PAYMENT, 
179736617224,14/09/2017,282957047373987 CALLAHAN LTD ,734.51,,17402.609999999982,POS, 
179736617224,15/09/2017,Mcclure-Anderson,,515.21,16887.399999999983,OTHER, 
179736617224,15/09/2017,756940720923463 WALL KING AND MCGUIRE ,1974.57,,18861.969999999983,ATM, 
179736617224,17/09/2017,Stokes and Sons,624.99,,19486.959999999985,POS, 
179736617224,20/09/2017,Brown-Myers,,1934.57,17552.389999999985,POS, 
179736617224,20/09/2017,Mullen Ltd,1813.8,,19366.189999999984,ATM, 
179736617224,21/09/2017,Miller Harrison and Hernandez,313.39,,19679.579999999984,POS, 
179736617224,23/09/2017,Cameron LLC,395.52,,20075.099999999984,POS, 
179736617224,26/09/2017,Simpson Bell and Ward,,57.12,20017.979999999985,PAYMENT, 
179736617224,28/09/2017,Dunn-Green,,933.09,19084.889999999985,POS, 
179736617224,29/09/2017,Cross Foster and Johns,,1251.75,17833.139999999985,OTHER, 
179736617224,01/10/2017,414437840327120 BEARD GROUP ,1906.92,,19740.059999999983,ATM, 
179736617224,01/10/2017,384878554635641 MILLS GROUP ,1391.25,,21131.309999999983,OTHER, 
179736617224,03/10/2017,517446726032703 WILLIAMS LTD ,1907.74,,23039.049999999985,ATM, 
179736617224,05/10/2017,237117499639777 FOSTER FLYNN AND STRICKLAND ,56.01,,23095.059999999983,ATM, 
179736617224,05/10/2017,Blair-Taylor,,1418.84,21676.219999999983,OTHER, 
179736617224,07/10/2017,869059095478473 WILLIAMS LTD ,,1059.75,20616.469999999983,POS, 
179736617224,10/10/2017,Stafford-Sheppard,338.36,,20954.829999999984,PAYMENT, 
179736617224,12/10/2017,Bowen Group,1967.21,,22922.039999999983,POS, 
179736617224,12/10/2017,Wilson Inc,1414.31,,24336.349999999984,POS, 
179736617224,14/10/2017,784507008355528 PEREZ-HUFFMAN ,,1883.09,22453.259999999984,POS, 
179736617224,15/10/2017,229344874561278 GOMEZ-ARMSTRONG ,,1349.03,21104.229999999985,ATM, 
179736617224,15/10/2017,Nichols-Edwards,,1632.74,19471.489999999983,OTHER, 
179736617224,16/10/2017,Dunn-Rogers,478.52,,19950.009999999984,PAYMENT, 
179736617224,18/10/2017,651260991530249 WALLACE GROUP ,,611.46,19338.549999999985,ATM, 
179736617224,21/10/2017,Tucker PLC,,127.41,19211.139999999985,ATM, 
179736617224,21/10/2017,Murphy Group,319.19,,19530.329999999984,ATM, 
179736617224,22/10/2017,Barker PLC,978.53,,20508.859999999982,OTHER, 
179736617224,24/10/2017,Black Jackson and Mack,,156.56,20352.29999999998,OTHER, 
179736617224,26/10/2017,851737816011252 SHAFFER GROUP ,1516.72,,21869.019999999982,OTHER, 
179736617224,26/10/2017,355076883955469 MARTIN WATERS AND SELLERS ,1622.26,,23491.27999999998,ATM, 
179736617224,26/10/2017,712138251369702 MILLS MILLER AND MILLER ,,1135.87,22355.40999999998,POS, 
179736617224,26/10/2017,415446952539793 SMITH-WATTS ,1439.78,,23795.18999999998,ATM, 
179736617224,26/10/2017,628794199791889 WILLIAMS-HARVEY ,1929.58,,25724.769999999982,POS, 
179736617224,27/10/2017,524912500124870 CARLSON-SMITH ,661.77,,26386.539999999983,PAYMENT, 
179736617224,28/10/2017,Benton Thompson and Silva,,1043.44,25343.099999999984,OTHER, 
179736617224,31/10/2017,89797138320043 REED-SMITH ,,800.35,24542.749999999985,ATM, 
179736617224,02/11/2017,832238176855777 CLARK MCCORMICK AND NIXON ,1223.13,,25765.879999999986,POS, 
179736617224,03/11/2017,994323987942556 GILBERT PLC ,,940.57,24825.309999999987,OTHER, 
179736617224,04/11/2017,Smith Group,,1799.54,23025.769999999986,ATM, 
179736617224,05/11/2017,115826085654794 ROCHA BUSH AND RAY ,1157.22,,24182.989999999987,PAYMENT, 
179736617224,06/11/2017,Stewart-Sanchez,,823.42,23359.56999999999,PAYMENT, 
179736617224,08/11/2017,512703676614117 SCHWARTZ-WILKERSON ,119.62,,23479.189999999988,POS, 
179736617224,08/11/2017,676005738113205 AVILA-WALKER ,,319.6,23159.58999999999,POS, 
179736617224,10/11/2017,457571403620702 HORN-HARRIS ,,1296.17,21863.41999999999,POS, 
179736617224,12/11/2017,Johnson Inc,752.66,,22616.07999999999,POS, 
179736617224,13/11/2017,496187043492925 WONG LLC ,1170.05,,23786.12999999999,OTHER, 
179736617224,16/11/2017,378736335848358 WILLIAMS-BELL ,758.59,,24544.71999999999,POS, 
179736617224,16/11/2017,Thompson Cobb and Reid,,1176.94,23367.77999999999,PAYMENT, 
179736617224,17/11/2017,88449581206197 HOOPER SALAS AND ALVARADO ,,1094.71,22273.069999999992,POS, 
179736617224,18/11/2017,Henderson Parker and Green,1851.15,,24124.219999999994,ATM, 
179736617224,19/11/2017,851306001629101 FREDERICK LLC ,723.73,,24847.949999999993,PAYMENT, 
179736617224,21/11/2017,140034670142055 DUNN GROUP ,630.3,,25478.249999999993,OTHER, 
179736617224,24/11/2017,Johnson Jennings and Smith,,535.53,24942.719999999994,ATM, 
179736617224,27/11/2017,116304642266602 MILLER MARTINEZ AND HILL ,,1421.87,23520.849999999995,POS, 
179736617224,28/11/2017,652480247388168 BRIDGES-LEWIS ,1460.5,,24981.349999999995,PAYMENT, 
179736617224,28/11/2017,Baker Jones and Ritter,1494.91,,26476.259999999995,PAYMENT, 
179736617224,01/12/2017,Rogers-Byrd,,1221.94,25254.319999999996,OTHER, 
179736617224,03/12/2017,225239320659687 FORD LLC ,,834.17,24420.149999999998,POS, 
179736617224,04/12/2017,103725377670418 LAM PLC ,,787.37,23632.78,OTHER, 
179736617224,05/12/2017,46298574986593 PAUL LTD ,,1334.6,22298.18,ATM, 
179736617224,05/12/2017,334740690133442 PUGH LLC ,,1453.61,20844.57,POS, 
179736617224,06/12/2017,28647013773039 WRIGHT-BOYLE ,,318.67,20525.9,ATM, 
179736617224,08/12/2017,30178287862476 NGUYEN-MOORE ,,1738.38,18787.52,OTHER, 
179736617224,08/12/2017,182284545246633 PEREZ-ANDERSON ,,102.68,18684.84,PAYMENT, 
179736617224,09/12/2017,Lane PLC,,104.69,18580.15,PAYMENT, 
179736617224,11/12/2017,Whitehead-Walton,2.06,,18582.210000000003,OTHER, 
179736617224,14/12/2017,Oneal and Sons,,1655.45,16926.760000000002,ATM, 
179736617224,14/12/2017,817972112289886 RUSH-YATES ,536.04,,17462.800000000003,OTHER, 
179736617224,14/12/2017,Garcia Gregory and Strong,,549.57,16913.230000000003,OTHER, 
179736617224,14/12/2017,571774093381389 JOHNSON-DANIELS ,115.27,,17028.500000000004,OTHER, 
179736617224,14/12/2017,420947051154721 HARRISON INC ,1978.43,,19006.930000000004,OTHER, 
179736617224,17/12/2017,Thomas-Peterson,1727.87,,20734.800000000003,POS, 
179736617224,17/12/2017,Shannon LLC,250.33,,20985.130000000005,ATM, 
179736617224,19/12/2017,908534787391605 CHAVEZ-SMITH ,,102.66,20882.470000000005,ATM, 
179736617224,19/12/2017,195611824095233 THOMAS-HUDSON ,,781.56,20100.910000000003,ATM, 
179736617224,21/12/2017,967131943361013 CARPENTER HILL AND CHANG ,433.21,,20534.120000000003,OTHER, 
179736617224,22/12/2017,137778059691351 THOMAS MILLER AND KING ,1002.75,,21536.870000000003,OTHER, 
179736617224,25/12/2017,276161302475623 PARK-GARCIA ,,1249.52,20287.350000000002,PAYMENT, 
179736617224,27/12/2017,Davis Moran and Johns,,1844.21,18443.140000000003,OTHER, 
179736617224,30/12/2017,Collier LLC,358.68,,18801.820000000003,POS, 
179736617224,02/01/2018,Myers Hutchinson and Crosby,,7.67,18794.150000000005,PAYMENT, 
179736617224,02/01/2018,Carrillo-Rojas,676.37,,19470.520000000004,ATM, 
179736617224,05/01/2018,509908693135456 COX ANDERSON AND LONG ,877.68,,20348.200000000004,ATM, 
179736617224,08/01/2018,Harrington-Butler,1504.85,,21853.050000000003,PAYMENT, 
179736617224,08/01/2018,411138078254658 FLORES-EVANS ,1171.43,,23024.480000000003,POS, 
179736617224,10/01/2018,Smith Simpson and Gilbert,338.13,,23362.610000000004,OTHER, 
179736617224,13/01/2018,Mclean Lin and Patterson,,1916.03,21446.580000000005,OTHER, 
179736617224,16/01/2018,Bennett Inc,,1898.18,19548.400000000005,PAYMENT, 
179736617224,16/01/2018,247092336525507 SCOTT HAMMOND AND NOBLE ,548.34,,20096.740000000005,ATM, 
179736617224,16/01/2018,521157551967589 VEGA WHITE AND PERRY ,660.72,,20757.460000000006,POS, 
179736617224,19/01/2018,Jones Group,732.25,,21489.710000000006,ATM, 
179736617224,19/01/2018,Gonzalez-Hammond,,564.53,20925.180000000008,OTHER, 
179736617224,20/01/2018,Bush Miller and Charles,1756.38,,22681.56000000001,OTHER, 
179736617224,23/01/2018,171999275120371 HAYES-DOYLE ,,1519.72,21161.840000000007,OTHER, 
179736617224,23/01/2018,30592261076808 BARRETT MCLAUGHLIN AND DONOVAN ,6.2,,21168.040000000008,ATM, 
179736617224,24/01/2018,203960941124315 FLORES-WEST ,45.27,,21213.31000000001,PAYMENT, 
179736617224,24/01/2018,Davis Group,822.35,,22035.660000000007,PAYMENT, 
179736617224,26/01/2018,869825984667222 PAGE LTD ,1022.94,,23058.600000000006,OTHER, 
179736617224,29/01/2018,732247761883634 BAXTER AND SONS ,,1066.8,21991.800000000007,OTHER, 
179736617224,29/01/2018,Howard Winters and Garner,,155.22,21836.580000000005,PAYMENT, 
179736617224,30/01/2018,Ferguson-Velasquez,1899.1,,23735.680000000004,POS, 
179736617224,01/02/2018,Jefferson-Hooper,,211.6,23524.080000000005,ATM, 
179736617224,01/02/2018,596695572298314 PORTER PLC ,,222.65,23301.430000000004,PAYMENT, 
179736617224,03/02/2018,112059579407447 STEVENS-WILLIAMSON ,72.98,,23374.410000000003,POS, 
179736617224,05/02/2018,Mills PLC,1159.13,,24533.540000000005,ATM, 
179736617224,06/02/2018,935913338062541 WEST HOWARD AND LLOYD ,835.02,,25368.560000000005,OTHER, 
179736617224,06/02/2018,974517083348628 MITCHELL HENDRIX AND LONG ,,244.35,25124.210000000006,PAYMENT, 
179736617224,07/02/2018,451199598210685 HOWELL SPENCE AND PEREZ ,,181.63,24942.580000000005,OTHER, 
179736617224,10/02/2018,Moreno Ltd,,364.02,24578.560000000005,POS, 
179736617224,11/02/2018,153745863054987 DAVIS SILVA AND OLSON ,,823.41,23755.150000000005,PAYMENT, 
179736617224,12/02/2018,West-Ramsey,595.18,,24350.330000000005,ATM, 
179736617224,12/02/2018,Hughes and Sons,1636.49,,25986.820000000007,POS, 
179736617224,14/02/2018,910370926217147 DAVIS MORGAN AND PARKER ,1522.46,,27509.280000000006,ATM, 
179736617224,14/02/2018,438536327990403 RODRIGUEZ-ESTRADA ,,1526.64,25982.640000000007,POS, 
179736617224,17/02/2018,109171399239177 MEYER LTD ,,1723.62,24259.020000000008,OTHER, 
179736617224,19/02/2018,Scott Dyer and Berg,,1140.36,23118.660000000007,POS, 
179736617224,20/02/2018,785035350452027 RUSH-WILSON ,,756.98,22361.680000000008,PAYMENT, 
179736617224,22/02/2018,73454108151712 MARTINEZ BATES AND MCDONALD ,105.77,,22467.450000000008,PAYMENT, 
179736617224,22/02/2018,794830121402269 CRUZ PLC ,977.44,,23444.890000000007,ATM, 
179736617224,25/02/2018,148499386753865 THOMPSON BROWN AND ROSALES ,1189.95,,24634.840000000007,POS, 
179736617224,26/02/2018,Obrien Ltd,1900.34,,26535.180000000008,ATM, 
179736617224,28/02/2018,Munoz-Weiss,,1910.84,24624.340000000007,OTHER, 
179736617224,03/03/2018,Richardson-Buckley,,1694.31,22930.030000000006,POS, 
179736617224,03/03/2018,178841991112837 BENTON-BUSH ,269.05,,23199.080000000005,ATM, 
179736617224,04/03/2018,Alexander Group,,1737.9,21461.180000000004,PAYMENT, 
179736617224,04/03/2018,Mccarthy-Edwards,1752.68,,23213.860000000004,ATM, 
179736617224,05/03/2018,Robinson Group,1911.54,,25125.400000000005,POS, 
179736617224,07/03/2018,70509236393942 SMITH-SMITH ,519.32,,25644.720000000005,ATM, 
179736617224,09/03/2018,207560649152109 BOOTH-RAMOS ,,19.79,25624.930000000004,PAYMENT, 
179736617224,09/03/2018,637950302779454 GORDON-SMITH ,,337.02,25287.910000000003,POS, 
179736617224,11/03/2018,541318283623355 SPARKS VALENCIA AND WATERS ,1118.53,,26406.440000000002,POS, 
179736617224,11/03/2018,910162529793483 SULLIVAN MARTIN AND HAWKINS ,,974.34,25432.100000000002,POS, 
179736617224,14/03/2018,138535176928637 ROBINSON LLC ,419.9,,25852.000000000004,PAYMENT, 
179736617224,15/03/2018,103248881452278 WILLIAMS GONZALEZ AND GREEN ,541.3,,26393.300000000003,ATM, 
179736617224,17/03/2018,398126955533406 ALLEN GROUP ,,1810.08,24583.22,PAYMENT, 
179736617224,20/03/2018,40639268103002 MARTIN-FOWLER ,,953.32,23629.9,ATM, 
179736617224,22/03/2018,768147329877912 WATKINS PLC ,,337.28,23292.620000000003,PAYMENT, 
179736617224,22/03/2018,867890327328620 LOGAN MURPHY AND CUNNINGHAM ,1857.19,,25149.81,ATM, 
179736617224,23/03/2018,395318942714198 MCGEE SMITH AND BARNES ,1021.37,,26171.18,POS, 
179736617224,24/03/2018,176826180878676 SCHMIDT GROUP ,,1885.44,24285.74,POS, 
179736617224,24/03/2018,Hubbard Group,,1516.42,22769.32,OTHER, 
179736617224,27/03/2018,Duran Inc,,488.27,22281.05,POS, 
179736617224,28/03/2018,Lopez-Baker,,1298.44,20982.61,ATM, 
179736617224,28/03/2018,Berry-Pierce,890.83,,21873.440000000002,PAYMENT, 
179736617224,29/03/2018,Robinson Sawyer and Rowe,513.4,,22386.840000000004,PAYMENT, 
179736617224,31/03/2018,Page Inc,,535.16,21851.680000000004,ATM, 
179736617224,31/03/2018,676635954191948 STRICKLAND LTD ,,44.8,21806.880000000005,OTHER, 
179736617224,03/04/2018,Castillo Phillips and Hill,1906.01,,23712.890000000003,POS, 
179736617224,03/04/2018,Jenkins Mitchell and Warren,647.81,,24360.700000000004,OTHER, 
179736617224,06/04/2018,Johnson-Walker,1096.17,,25456.870000000003,OTHER, 
179736617224,09/04/2018,245442987393243 MACIAS MONTGOMERY AND SANCHEZ ,,1241.52,24215.350000000002,OTHER, 
179736617224,10/04/2018,810013949837442 ROBBINS ABBOTT AND FOWLER ,,602.13,23613.22,PAYMENT, 
179736617224,10/04/2018,Nielsen Inc,210.87,,23824.09,OTHER, 
179736617224,11/04/2018,Jimenez and Sons,1170.72,,24994.81,OTHER, 
179736617224,11/04/2018,May Group,,112.53,24882.280000000002,POS, 
179736617224,13/04/2018,989667716891310 ELLIOTT CAMPBELL AND HOPKINS ,969.53,,25851.81,POS, 
179736617224,16/04/2018,821794745337429 HALL HANSON AND BECKER ,72.66,,25924.47,PAYMENT, 
179736617224,18/04/2018,45350153884778 MANNING LUNA AND PRICE ,1450.49,,27374.960000000003,PAYMENT, 
179736617224,18/04/2018,381441669540966 FERNANDEZ PLC ,,1866.55,25508.410000000003,OTHER, 
179736617224,21/04/2018,567579908292737 MURPHY BAXTER AND THOMPSON ,2.59,,25511.000000000004,OTHER, 
179736617224,23/04/2018,Erickson LLC,,380.52,25130.480000000003,OTHER, 
179736617224,26/04/2018,172870094715304 GARCIA-LOPEZ ,,1737.16,23393.320000000003,POS, 
179736617224,28/04/2018,Tran Garner and Peck,611.41,,24004.730000000003,PAYMENT, 
179736617224,29/04/2018,Roberts Martinez and Hughes,1554.99,,25559.720000000005,POS, 
179736617224,01/05/2018,Santana-Martinez,,1104.51,24455.210000000006,OTHER, 
