Bank Account,Date,Narrative,Debit,Credit,Balance,Categories,Serial
484719521930,30/08/2016,Chung Gomez and Phillips,,1281.05,-5521.110000000001,PAYMENT, 
484719521930,30/08/2016,281079169247893 HUBBARD PLC ,1779.58,,-3741.5300000000007,POS, 
484719521930,02/09/2016,484067739896382 WEST LLC ,,1674.25,-5415.780000000001,PAYMENT, 
484719521930,05/09/2016,913672204228932 MARQUEZ LLC ,,417.91,-5833.6900000000005,POS, 
484719521930,05/09/2016,896787719343961 WATKINS-HARRIS ,,1380.23,-7213.92,PAYMENT, 
484719521930,07/09/2016,543421219336816 GORDON-COLLINS ,,1900.73,-9114.65,POS, 
484719521930,08/09/2016,324106000801284 MARSHALL COOPER AND HUERTA ,362.15,,-8752.5,ATM, 
484719521930,08/09/2016,828294897928627 ROTH LTD ,,248.01,-9000.51,PAYMENT, 
484719521930,08/09/2016,Smith Ltd,,429.24,-9429.75,PAYMENT, 
484719521930,10/09/2016,Moreno Inc,,1495.09,-10924.84,ATM, 
484719521930,10/09/2016,299870559314743 GIBBS-THOMAS ,1629.35,,-9295.49,PAYMENT, 
484719521930,11/09/2016,Hutchinson Inc,,76.06,-9371.55,OTHER, 
484719521930,12/09/2016,Lamb Jones and Armstrong,,1974.15,-11345.699999999999,OTHER, 
484719521930,14/09/2016,Leblanc Sullivan and Baldwin,,1798.71,-13144.41,ATM, 
484719521930,16/09/2016,Gardner PLC,,854.11,-13998.52,PAYMENT, 
484719521930,16/09/2016,Harris and Sons,187.78,,-13810.74,ATM, 
484719521930,16/09/2016,102605133138812 SCHMIDT PLC ,,42.06,-13852.8,POS, 
484719521930,17/09/2016,Knight-Smith,1405.65,,-12447.15,POS, 
484719521930,20/09/2016,Wade Scott and Wong,95.02,,-12352.13,POS, 
484719521930,22/09/2016,Collins PLC,,950.32,-13302.449999999999,PAYMENT, 
484719521930,25/09/2016,118166455625827 WATSON-DOYLE ,814.42,,-12488.029999999999,POS, 
484719521930,25/09/2016,Carter-Price,,1945.3,-14433.329999999998,ATM, 
484719521930,27/09/2016,Kim-Cole,,1373.22,-15806.549999999997,POS, 
484719521930,28/09/2016,Ayala Scott and Hall,,1725.64,-17532.19,ATM, 
484719521930,01/10/2016,Mccormick LLC,,893.19,-18425.379999999997,OTHER, 
484719521930,03/10/2016,828133262046425 CONRAD AND SONS ,,1734.41,-20159.789999999997,ATM, 
484719521930,05/10/2016,Anderson PLC,15.79,,-20143.999999999996,POS, 
484719521930,08/10/2016,638920866511118 COLLINS-GUTIERREZ ,1893.09,,-18250.909999999996,POS, 
484719521930,09/10/2016,215800856015194 HINES PARKS AND WILLIAMS ,,1401.67,-19652.579999999994,POS, 
484719521930,12/10/2016,Williams-Schneider,359.05,,-19293.529999999995,OTHER, 
484719521930,14/10/2016,Farmer Smith and Guzman,,1115.87,-20409.399999999994,POS, 
484719521930,16/10/2016,347049817189555 JORDAN SLOAN AND KELLY ,,190.27,-20599.669999999995,ATM, 
484719521930,19/10/2016,Baldwin and Sons,,569.68,-21169.349999999995,ATM, 
484719521930,22/10/2016,944798374199460 CLARK RODRIGUEZ AND WEST ,,994.53,-22163.879999999994,ATM, 
484719521930,23/10/2016,Watson Inc,,542.08,-22705.959999999995,POS, 
484719521930,26/10/2016,52244586616885 FERRELL-GARCIA ,,17.35,-22723.309999999994,OTHER, 
484719521930,27/10/2016,Walker-Navarro,1903.43,,-20819.879999999994,ATM, 
484719521930,30/10/2016,332643287990013 HARPER-MOORE ,,1114.21,-21934.089999999993,ATM, 
484719521930,31/10/2016,793645108252809 WEST-DAVENPORT ,744.19,,-21189.899999999994,OTHER, 
484719521930,03/11/2016,Walter-Guzman,,871.45,-22061.349999999995,ATM, 
484719521930,04/11/2016,861191485543325 COMPTON-WHITE ,,233.23,-22294.579999999994,OTHER, 
484719521930,04/11/2016,153078123505201 JOHNS WILLIAMS AND PUGH ,1007.68,,-21286.899999999994,POS, 
484719521930,07/11/2016,306256467748546 KELLY-WATSON ,,256.93,-21543.829999999994,ATM, 
484719521930,10/11/2016,967752717388830 PHILLIPS-CONLEY ,1190.45,,-20353.379999999994,OTHER, 
484719521930,12/11/2016,383952246763391 CHRISTENSEN-JONES ,1979.21,,-18374.169999999995,PAYMENT, 
484719521930,13/11/2016,283817529107119 MARTINEZ OLSEN AND MARTINEZ ,,119.29,-18493.459999999995,PAYMENT, 
484719521930,16/11/2016,Davila-Johns,,1932.99,-20426.449999999997,OTHER, 
484719521930,17/11/2016,913459039866684 MCKINNEY PLC ,789.44,,-19637.01,OTHER, 
484719521930,18/11/2016,754235312643173 BAKER SANTIAGO AND TAYLOR ,,778.71,-20415.719999999998,PAYMENT, 
484719521930,19/11/2016,805576059955246 PEREZ AND SONS ,768.54,,-19647.179999999997,ATM, 
484719521930,20/11/2016,215205030346823 HARDY JACKSON AND BURKE ,914.96,,-18732.219999999998,ATM, 
484719521930,20/11/2016,Ford Mcgee and Nash,1075.51,,-17656.71,PAYMENT, 
484719521930,20/11/2016,Jackson Ltd,,1125.0,-18781.71,POS, 
484719521930,21/11/2016,Williams Williams and Deleon,,1650.57,-20432.28,PAYMENT, 
484719521930,24/11/2016,533491305880743 FULLER-ANDRADE ,142.43,,-20289.85,PAYMENT, 
484719521930,27/11/2016,118547149615300 BRYANT-CUNNINGHAM ,,1995.25,-22285.1,OTHER, 
484719521930,28/11/2016,918641875219395 MUNOZ GILL AND MCLAUGHLIN ,,1767.87,-24052.969999999998,ATM, 
484719521930,29/11/2016,550205632672811 MAY PLC ,1276.8,,-22776.17,OTHER, 
484719521930,29/11/2016,Nguyen-Walker,,1096.3,-23872.469999999998,PAYMENT, 
484719521930,29/11/2016,550114419697344 LOPEZ GROUP ,1996.29,,-21876.179999999997,OTHER, 
484719521930,01/12/2016,645360755442814 ANDREWS PLC ,,351.9,-22228.079999999998,OTHER, 
484719521930,01/12/2016,Pennington-Collins,717.55,,-21510.53,POS, 
484719521930,03/12/2016,353656221548439 VANCE THOMPSON AND WILSON ,1452.17,,-20058.36,ATM, 
484719521930,05/12/2016,Hernandez-Smith,1969.93,,-18088.43,PAYMENT, 
484719521930,05/12/2016,Fisher-Duncan,1617.58,,-16470.85,PAYMENT, 
484719521930,08/12/2016,897357464265239 DIAZ-MATTHEWS ,106.09,,-16364.759999999998,POS, 
484719521930,08/12/2016,Cole Howard and Osborn,846.12,,-15518.639999999998,ATM, 
484719521930,09/12/2016,Elliott-Ross,,504.61,-16023.249999999998,ATM, 
484719521930,11/12/2016,Mitchell Osborn and Snyder,,1994.82,-18018.07,PAYMENT, 
484719521930,14/12/2016,Ruiz LLC,,1430.93,-19449.0,PAYMENT, 
484719521930,17/12/2016,923106147800477 CRAWFORD-WELCH ,231.96,,-19217.04,OTHER, 
484719521930,17/12/2016,Booth Gilbert and Anderson,514.65,,-18702.39,OTHER, 
484719521930,19/12/2016,Johnson-Lee,1834.64,,-16867.75,POS, 
484719521930,21/12/2016,Roberts Barrett and White,,1102.55,-17970.3,PAYMENT, 
484719521930,24/12/2016,Phillips Alvarez and Robinson,,818.09,-18788.39,ATM, 
484719521930,24/12/2016,648560199927897 THOMPSON PLC ,334.98,,-18453.41,OTHER, 
484719521930,25/12/2016,982160733810475 CISNEROS-BERG ,179.4,,-18274.01,ATM, 
484719521930,26/12/2016,Palmer Franklin and Ali,,1063.72,-19337.73,ATM, 
484719521930,29/12/2016,920324857785691 WELLS KENNEDY AND ANDERSON ,95.34,,-19242.39,POS, 
484719521930,01/01/2017,Wang Evans and Miles,1318.53,,-17923.86,POS, 
484719521930,03/01/2017,Rogers Schmidt and Martinez,,1626.24,-19550.100000000002,PAYMENT, 
484719521930,04/01/2017,737713852577794 BELL-GREEN ,,1551.63,-21101.730000000003,OTHER, 
484719521930,04/01/2017,Thomas and Sons,710.88,,-20390.850000000002,PAYMENT, 
484719521930,06/01/2017,Rogers-Smith,,133.98,-20524.83,OTHER, 
484719521930,08/01/2017,Lawrence-Wright,333.6,,-20191.230000000003,OTHER, 
484719521930,11/01/2017,Sullivan Atkins and Lewis,,1494.37,-21685.600000000002,POS, 
484719521930,12/01/2017,Cox Inc,1561.16,,-20124.440000000002,ATM, 
484719521930,13/01/2017,Hester and Sons,663.26,,-19461.180000000004,OTHER, 
484719521930,16/01/2017,211553636260332 CLARK AND SONS ,117.47,,-19343.710000000003,POS, 
484719521930,16/01/2017,791427313615414 HURLEY WILSON AND MOORE ,1174.24,,-18169.47,ATM, 
484719521930,17/01/2017,714242266469612 SMITH LLC ,,1027.79,-19197.260000000002,OTHER, 
484719521930,20/01/2017,519200483740211 WALKER AND SONS ,,1379.09,-20576.350000000002,PAYMENT, 
484719521930,21/01/2017,673271729811414 HIGGINS CANNON AND MELENDEZ ,,1167.09,-21743.440000000002,PAYMENT, 
484719521930,22/01/2017,935406119488486 MURRAY RANGEL AND RAYMOND ,,142.48,-21885.920000000002,OTHER, 
484719521930,22/01/2017,Brown-Long,921.47,,-20964.45,ATM, 
484719521930,25/01/2017,587815450209923 BURNETT-STEWART ,,1127.48,-22091.93,OTHER, 
484719521930,28/01/2017,942706947883890 THORNTON MOLINA AND FINLEY ,1793.27,,-20298.66,PAYMENT, 
484719521930,28/01/2017,432669950547078 RHODES GROUP ,,21.16,-20319.82,OTHER, 
484719521930,29/01/2017,763787010945113 CAMPBELL STUART AND RIVERA ,283.67,,-20036.15,PAYMENT, 
484719521930,29/01/2017,995693045199532 RICH LLC ,1864.03,,-18172.120000000003,OTHER, 
484719521930,01/02/2017,Smith Inc,286.94,,-17885.180000000004,OTHER, 
484719521930,03/02/2017,Vargas Lewis and Miller,,562.55,-18447.730000000003,ATM, 
484719521930,05/02/2017,Phelps PLC,488.12,,-17959.610000000004,PAYMENT, 
484719521930,07/02/2017,294174203230699 SMITH PLC ,,27.12,-17986.730000000003,ATM, 
484719521930,10/02/2017,672584684227316 WOOD-MILES ,209.68,,-17777.050000000003,ATM, 
484719521930,12/02/2017,Bennett Fischer and Burton,,1006.62,-18783.670000000002,OTHER, 
484719521930,12/02/2017,Patrick PLC,1564.76,,-17218.910000000003,ATM, 
484719521930,13/02/2017,736408848890411 HODGE-TRUJILLO ,479.25,,-16739.660000000003,ATM, 
484719521930,16/02/2017,1601352534419 GRIFFIN-WALSH ,1939.18,,-14800.480000000003,POS, 
484719521930,16/02/2017,992172924022086 GREEN LLC ,,875.03,-15675.510000000004,PAYMENT, 
484719521930,16/02/2017,Taylor PLC,312.92,,-15362.590000000004,OTHER, 
484719521930,19/02/2017,Sanchez-Mills,,13.35,-15375.940000000004,OTHER, 
484719521930,21/02/2017,Roth Inc,,1156.25,-16532.190000000002,ATM, 
484719521930,23/02/2017,210224650577844 WOODS-CARLSON ,1243.39,,-15288.800000000003,OTHER, 
484719521930,26/02/2017,52988659687414 GALLOWAY FERNANDEZ AND JOHNSON ,308.21,,-14980.590000000004,OTHER, 
484719521930,28/02/2017,353061189252104 THOMPSON ROBERTSON AND CHANDLER ,,713.29,-15693.880000000005,OTHER, 
484719521930,28/02/2017,Williams Williams and Huynh,1825.29,,-13868.590000000004,OTHER, 
484719521930,02/03/2017,Smith LLC,,1741.55,-15610.140000000003,ATM, 
484719521930,03/03/2017,245777039014814 MONTGOMERY GROSS AND STUART ,,1994.11,-17604.250000000004,OTHER, 
484719521930,04/03/2017,866390080336814 HAYNES WILLIAMS AND HUGHES ,1829.14,,-15775.110000000004,PAYMENT, 
484719521930,07/03/2017,615129391585824 SNYDER LLC ,,1968.55,-17743.660000000003,ATM, 
484719521930,10/03/2017,525476889575800 ROWE ELLIS AND RODGERS ,99.82,,-17643.840000000004,POS, 
484719521930,13/03/2017,Pennington Rodriguez and Harris,,802.71,-18446.550000000003,OTHER, 
484719521930,15/03/2017,White PLC,1760.17,,-16686.380000000005,OTHER, 
484719521930,16/03/2017,31689177325949 TOWNSEND PLC ,,416.33,-17102.710000000006,POS, 
484719521930,19/03/2017,Hughes Lopez and Kennedy,,1331.4,-18434.110000000008,POS, 
484719521930,20/03/2017,Walls-Torres,1539.36,,-16894.750000000007,POS, 
484719521930,21/03/2017,265361828324826 PORTER WILLIAMS AND COLEMAN ,799.86,,-16094.890000000007,ATM, 
484719521930,23/03/2017,Fritz Johnson and Patterson,,944.82,-17039.710000000006,POS, 
484719521930,24/03/2017,Gibson Gray and Morgan,660.25,,-16379.460000000006,PAYMENT, 
484719521930,25/03/2017,239064830042613 WALKER-KNIGHT ,610.01,,-15769.450000000006,OTHER, 
484719521930,25/03/2017,973207171039297 HENDRIX MORRIS AND BARNES ,1110.08,,-14659.370000000006,ATM, 
484719521930,26/03/2017,Bowen Rojas and Shaffer,1438.0,,-13221.370000000006,POS, 
484719521930,28/03/2017,262174526743868 RHODES CRUZ AND THOMAS ,1072.97,,-12148.400000000007,PAYMENT, 
484719521930,28/03/2017,366566072270174 WATERS LLC ,,1941.83,-14090.230000000007,PAYMENT, 
484719521930,29/03/2017,269908041589483 RUSSELL HENRY AND ROSE ,,1448.17,-15538.400000000007,PAYMENT, 
484719521930,29/03/2017,Burnett Inc,782.18,,-14756.220000000007,ATM, 
484719521930,31/03/2017,90402310868909 WILLIAMS-MOORE ,1102.86,,-13653.360000000006,ATM, 
484719521930,02/04/2017,259813202663046 MILLER-MARKS ,,777.05,-14430.410000000005,OTHER, 
484719521930,03/04/2017,425731431969633 WALKER CHAVEZ AND JOHNSON ,1291.68,,-13138.730000000005,ATM, 
484719521930,04/04/2017,Benson LLC,,1697.49,-14836.220000000005,PAYMENT, 
484719521930,04/04/2017,784844182173802 BRADLEY BURKE AND HOLLAND ,,680.55,-15516.770000000004,POS, 
484719521930,07/04/2017,207980728000182 PETERSON JOHNSON AND DAVIS ,,81.23,-15598.000000000004,POS, 
484719521930,09/04/2017,214064796212310 JOHNSON BARTON AND HUGHES ,830.23,,-14767.770000000004,PAYMENT, 
484719521930,12/04/2017,Thompson-Mckinney,1904.06,,-12863.710000000005,POS, 
484719521930,14/04/2017,335608822868464 LEONARD-GILL ,1767.18,,-11096.530000000004,ATM, 
484719521930,14/04/2017,264070495372898 BISHOP-SMITH ,1226.14,,-9870.390000000005,ATM, 
484719521930,15/04/2017,294049115436571 WU BELL AND GORDON ,,1716.72,-11587.110000000004,PAYMENT, 
484719521930,18/04/2017,911333974007681 PEREZ AND SONS ,329.31,,-11257.800000000005,ATM, 
484719521930,21/04/2017,White Evans and Moore,,1034.19,-12291.990000000005,OTHER, 
484719521930,22/04/2017,Fields Mitchell and White,1861.22,,-10430.770000000006,POS, 
484719521930,23/04/2017,781383494939477 THOMPSON-ALVAREZ ,,1763.22,-12193.990000000005,PAYMENT, 
484719521930,23/04/2017,378896437438731 OSBORNE CONTRERAS AND STEVENS ,,1296.17,-13490.160000000005,OTHER, 
484719521930,24/04/2017,Gamble-Stark,,1886.97,-15377.130000000005,OTHER, 
484719521930,25/04/2017,789348294022205 KELLER-HUANG ,1358.1,,-14019.030000000004,PAYMENT, 
484719521930,26/04/2017,380756962121262 HUNT MELTON AND POTTER ,1095.1,,-12923.930000000004,ATM, 
484719521930,28/04/2017,866484801329403 TAYLOR BROOKS AND LEWIS ,1751.53,,-11172.400000000003,PAYMENT, 
484719521930,28/04/2017,476894246725031 DOMINGUEZ TURNER AND SMITH ,,1770.52,-12942.920000000004,POS, 
484719521930,30/04/2017,Taylor-Lopez,,1214.21,-14157.130000000005,ATM, 
484719521930,30/04/2017,338775902633794 BRADY PLC ,,944.03,-15101.160000000005,ATM, 
484719521930,02/05/2017,726663249610675 TURNER ANDERSON AND BLACK ,,1812.96,-16914.120000000006,ATM, 
484719521930,04/05/2017,109013617973404 PATEL SHANNON AND PIERCE ,,725.56,-17639.680000000008,OTHER, 
484719521930,07/05/2017,Martin Martinez and Davis,,222.89,-17862.570000000007,ATM, 
484719521930,08/05/2017,281502248505543 DRAKE PLC ,1094.43,,-16768.140000000007,OTHER, 
484719521930,08/05/2017,477238081362919 MURPHY-CHAVEZ ,,402.12,-17170.260000000006,OTHER, 
484719521930,09/05/2017,Roberson Parks and Walsh,1167.7,,-16002.560000000005,ATM, 
484719521930,11/05/2017,Ferguson-Perez,,1477.58,-17480.140000000007,POS, 
484719521930,13/05/2017,Walker PLC,,334.04,-17814.180000000008,ATM, 
484719521930,13/05/2017,598765635337277 HARTMAN DRAKE AND RICE ,,1730.12,-19544.300000000007,PAYMENT, 
484719521930,13/05/2017,Walton Villegas and Campos,,1973.11,-21517.410000000007,ATM, 
484719521930,16/05/2017,569602624349987 HAMMOND LONG AND WRIGHT ,,1060.77,-22578.180000000008,ATM, 
484719521930,19/05/2017,922428038074348 WEBB PLC ,500.77,,-22077.410000000007,ATM, 
484719521930,22/05/2017,276828972833883 MILLER-WILLIAMS ,776.96,,-21300.450000000008,ATM, 
484719521930,23/05/2017,259474834160312 JOHNSON KELLY AND THORNTON ,,1550.99,-22851.44000000001,ATM, 
484719521930,25/05/2017,Moreno and Sons,,1207.42,-24058.860000000008,POS, 
484719521930,27/05/2017,Warren Richard and Rose,,1483.39,-25542.250000000007,POS, 
484719521930,29/05/2017,Carter-Garcia,997.75,,-24544.500000000007,OTHER, 
484719521930,29/05/2017,94322559072486 HERRERA AND SONS ,,1780.64,-26325.140000000007,PAYMENT, 
484719521930,01/06/2017,870324713009489 RICHARDSON-BRYAN ,,438.54,-26763.680000000008,POS, 
484719521930,02/06/2017,Barr Inc,1565.64,,-25198.040000000008,OTHER, 
484719521930,03/06/2017,136654400829967 RAYMOND JONES AND JOHNSON ,,969.08,-26167.12000000001,OTHER, 
484719521930,04/06/2017,356039734002346 WILLIAMS LEWIS AND HAMILTON ,1084.85,,-25082.27000000001,POS, 
484719521930,04/06/2017,Schmidt PLC,332.01,,-24750.260000000013,OTHER, 
484719521930,04/06/2017,Wood Mann and Jenkins,,696.26,-25446.52000000001,POS, 
484719521930,07/06/2017,Gutierrez PLC,975.76,,-24470.760000000013,OTHER, 
484719521930,09/06/2017,23341044086867 ENGLISH LTD ,480.04,,-23990.720000000012,PAYMENT, 
484719521930,09/06/2017,856761230768221 WATTS MARTINEZ AND WILLIAMS ,1370.68,,-22620.04000000001,POS, 
484719521930,09/06/2017,82847575638195 BOYD WALKER AND EDWARDS ,,1764.02,-24384.060000000012,PAYMENT, 
484719521930,11/06/2017,62528162015699 PETERSON-WALLACE ,,1024.25,-25408.310000000012,PAYMENT, 
484719521930,11/06/2017,York Ltd,,1760.2,-27168.510000000013,POS, 
484719521930,14/06/2017,Fox-Lynch,438.89,,-26729.620000000014,PAYMENT, 
484719521930,15/06/2017,920614276310077 MEZA LLC ,1619.75,,-25109.870000000014,ATM, 
484719521930,16/06/2017,Brown-Powell,1214.13,,-23895.740000000013,OTHER, 
484719521930,16/06/2017,Reese Hughes and Jackson,,713.09,-24608.830000000013,POS, 
484719521930,17/06/2017,614398580583643 WILLIAMS-SANCHEZ ,,1560.3,-26169.130000000012,ATM, 
484719521930,20/06/2017,885397827459477 ANDERSON-NORTON ,,922.63,-27091.760000000013,ATM, 
484719521930,21/06/2017,Olson Sims and Perry,425.13,,-26666.630000000012,PAYMENT, 
484719521930,21/06/2017,Stevens-Fischer,77.35,,-26589.280000000013,PAYMENT, 
484719521930,24/06/2017,237261620056195 ROGERS-BROWN ,,1204.96,-27794.240000000013,PAYMENT, 
484719521930,24/06/2017,Gonzalez-Freeman,,46.93,-27841.170000000013,ATM, 
484719521930,26/06/2017,285219849541831 HUNTER-GRIFFITH ,,1491.81,-29332.980000000014,OTHER, 
484719521930,29/06/2017,Russell-Edwards,,1659.59,-30992.570000000014,PAYMENT, 
484719521930,02/07/2017,Villanueva PLC,,777.77,-31770.340000000015,ATM, 
484719521930,03/07/2017,466471616963933 BUCKLEY LLC ,,561.54,-32331.880000000016,PAYMENT, 
484719521930,04/07/2017,Macias-Watts,,224.23,-32556.110000000015,OTHER, 
484719521930,05/07/2017,Mclaughlin PLC,,422.8,-32978.91000000002,OTHER, 
484719521930,05/07/2017,Valentine LLC,461.28,,-32517.63000000002,OTHER, 
484719521930,06/07/2017,Hicks Morgan and White,199.47,,-32318.160000000018,ATM, 
484719521930,06/07/2017,Butler Anderson and Roy,,403.59,-32721.75000000002,POS, 
484719521930,07/07/2017,671155705876236 SPARKS-NICHOLS ,,722.05,-33443.80000000002,ATM, 
484719521930,09/07/2017,Fisher-Carter,,34.94,-33478.74000000002,POS, 
484719521930,11/07/2017,Patton-Mcclain,,1163.23,-34641.97000000002,ATM, 
484719521930,14/07/2017,368320224600121 ROWE LTD ,,1493.9,-36135.870000000024,PAYMENT, 
484719521930,14/07/2017,903748665138578 GREEN LTD ,236.92,,-35898.950000000026,OTHER, 
484719521930,16/07/2017,130380296517068 DAVIS HAMILTON AND SUTTON ,,1382.86,-37281.81000000003,ATM, 
484719521930,17/07/2017,Day-Thomas,,1227.4,-38509.21000000003,ATM, 
484719521930,20/07/2017,Douglas LLC,1869.56,,-36639.65000000003,ATM, 
484719521930,22/07/2017,649962152090150 ERICKSON PLC ,116.28,,-36523.37000000003,PAYMENT, 
484719521930,25/07/2017,Bradford-Estrada,307.64,,-36215.73000000003,PAYMENT, 
484719521930,28/07/2017,638807071818736 WILCOX INC ,,478.88,-36694.61000000003,PAYMENT, 
484719521930,30/07/2017,262733830690401 BOYD DAVIS AND WHITEHEAD ,1163.38,,-35531.23000000003,OTHER, 
484719521930,01/08/2017,167681760612561 COOPER-REYNOLDS ,785.71,,-34745.52000000003,ATM, 
484719521930,04/08/2017,208640569733807 ZHANG INC ,1400.22,,-33345.30000000003,OTHER, 
484719521930,04/08/2017,843456058085266 MEDINA-WILKINS ,692.01,,-32653.290000000034,OTHER, 
484719521930,05/08/2017,455661340967539 LEE-MENDEZ ,503.26,,-32150.030000000035,OTHER, 
484719521930,07/08/2017,Mason LLC,441.09,,-31708.940000000035,OTHER, 
484719521930,09/08/2017,246737496080784 PETERSON-GUTIERREZ ,1343.88,,-30365.060000000034,POS, 
484719521930,09/08/2017,314915955630388 FRANCIS-KIM ,,139.6,-30504.660000000033,PAYMENT, 
484719521930,11/08/2017,516699065571075 GRAY-MALONE ,,1824.23,-32328.890000000032,ATM, 
484719521930,11/08/2017,878691698166612 DAVIS GROUP ,634.28,,-31694.610000000033,PAYMENT, 
484719521930,14/08/2017,Johnson Ltd,,1440.99,-33135.600000000035,OTHER, 
484719521930,16/08/2017,Brown-Lawrence,,1475.83,-34611.43000000004,PAYMENT, 
484719521930,17/08/2017,Gonzalez Parker and Salas,1049.97,,-33561.460000000036,POS, 
484719521930,20/08/2017,Rodriguez Group,758.16,,-32803.30000000003,POS, 
484719521930,23/08/2017,48516419210637 HARRIS INC ,,659.4,-33462.70000000003,OTHER, 
484719521930,25/08/2017,473120120144519 PRICE INC ,1751.94,,-31710.760000000035,PAYMENT, 
484719521930,27/08/2017,770840306025247 BARRERA-JOHNSON ,,566.05,-32276.810000000034,OTHER, 
484719521930,27/08/2017,Williams and Sons,,1583.9,-33860.710000000036,OTHER, 
484719521930,28/08/2017,Watkins Group,,229.14,-34089.850000000035,POS, 
484719521930,29/08/2017,612560055188110 SINGH SHAFFER AND ERICKSON ,,1803.03,-35892.880000000034,OTHER, 
484719521930,31/08/2017,895398799316062 WALTERS MEYER AND DIAZ ,1244.96,,-34647.920000000035,ATM, 
484719521930,31/08/2017,522674977791091 MATA PLC ,1621.83,,-33026.09000000003,OTHER, 
484719521930,31/08/2017,Solomon Harper and Brown,,1764.82,-34790.91000000003,OTHER, 
484719521930,02/09/2017,625349128122404 OROZCO MURRAY AND OWENS ,,511.55,-35302.460000000036,OTHER, 
484719521930,03/09/2017,Payne Montoya and Shepard,1802.45,,-33500.01000000004,ATM, 
484719521930,06/09/2017,926687865553283 RODRIGUEZ LLC ,,1220.31,-34720.320000000036,ATM, 
484719521930,09/09/2017,Ramirez and Sons,1599.16,,-33121.16000000003,PAYMENT, 
484719521930,10/09/2017,Black-Baird,27.86,,-33093.30000000003,ATM, 
484719521930,13/09/2017,Gonzales-Smith,,119.6,-33212.90000000003,POS, 
484719521930,16/09/2017,278043039339561 PERKINS GROUP ,,1948.72,-35161.62000000003,OTHER, 
484719521930,17/09/2017,Hughes Hill and Robbins,,1505.87,-36667.490000000034,POS, 
484719521930,19/09/2017,985432055036742 JONES-MEDINA ,,890.34,-37557.83000000003,OTHER, 
484719521930,22/09/2017,Lee and Sons,,1536.29,-39094.12000000003,POS, 
484719521930,23/09/2017,33556662222750 LEWIS LLC ,164.26,,-38929.86000000003,OTHER, 
484719521930,23/09/2017,Obrien Inc,,1812.77,-40742.63000000003,POS, 
484719521930,23/09/2017,Stephens-Randall,883.27,,-39859.36000000003,ATM, 
484719521930,23/09/2017,456861325448939 OSBORNE-BRADSHAW ,,1810.26,-41669.62000000003,OTHER, 
484719521930,24/09/2017,Huang-Dixon,,1904.78,-43574.40000000003,PAYMENT, 
484719521930,26/09/2017,671685266184753 THOMAS AND SONS ,830.97,,-42743.43000000003,POS, 
484719521930,26/09/2017,Lang Ltd,811.77,,-41931.66000000003,ATM, 
484719521930,29/09/2017,705253580048442 WALTERS AND SONS ,,626.73,-42558.390000000036,PAYMENT, 
484719521930,02/10/2017,Berg-Abbott,1211.39,,-41347.00000000004,OTHER, 
484719521930,04/10/2017,277660518404773 LARSON-PAYNE ,1109.33,,-40237.670000000035,ATM, 
484719521930,05/10/2017,130187867704255 ROTH-COCHRAN ,,1883.74,-42121.41000000003,ATM, 
484719521930,06/10/2017,Vega Group,1511.59,,-40609.820000000036,OTHER, 
484719521930,08/10/2017,Brooks Wright and Franklin,,1568.41,-42178.23000000004,OTHER, 
484719521930,10/10/2017,Davis Ltd,1599.89,,-40578.34000000004,POS, 
484719521930,11/10/2017,Cook PLC,,920.9,-41499.24000000004,PAYMENT, 
484719521930,11/10/2017,Hoffman-Webb,72.5,,-41426.74000000004,OTHER, 
484719521930,12/10/2017,Reyes Walters and Osborne,1878.22,,-39548.52000000004,OTHER, 
484719521930,14/10/2017,840796950169042 JIMENEZ-SMITH ,,534.24,-40082.76000000004,PAYMENT, 
484719521930,15/10/2017,516238230914468 CARTER GREEN AND CAREY ,,980.38,-41063.140000000036,PAYMENT, 
484719521930,15/10/2017,292354106080779 SIMS-GILLESPIE ,,208.03,-41271.170000000035,POS, 
484719521930,16/10/2017,Baker-Harvey,,866.27,-42137.44000000003,OTHER, 
484719521930,17/10/2017,Brown Macias and Turner,,1218.04,-43355.48000000003,POS, 
484719521930,17/10/2017,Petty-Cuevas,1563.02,,-41792.460000000036,POS, 
484719521930,20/10/2017,Lewis Landry and Wade,,1405.69,-43198.15000000004,OTHER, 
484719521930,20/10/2017,629468540191304 COLLINS LLC ,1232.91,,-41965.240000000034,ATM, 
484719521930,21/10/2017,350555010439510 RODRIGUEZ GROUP ,,496.8,-42462.04000000004,ATM, 
484719521930,22/10/2017,Allison Graves and Brown,,601.5,-43063.54000000004,PAYMENT, 
484719521930,25/10/2017,524099712862299 RODRIGUEZ-HAYES ,954.92,,-42108.62000000004,POS, 
484719521930,27/10/2017,876971767305418 TOWNSEND WEBER AND LOPEZ ,1139.53,,-40969.09000000004,ATM, 
484719521930,30/10/2017,Floyd LLC,,966.24,-41935.33000000004,ATM, 
484719521930,30/10/2017,931985674579089 CRUZ JOHNSON AND FISHER ,,809.6,-42744.93000000004,POS, 
484719521930,30/10/2017,115152160067629 HARRIS-THOMPSON ,61.96,,-42682.97000000004,POS, 
484719521930,01/11/2017,Boone Martinez and Gould,1353.24,,-41329.73000000004,PAYMENT, 
484719521930,01/11/2017,543700317541986 LEE LLC ,,1761.08,-43090.81000000004,PAYMENT, 
484719521930,03/11/2017,Lewis Jimenez and Blackwell,946.53,,-42144.28000000004,POS, 
484719521930,06/11/2017,226316389975850 HALL FULLER AND MALONE ,757.32,,-41386.96000000004,POS, 
484719521930,08/11/2017,Padilla Osborn and Nelson,,906.74,-42293.70000000004,POS, 
484719521930,10/11/2017,West Cummings and King,,538.18,-42831.88000000004,PAYMENT, 
484719521930,10/11/2017,Vargas Chapman and Mcdonald,960.71,,-41871.17000000004,OTHER, 
484719521930,11/11/2017,Mcgee-Hall,1619.93,,-40251.24000000004,POS, 
484719521930,14/11/2017,Williams Inc,,1966.89,-42218.13000000004,OTHER, 
484719521930,14/11/2017,827849068114841 GOLDEN-JOYCE ,,865.58,-43083.71000000004,ATM, 
484719521930,16/11/2017,351173135238572 GRIFFIN-JACKSON ,737.15,,-42346.56000000004,ATM, 
484719521930,19/11/2017,Crawford Group,,1276.62,-43623.180000000044,PAYMENT, 
484719521930,19/11/2017,Collins LLC,158.29,,-43464.89000000004,POS, 
484719521930,19/11/2017,577733335122691 NGUYEN-MARTIN ,509.32,,-42955.57000000004,POS, 
484719521930,21/11/2017,879904404786166 WALTON-STEVENSON ,,1759.17,-44714.74000000004,PAYMENT, 
484719521930,21/11/2017,Brown Inc,,1180.42,-45895.16000000004,OTHER, 
484719521930,21/11/2017,389751760457488 DICKERSON ALEXANDER AND HAMPTON ,704.27,,-45190.89000000004,PAYMENT, 
484719521930,24/11/2017,Hansen PLC,986.27,,-44204.620000000046,PAYMENT, 
484719521930,27/11/2017,Stewart Group,888.09,,-43316.53000000005,OTHER, 
484719521930,28/11/2017,403957478983904 BURGESS GROUP ,,1171.23,-44487.76000000005,PAYMENT, 
484719521930,29/11/2017,Powell Miller and Mccoy,,88.83,-44576.590000000055,PAYMENT, 
484719521930,30/11/2017,Tucker PLC,756.91,,-43819.68000000005,OTHER, 
484719521930,01/12/2017,124529130035272 BENNETT-MYERS ,,855.88,-44675.56000000005,PAYMENT, 
484719521930,02/12/2017,Smith-Martin,706.34,,-43969.22000000005,OTHER, 
484719521930,02/12/2017,Dunn PLC,1025.82,,-42943.40000000005,OTHER, 
484719521930,02/12/2017,835058917488063 MASSEY LLC ,129.63,,-42813.770000000055,ATM, 
484719521930,03/12/2017,230017379698511 PARKER GROUP ,,792.94,-43606.71000000006,ATM, 
484719521930,05/12/2017,Moore-Price,267.41,,-43339.300000000054,OTHER, 
484719521930,05/12/2017,634325197484438 ALEXANDER LTD ,1241.8,,-42097.50000000005,ATM, 
484719521930,06/12/2017,Tran-Reed,1679.16,,-40418.34000000005,OTHER, 
484719521930,07/12/2017,Long Fisher and Rollins,97.32,,-40321.02000000005,ATM, 
484719521930,07/12/2017,458872798691606 ROWE AND SONS ,373.74,,-39947.28000000005,OTHER, 
484719521930,08/12/2017,Todd Jenkins and Evans,1916.98,,-38030.30000000005,PAYMENT, 
484719521930,08/12/2017,Lynch Gray and Mitchell,1239.73,,-36790.57000000004,ATM, 
484719521930,11/12/2017,Woodard Harvey and Weaver,678.23,,-36112.34000000004,POS, 
484719521930,11/12/2017,Hill LLC,,1804.77,-37917.11000000004,PAYMENT, 
484719521930,14/12/2017,Cox Group,,974.78,-38891.890000000036,POS, 
484719521930,15/12/2017,485442409200091 ANDERSON INC ,1691.78,,-37200.11000000004,POS, 
484719521930,17/12/2017,855280506412068 MILLER LLC ,,506.52,-37706.630000000034,OTHER, 
484719521930,19/12/2017,Johnson Rhodes and Martinez,,1390.6,-39097.23000000003,PAYMENT, 
484719521930,20/12/2017,Baker-Brooks,,1416.03,-40513.26000000003,POS, 
484719521930,22/12/2017,817670500769215 COOK HERNANDEZ AND MANNING ,1841.16,,-38672.10000000003,OTHER, 
484719521930,23/12/2017,Snyder-Kirk,1276.16,,-37395.940000000024,PAYMENT, 
484719521930,25/12/2017,36407418760802 DAVIDSON AND SONS ,1899.86,,-35496.08000000002,ATM, 
484719521930,28/12/2017,659281242837695 NELSON LLC ,,898.2,-36394.28000000002,ATM, 
484719521930,31/12/2017,367267798516539 ANDERSON INC ,912.82,,-35481.46000000002,ATM, 
484719521930,02/01/2018,722683893989494 GOODMAN-ALLEN ,,236.16,-35717.620000000024,OTHER, 
484719521930,03/01/2018,Day Meyer and Hill,1150.35,,-34567.270000000026,POS, 
484719521930,04/01/2018,500477628538215 FRANCIS-FISHER ,72.78,,-34494.49000000003,PAYMENT, 
484719521930,05/01/2018,796918246946473 FOLEY PRESTON AND SHAH ,1243.36,,-33251.13000000003,PAYMENT, 
484719521930,07/01/2018,641923320648599 FLORES ROSS AND ORTEGA ,303.0,,-32948.13000000003,PAYMENT, 
484719521930,08/01/2018,Jackson-Jones,1608.05,,-31340.080000000027,ATM, 
484719521930,08/01/2018,Stafford Inc,,72.71,-31412.790000000026,PAYMENT, 
484719521930,11/01/2018,464454036265184 CAMPBELL JONES AND WILSON ,,836.62,-32249.410000000025,POS, 
484719521930,12/01/2018,547644679468894 STRICKLAND-TREVINO ,391.56,,-31857.850000000024,POS, 
484719521930,14/01/2018,143965496906344 LINDSEY LYNCH AND MURPHY ,1122.85,,-30735.000000000025,PAYMENT, 
484719521930,16/01/2018,800804017569952 JACKSON BRUCE AND CRAWFORD ,1326.9,,-29408.100000000024,ATM, 
484719521930,18/01/2018,82530450907586 ROBERTS LTD ,107.04,,-29301.060000000023,POS, 
484719521930,19/01/2018,Mcpherson Romero and Powell,1237.95,,-28063.110000000022,PAYMENT, 
484719521930,19/01/2018,Romero Group,,233.34,-28296.450000000023,PAYMENT, 
484719521930,21/01/2018,999030910635714 RAMIREZ PLC ,514.86,,-27781.590000000022,PAYMENT, 
484719521930,22/01/2018,Gibson Barr and Perez,,1897.41,-29679.000000000022,ATM, 
484719521930,25/01/2018,Sanchez-Morales,,1875.6,-31554.60000000002,OTHER, 
484719521930,25/01/2018,Porter-Parrish,1986.19,,-29568.41000000002,OTHER, 
484719521930,25/01/2018,Green-Hobbs,,775.41,-30343.82000000002,OTHER, 
484719521930,26/01/2018,Smith-Johnson,1335.86,,-29007.96000000002,POS, 
484719521930,28/01/2018,745747710268498 HERRERA TURNER AND COOK ,,1502.23,-30510.19000000002,PAYMENT, 
484719521930,28/01/2018,582673832155862 ADAMS AND SONS ,248.05,,-30262.14000000002,OTHER, 
484719521930,29/01/2018,447698201534588 DAVIS AND SONS ,1392.73,,-28869.41000000002,POS, 
484719521930,30/01/2018,912450951404080 GUZMAN GOMEZ AND FITZGERALD ,,1030.55,-29899.96000000002,ATM, 
484719521930,02/02/2018,869824828539908 RAY-SNYDER ,,1029.81,-30929.770000000022,OTHER, 
484719521930,03/02/2018,288089364338685 SIMPSON-RODGERS ,962.48,,-29967.290000000023,ATM, 
484719521930,05/02/2018,979683554109388 MCCALL-PETERSON ,,1146.68,-31113.970000000023,PAYMENT, 
484719521930,05/02/2018,987264781515165 RHODES-SCOTT ,1392.31,,-29721.66000000002,ATM, 
484719521930,07/02/2018,110999896935934 VILLANUEVA LLC ,,1000.34,-30722.000000000022,OTHER, 
484719521930,08/02/2018,48768419376556 JIMENEZ DAVID AND EVANS ,359.98,,-30362.020000000022,POS, 
484719521930,10/02/2018,Singleton Martin and Stone,,1476.05,-31838.07000000002,POS, 
484719521930,10/02/2018,609629381098685 SHERMAN-MILLER ,,1592.81,-33430.88000000002,OTHER, 
484719521930,13/02/2018,Smith-Rose,,1412.52,-34843.400000000016,ATM, 
484719521930,14/02/2018,Fritz Inc,956.92,,-33886.48000000002,POS, 
484719521930,14/02/2018,952142418244316 VILLARREAL ELLIOTT AND FULLER ,,678.77,-34565.250000000015,PAYMENT, 
484719521930,16/02/2018,569780141018979 PHELPS INC ,410.8,,-34154.45000000001,POS, 
484719521930,18/02/2018,444628691604049 DOUGHERTY WILSON AND DAVIES ,,1820.96,-35975.41000000001,OTHER, 
484719521930,18/02/2018,405339407808036 MARTINEZ STEWART AND GRIFFIN ,1303.11,,-34672.30000000001,PAYMENT, 
484719521930,19/02/2018,181755306800549 FRAZIER LTD ,1916.43,,-32755.87000000001,PAYMENT, 
484719521930,19/02/2018,783041331445080 MILLS SCHULTZ AND SOSA ,1344.05,,-31411.82000000001,POS, 
484719521930,22/02/2018,597048435223986 NGUYEN MILES AND BAILEY ,637.54,,-30774.28000000001,POS, 
484719521930,25/02/2018,216106788675553 BURNETT FITZGERALD AND PETERSON ,472.59,,-30301.69000000001,PAYMENT, 
484719521930,26/02/2018,547793415697158 JOHNSON PLC ,,127.58,-30429.27000000001,POS, 
484719521930,27/02/2018,266700381428426 SANTOS-HOPKINS ,,212.24,-30641.510000000013,OTHER, 
484719521930,28/02/2018,Wade and Sons,814.2,,-29827.310000000012,OTHER, 
484719521930,02/03/2018,838796060351855 DAY LLC ,450.17,,-29377.140000000014,PAYMENT, 
484719521930,03/03/2018,381778275392515 LOPEZ LTD ,,1686.25,-31063.390000000014,ATM, 
484719521930,06/03/2018,261760559982328 BUCHANAN AND SONS ,1441.47,,-29621.920000000013,POS, 
484719521930,08/03/2018,Mayer-Bowman,1562.1,,-28059.820000000014,ATM, 
484719521930,11/03/2018,157890003156561 REESE ADAMS AND WARNER ,,1864.84,-29924.660000000014,POS, 
484719521930,11/03/2018,Carey Ltd,1200.33,,-28724.330000000016,PAYMENT, 
484719521930,12/03/2018,Rogers Inc,,646.77,-29371.100000000017,ATM, 
484719521930,14/03/2018,420388940619297 BRYAN JACKSON AND GRAHAM ,,286.99,-29658.09000000002,ATM, 
484719521930,14/03/2018,Duncan and Sons,,736.68,-30394.77000000002,PAYMENT, 
484719521930,15/03/2018,Bailey Reyes and Richard,1234.9,,-29159.870000000017,POS, 
484719521930,17/03/2018,501382278660300 MOORE LLC ,1800.04,,-27359.830000000016,PAYMENT, 
484719521930,19/03/2018,Becker Edwards and Terry,28.57,,-27331.260000000017,OTHER, 
484719521930,22/03/2018,Jones-Mayer,134.06,,-27197.200000000015,ATM, 
484719521930,24/03/2018,959037850394356 HAYNES LLC ,,1820.79,-29017.990000000016,OTHER, 
484719521930,26/03/2018,Huber-Clark,478.53,,-28539.460000000017,POS, 
484719521930,26/03/2018,800663475111431 HERNANDEZ-ANDREWS ,1904.59,,-26634.870000000017,OTHER, 
484719521930,26/03/2018,Warner-Davila,1617.94,,-25016.93000000002,POS, 
484719521930,29/03/2018,971876356757582 SMITH-HUGHES ,,1034.94,-26051.870000000017,OTHER, 
484719521930,01/04/2018,279518506386469 WARREN GROUP ,,1296.26,-27348.130000000016,ATM, 
484719521930,03/04/2018,Kim Powell and Young,,766.39,-28114.520000000015,PAYMENT, 
484719521930,05/04/2018,Acosta-Sanchez,822.87,,-27291.650000000016,OTHER, 
484719521930,07/04/2018,381690638447507 KIDD-POLLARD ,,1365.02,-28656.670000000016,ATM, 
484719521930,09/04/2018,Frederick-Romero,,1986.67,-30643.34000000002,OTHER, 
484719521930,12/04/2018,227688054531009 KING INC ,,1700.2,-32343.54000000002,POS, 
484719521930,12/04/2018,Davis-Small,,1710.19,-34053.73000000002,OTHER, 
484719521930,14/04/2018,Turner-Smith,,518.8,-34572.53000000002,ATM, 
484719521930,16/04/2018,Martinez-Ross,,364.4,-34936.93000000002,POS, 
484719521930,17/04/2018,833446809231453 HOOD-PHELPS ,,1188.94,-36125.870000000024,PAYMENT, 
484719521930,17/04/2018,537667963608890 JOHNSON INC ,305.34,,-35820.53000000003,PAYMENT, 
484719521930,18/04/2018,Booker-Gutierrez,,1861.5,-37682.03000000003,OTHER, 
484719521930,19/04/2018,935302410735711 LOPEZ-MARQUEZ ,1392.01,,-36290.020000000026,PAYMENT, 
484719521930,20/04/2018,543240057221269 WILLIAMS GROUP ,599.01,,-35691.010000000024,POS, 
484719521930,21/04/2018,Joseph-Jones,,1263.4,-36954.410000000025,OTHER, 
484719521930,23/04/2018,840904390906613 WEBB-DAVIS ,,876.24,-37830.65000000002,PAYMENT, 
484719521930,23/04/2018,Forbes Good and Hayes,,820.61,-38651.260000000024,POS, 
484719521930,23/04/2018,505309538968483 RODRIGUEZ-DRAKE ,,1288.44,-39939.700000000026,PAYMENT, 
484719521930,25/04/2018,353452369562811 LEWIS-HALL ,,963.29,-40902.99000000003,OTHER, 
484719521930,26/04/2018,Richards-Hart,,218.81,-41121.800000000025,POS, 
484719521930,28/04/2018,451519015171389 ROBERTS PLC ,885.52,,-40236.28000000003,OTHER, 
484719521930,01/05/2018,275727376412615 BROWN-TUCKER ,,70.92,-40307.200000000026,PAYMENT, 
484719521930,01/05/2018,787414568432484 BROWN AND SONS ,,1457.3,-41764.50000000003,ATM, 
484719521930,02/05/2018,Huber Young and Taylor,,874.92,-42639.42000000003,OTHER, 
484719521930,03/05/2018,379124677535369 NIELSEN GRAY AND PATEL ,277.73,,-42361.690000000024,ATM, 
484719521930,05/05/2018,Cochran Clark and Lewis,,1204.16,-43565.85000000003,PAYMENT, 
484719521930,05/05/2018,Allen-White,,959.87,-44525.72000000003,POS, 
484719521930,05/05/2018,Blair Nunez and Norton,1449.18,,-43076.54000000003,POS, 
484719521930,05/05/2018,Owens LLC,316.52,,-42760.02000000003,ATM, 
484719521930,08/05/2018,Smith and Sons,545.24,,-42214.780000000035,OTHER, 
484719521930,08/05/2018,Moore and Sons,1114.16,,-41100.62000000003,POS, 
484719521930,11/05/2018,92249573605428 FRANCO AND SONS ,,859.87,-41960.490000000034,OTHER, 
484719521930,14/05/2018,Brown-Bailey,,896.73,-42857.22000000004,OTHER, 
484719521930,14/05/2018,743868718721019 THOMPSON RAMIREZ AND CRAIG ,1205.99,,-41651.23000000004,ATM, 
484719521930,14/05/2018,Anderson Bailey and Frederick,721.96,,-40929.27000000004,OTHER, 
484719521930,17/05/2018,Rivera-Williams,,551.42,-41480.69000000004,POS, 
484719521930,17/05/2018,876325420409944 COX LLC ,,1665.57,-43146.26000000004,ATM, 
484719521930,19/05/2018,511712583702203 JORDAN-MORALES ,,527.24,-43673.50000000004,PAYMENT, 
484719521930,19/05/2018,797872179217517 HILL MOORE AND EDWARDS ,,1943.04,-45616.54000000004,OTHER, 
484719521930,20/05/2018,Davis-Wilson,1477.92,,-44138.62000000004,POS, 
484719521930,21/05/2018,Smith-Nelson,246.88,,-43891.74000000004,POS, 
484719521930,23/05/2018,Garcia Ltd,,1631.88,-45523.62000000004,ATM, 
484719521930,25/05/2018,Mcdonald-Ashley,548.19,,-44975.43000000004,OTHER, 
484719521930,28/05/2018,154580411537565 CANTU-NEWMAN ,,474.97,-45450.40000000004,OTHER, 
484719521930,30/05/2018,Bradley-Larson,1617.02,,-43833.38000000004,PAYMENT, 
484719521930,31/05/2018,Howell PLC,,861.77,-44695.15000000004,POS, 
484719521930,02/06/2018,Hughes Lopez and Perez,,264.18,-44959.33000000004,PAYMENT, 
484719521930,05/06/2018,850460725114004 BOYD RICHARDS AND BROWN ,1287.59,,-43671.74000000004,POS, 
484719521930,06/06/2018,Avery-Lopez,584.86,,-43086.88000000004,POS, 
484719521930,08/06/2018,Underwood Kirk and Ramsey,,1412.65,-44499.53000000004,PAYMENT, 
484719521930,09/06/2018,Adkins Inc,1750.37,,-42749.16000000004,POS, 
484719521930,12/06/2018,603035449808990 BERNARD AND SONS ,744.65,,-42004.51000000004,POS, 
484719521930,13/06/2018,Rasmussen Taylor and Mendoza,,260.61,-42265.12000000004,PAYMENT, 
484719521930,13/06/2018,558169824697042 REED LTD ,,1273.64,-43538.76000000004,POS, 
484719521930,16/06/2018,Brennan Group,,762.52,-44301.280000000035,POS, 
484719521930,19/06/2018,178355945311536 AGUILAR AND SONS ,,867.58,-45168.86000000004,OTHER, 
484719521930,19/06/2018,249297696460155 GARRETT-WRIGHT ,,869.53,-46038.390000000036,PAYMENT, 
484719521930,20/06/2018,432407778221272 PEREZ-BRADY ,,1580.03,-47618.420000000035,OTHER, 
484719521930,21/06/2018,Gill Group,,1097.27,-48715.69000000003,PAYMENT, 
484719521930,22/06/2018,Flores Compton and Kelly,,1860.02,-50575.71000000003,POS, 
484719521930,22/06/2018,308366776730446 KIM-NGUYEN ,390.83,,-50184.88000000003,PAYMENT, 
484719521930,25/06/2018,Floyd Watts and Le,783.94,,-49400.940000000024,PAYMENT, 
484719521930,27/06/2018,856897162858945 FORD-GONZALEZ ,1179.1,,-48221.840000000026,PAYMENT, 
